SongID,segment_num,segment_start,segment_end,duration,start_beat_idx,end_beat_idx,num_beats,seg_type
1,1,0.0,15.466666666666667,15.466666666666667,0,33,33,chromagram
1,2,15.466666666666667,28.426666666666666,12.959999999999999,33,60,27,chromagram
1,3,28.426666666666666,60.586666666666666,32.16,60,127,67,chromagram
1,4,60.586666666666666,120.58666666666666,59.99999999999999,127,252,125,chromagram
1,5,120.58666666666666,150.82666666666665,30.239999999999995,252,315,63,chromagram
1,6,150.82666666666665,166.18666666666664,15.359999999999985,315,347,32,chromagram
1,7,166.18666666666664,227.14666666666665,60.96000000000001,347,474,127,chromagram
1,8,227.14666666666665,259.995,32.84833333333336,474,541,67,chromagram
1,1,0.0,15.466666666666667,15.466666666666667,0,33,33,chroma_acts
1,2,15.466666666666667,28.426666666666666,12.959999999999999,33,60,27,chroma_acts
1,3,28.426666666666666,60.586666666666666,32.16,60,127,67,chroma_acts
1,4,60.586666666666666,120.58666666666666,59.99999999999999,127,252,125,chroma_acts
1,5,120.58666666666666,148.90666666666664,28.31999999999998,252,311,59,chroma_acts
1,6,148.90666666666664,166.18666666666664,17.28,311,347,36,chroma_acts
1,7,166.18666666666664,227.14666666666665,60.96000000000001,347,474,127,chroma_acts
1,8,227.14666666666665,259.995,32.84833333333336,474,541,67,chroma_acts
1,1,0.0,15.466666666666667,15.466666666666667,0,33,33,chroma_acts_smoothed
1,2,15.466666666666667,28.426666666666666,12.959999999999999,33,60,27,chroma_acts_smoothed
1,3,28.426666666666666,60.586666666666666,32.16,60,127,67,chroma_acts_smoothed
1,4,60.586666666666666,120.58666666666666,59.99999999999999,127,252,125,chroma_acts_smoothed
1,5,120.58666666666666,148.90666666666664,28.31999999999998,252,311,59,chroma_acts_smoothed
1,6,148.90666666666664,166.18666666666664,17.28,311,347,36,chroma_acts_smoothed
1,7,166.18666666666664,228.58666666666664,62.400000000000006,347,477,130,chroma_acts_smoothed
1,8,228.58666666666664,259.995,31.40833333333336,477,541,64,chroma_acts_smoothed
1,1,0.0,15.466666666666667,15.466666666666667,0,33,33,ki_chroma
1,2,15.466666666666667,28.426666666666666,12.959999999999999,33,60,27,ki_chroma
1,3,28.426666666666666,60.586666666666666,32.16,60,127,67,ki_chroma
1,4,60.586666666666666,120.58666666666666,59.99999999999999,127,252,125,ki_chroma
1,5,120.58666666666666,150.82666666666665,30.239999999999995,252,315,63,ki_chroma
1,6,150.82666666666665,166.18666666666664,15.359999999999985,315,347,32,ki_chroma
1,7,166.18666666666664,227.14666666666665,60.96000000000001,347,474,127,ki_chroma
1,8,227.14666666666665,259.995,32.84833333333336,474,541,67,ki_chroma
1,1,0.0,15.466666666666667,15.466666666666667,0,33,33,ki_chroma_acts
1,2,15.466666666666667,28.426666666666666,12.959999999999999,33,60,27,ki_chroma_acts
1,3,28.426666666666666,60.586666666666666,32.16,60,127,67,ki_chroma_acts
1,4,60.586666666666666,120.58666666666666,59.99999999999999,127,252,125,ki_chroma_acts
1,5,120.58666666666666,148.90666666666664,28.31999999999998,252,311,59,ki_chroma_acts
1,6,148.90666666666664,166.18666666666664,17.28,311,347,36,ki_chroma_acts
1,7,166.18666666666664,227.14666666666665,60.96000000000001,347,474,127,ki_chroma_acts
1,8,227.14666666666665,259.995,32.84833333333336,474,541,67,ki_chroma_acts
1,1,0.0,15.466666666666667,15.466666666666667,0,33,33,ki_chroma_acts_smoothed
1,2,15.466666666666667,28.426666666666666,12.959999999999999,33,60,27,ki_chroma_acts_smoothed
1,3,28.426666666666666,60.586666666666666,32.16,60,127,67,ki_chroma_acts_smoothed
1,4,60.586666666666666,120.58666666666666,59.99999999999999,127,252,125,ki_chroma_acts_smoothed
1,5,120.58666666666666,148.90666666666664,28.31999999999998,252,311,59,ki_chroma_acts_smoothed
1,6,148.90666666666664,166.18666666666664,17.28,311,347,36,ki_chroma_acts_smoothed
1,7,166.18666666666664,228.58666666666664,62.400000000000006,347,477,130,ki_chroma_acts_smoothed
1,8,228.58666666666664,259.995,31.40833333333336,477,541,64,ki_chroma_acts_smoothed
2,1,0.0,13.536,13.536,0,29,29,chromagram
2,2,13.536,14.975999999999999,1.4399999999999995,29,32,3,chromagram
2,3,14.975999999999999,44.25599999999999,29.279999999999994,32,93,61,chromagram
2,4,44.25599999999999,76.896,32.64000000000001,93,161,68,chromagram
2,5,76.896,91.776,14.879999999999995,161,192,31,chromagram
2,6,91.776,136.416,44.64,192,285,93,chromagram
2,7,136.416,169.05599999999998,32.639999999999986,285,353,68,chromagram
2,8,169.05599999999998,183.936,14.880000000000024,353,384,31,chromagram
2,9,183.936,276.425,92.489,384,575,191,chromagram
2,1,0.0,44.25599999999999,44.25599999999999,0,93,93,chroma_acts
2,2,44.25599999999999,76.896,32.64000000000001,93,161,68,chroma_acts
2,3,76.896,84.576,7.679999999999993,161,177,16,chroma_acts
2,4,84.576,91.776,7.200000000000003,177,192,15,chroma_acts
2,5,91.776,136.416,44.64,192,285,93,chroma_acts
2,6,136.416,169.05599999999998,32.639999999999986,285,353,68,chroma_acts
2,7,169.05599999999998,176.736,7.680000000000007,353,369,16,chroma_acts
2,8,176.736,183.936,7.200000000000017,369,384,15,chroma_acts
2,9,183.936,276.425,92.489,384,575,191,chroma_acts
2,1,0.0,43.775999999999996,43.775999999999996,0,92,92,chroma_acts_smoothed
2,2,43.775999999999996,76.896,33.120000000000005,92,161,69,chroma_acts_smoothed
2,3,76.896,82.656,5.760000000000005,161,173,12,chroma_acts_smoothed
2,4,82.656,92.256,9.599999999999994,173,193,20,chroma_acts_smoothed
2,5,92.256,135.936,43.68000000000001,193,284,91,chroma_acts_smoothed
2,6,135.936,169.05599999999998,33.119999999999976,284,353,69,chroma_acts_smoothed
2,7,169.05599999999998,176.736,7.680000000000007,353,369,16,chroma_acts_smoothed
2,8,176.736,184.416,7.680000000000007,369,385,16,chroma_acts_smoothed
2,9,184.416,276.425,92.00900000000001,385,575,190,chroma_acts_smoothed
2,1,0.0,13.536,13.536,0,29,29,ki_chroma
2,2,13.536,14.975999999999999,1.4399999999999995,29,32,3,ki_chroma
2,3,14.975999999999999,44.25599999999999,29.279999999999994,32,93,61,ki_chroma
2,4,44.25599999999999,76.896,32.64000000000001,93,161,68,ki_chroma
2,5,76.896,91.776,14.879999999999995,161,192,31,ki_chroma
2,6,91.776,136.416,44.64,192,285,93,ki_chroma
2,7,136.416,169.05599999999998,32.639999999999986,285,353,68,ki_chroma
2,8,169.05599999999998,183.936,14.880000000000024,353,384,31,ki_chroma
2,9,183.936,276.425,92.489,384,575,191,ki_chroma
2,1,0.0,44.25599999999999,44.25599999999999,0,93,93,ki_chroma_acts
2,2,44.25599999999999,76.896,32.64000000000001,93,161,68,ki_chroma_acts
2,3,76.896,84.576,7.679999999999993,161,177,16,ki_chroma_acts
2,4,84.576,91.776,7.200000000000003,177,192,15,ki_chroma_acts
2,5,91.776,136.416,44.64,192,285,93,ki_chroma_acts
2,6,136.416,169.05599999999998,32.639999999999986,285,353,68,ki_chroma_acts
2,7,169.05599999999998,176.736,7.680000000000007,353,369,16,ki_chroma_acts
2,8,176.736,183.936,7.200000000000017,369,384,15,ki_chroma_acts
2,9,183.936,276.425,92.489,384,575,191,ki_chroma_acts
2,1,0.0,43.775999999999996,43.775999999999996,0,92,92,ki_chroma_acts_smoothed
2,2,43.775999999999996,76.896,33.120000000000005,92,161,69,ki_chroma_acts_smoothed
2,3,76.896,82.656,5.760000000000005,161,173,12,ki_chroma_acts_smoothed
2,4,82.656,92.256,9.599999999999994,173,193,20,ki_chroma_acts_smoothed
2,5,92.256,135.936,43.68000000000001,193,284,91,ki_chroma_acts_smoothed
2,6,135.936,169.05599999999998,33.119999999999976,284,353,69,ki_chroma_acts_smoothed
2,7,169.05599999999998,176.736,7.680000000000007,353,369,16,ki_chroma_acts_smoothed
2,8,176.736,184.416,7.680000000000007,369,385,16,ki_chroma_acts_smoothed
2,9,184.416,276.425,92.00900000000001,385,575,190,ki_chroma_acts_smoothed
3,1,0.0,13.194666666666667,13.194666666666667,0,28,28,chromagram
3,2,13.194666666666667,47.27466666666667,34.08,28,99,71,chromagram
3,3,47.27466666666667,91.43466666666666,44.15999999999999,99,191,92,chromagram
3,4,91.43466666666666,123.11466666666666,31.680000000000007,191,257,66,chromagram
3,5,123.11466666666666,160.07466666666667,36.96000000000001,257,334,77,chromagram
3,6,160.07466666666667,161.51466666666667,1.4399999999999977,334,337,3,chromagram
3,7,161.51466666666667,179.529,18.014333333333326,337,373,36,chromagram
3,1,0.0,13.194666666666667,13.194666666666667,0,28,28,chroma_acts
3,2,13.194666666666667,47.27466666666667,34.08,28,99,71,chroma_acts
3,3,47.27466666666667,91.43466666666666,44.15999999999999,99,191,92,chroma_acts
3,4,91.43466666666666,115.91466666666666,24.480000000000004,191,242,51,chroma_acts
3,5,115.91466666666666,123.11466666666666,7.200000000000003,242,257,15,chroma_acts
3,6,123.11466666666666,161.51466666666667,38.400000000000006,257,337,80,chroma_acts
3,7,161.51466666666667,179.529,18.014333333333326,337,373,36,chroma_acts
3,1,0.0,13.194666666666667,13.194666666666667,0,28,28,chroma_acts_smoothed
3,2,13.194666666666667,47.754666666666665,34.56,28,100,72,chroma_acts_smoothed
3,3,47.754666666666665,91.43466666666666,43.67999999999999,100,191,91,chroma_acts_smoothed
3,4,91.43466666666666,116.39466666666665,24.959999999999994,191,243,52,chroma_acts_smoothed
3,5,116.39466666666665,123.11466666666666,6.720000000000013,243,257,14,chroma_acts_smoothed
3,6,123.11466666666666,161.51466666666667,38.400000000000006,257,337,80,chroma_acts_smoothed
3,7,161.51466666666667,179.529,18.014333333333326,337,373,36,chroma_acts_smoothed
3,1,0.0,13.194666666666667,13.194666666666667,0,28,28,ki_chroma
3,2,13.194666666666667,47.27466666666667,34.08,28,99,71,ki_chroma
3,3,47.27466666666667,91.43466666666666,44.15999999999999,99,191,92,ki_chroma
3,4,91.43466666666666,123.11466666666666,31.680000000000007,191,257,66,ki_chroma
3,5,123.11466666666666,160.07466666666667,36.96000000000001,257,334,77,ki_chroma
3,6,160.07466666666667,161.51466666666667,1.4399999999999977,334,337,3,ki_chroma
3,7,161.51466666666667,179.529,18.014333333333326,337,373,36,ki_chroma
3,1,0.0,13.194666666666667,13.194666666666667,0,28,28,ki_chroma_acts
3,2,13.194666666666667,47.27466666666667,34.08,28,99,71,ki_chroma_acts
3,3,47.27466666666667,91.43466666666666,44.15999999999999,99,191,92,ki_chroma_acts
3,4,91.43466666666666,115.91466666666666,24.480000000000004,191,242,51,ki_chroma_acts
3,5,115.91466666666666,123.11466666666666,7.200000000000003,242,257,15,ki_chroma_acts
3,6,123.11466666666666,161.51466666666667,38.400000000000006,257,337,80,ki_chroma_acts
3,7,161.51466666666667,179.529,18.014333333333326,337,373,36,ki_chroma_acts
3,1,0.0,13.194666666666667,13.194666666666667,0,28,28,ki_chroma_acts_smoothed
3,2,13.194666666666667,47.754666666666665,34.56,28,100,72,ki_chroma_acts_smoothed
3,3,47.754666666666665,91.43466666666666,43.67999999999999,100,191,91,ki_chroma_acts_smoothed
3,4,91.43466666666666,116.39466666666665,24.959999999999994,191,243,52,ki_chroma_acts_smoothed
3,5,116.39466666666665,123.11466666666666,6.720000000000013,243,257,14,ki_chroma_acts_smoothed
3,6,123.11466666666666,161.51466666666667,38.400000000000006,257,337,80,ki_chroma_acts_smoothed
3,7,161.51466666666667,179.529,18.014333333333326,337,373,36,ki_chroma_acts_smoothed
6,1,0.0,8.682666666666666,8.682666666666666,0,19,19,chromagram
6,2,8.682666666666666,15.882666666666665,7.199999999999999,19,34,15,chromagram
6,3,15.882666666666665,31.722666666666665,15.84,34,67,33,chromagram
6,4,31.722666666666665,61.00266666666666,29.279999999999998,67,128,61,chromagram
6,5,61.00266666666666,92.20266666666666,31.199999999999996,128,193,65,chromagram
6,6,92.20266666666666,122.92266666666666,30.72,193,257,64,chromagram
6,7,122.92266666666666,156.04266666666666,33.120000000000005,257,326,69,chromagram
6,8,156.04266666666666,203.799,47.756333333333345,326,424,98,chromagram
6,1,0.0,8.682666666666666,8.682666666666666,0,19,19,chroma_acts
6,2,8.682666666666666,15.882666666666665,7.199999999999999,19,34,15,chroma_acts
6,3,15.882666666666665,31.722666666666665,15.84,34,67,33,chroma_acts
6,4,31.722666666666665,61.00266666666666,29.279999999999998,67,128,61,chroma_acts
6,5,61.00266666666666,92.20266666666666,31.199999999999996,128,193,65,chroma_acts
6,6,92.20266666666666,122.92266666666666,30.72,193,257,64,chroma_acts
6,7,122.92266666666666,156.04266666666666,33.120000000000005,257,326,69,chroma_acts
6,8,156.04266666666666,203.799,47.756333333333345,326,424,98,chroma_acts
6,1,0.0,8.682666666666666,8.682666666666666,0,19,19,chroma_acts_smoothed
6,2,8.682666666666666,16.362666666666666,7.68,19,35,16,chroma_acts_smoothed
6,3,16.362666666666666,31.722666666666665,15.36,35,67,32,chroma_acts_smoothed
6,4,31.722666666666665,60.522666666666666,28.8,67,127,60,chroma_acts_smoothed
6,5,60.522666666666666,92.20266666666666,31.679999999999993,127,193,66,chroma_acts_smoothed
6,6,92.20266666666666,122.92266666666666,30.72,193,257,64,chroma_acts_smoothed
6,7,122.92266666666666,155.56266666666667,32.640000000000015,257,325,68,chroma_acts_smoothed
6,8,155.56266666666667,203.799,48.236333333333334,325,424,99,chroma_acts_smoothed
6,1,0.0,8.682666666666666,8.682666666666666,0,19,19,ki_chroma
6,2,8.682666666666666,15.882666666666665,7.199999999999999,19,34,15,ki_chroma
6,3,15.882666666666665,31.722666666666665,15.84,34,67,33,ki_chroma
6,4,31.722666666666665,61.00266666666666,29.279999999999998,67,128,61,ki_chroma
6,5,61.00266666666666,92.20266666666666,31.199999999999996,128,193,65,ki_chroma
6,6,92.20266666666666,122.92266666666666,30.72,193,257,64,ki_chroma
6,7,122.92266666666666,156.04266666666666,33.120000000000005,257,326,69,ki_chroma
6,8,156.04266666666666,203.799,47.756333333333345,326,424,98,ki_chroma
6,1,0.0,8.682666666666666,8.682666666666666,0,19,19,ki_chroma_acts
6,2,8.682666666666666,15.882666666666665,7.199999999999999,19,34,15,ki_chroma_acts
6,3,15.882666666666665,31.722666666666665,15.84,34,67,33,ki_chroma_acts
6,4,31.722666666666665,61.00266666666666,29.279999999999998,67,128,61,ki_chroma_acts
6,5,61.00266666666666,92.20266666666666,31.199999999999996,128,193,65,ki_chroma_acts
6,6,92.20266666666666,122.92266666666666,30.72,193,257,64,ki_chroma_acts
6,7,122.92266666666666,156.04266666666666,33.120000000000005,257,326,69,ki_chroma_acts
6,8,156.04266666666666,203.799,47.756333333333345,326,424,98,ki_chroma_acts
6,1,0.0,8.682666666666666,8.682666666666666,0,19,19,ki_chroma_acts_smoothed
6,2,8.682666666666666,16.362666666666666,7.68,19,35,16,ki_chroma_acts_smoothed
6,3,16.362666666666666,31.722666666666665,15.36,35,67,32,ki_chroma_acts_smoothed
6,4,31.722666666666665,60.522666666666666,28.8,67,127,60,ki_chroma_acts_smoothed
6,5,60.522666666666666,92.20266666666666,31.679999999999993,127,193,66,ki_chroma_acts_smoothed
6,6,92.20266666666666,122.92266666666666,30.72,193,257,64,ki_chroma_acts_smoothed
6,7,122.92266666666666,155.56266666666667,32.640000000000015,257,325,68,ki_chroma_acts_smoothed
6,8,155.56266666666667,203.799,48.236333333333334,325,424,99,ki_chroma_acts_smoothed
7,1,0.0,29.898666666666664,29.898666666666664,0,63,63,chromagram
7,2,29.898666666666664,53.41866666666667,23.520000000000003,63,112,49,chromagram
7,3,53.41866666666667,76.93866666666666,23.519999999999996,112,161,49,chromagram
7,4,76.93866666666666,92.29866666666666,15.36,161,193,32,chromagram
7,5,92.29866666666666,149.89866666666666,57.599999999999994,193,313,120,chromagram
7,6,149.89866666666666,230.53866666666664,80.63999999999999,313,481,168,chromagram
7,7,230.53866666666664,253.57866666666666,23.04000000000002,481,529,48,chromagram
7,8,253.57866666666666,291.4986666666667,37.920000000000016,529,608,79,chromagram
7,9,291.4986666666667,323.466,31.96733333333333,608,673,65,chromagram
7,1,0.0,29.418666666666663,29.418666666666663,0,62,62,chroma_acts
7,2,29.418666666666663,57.25866666666666,27.84,62,120,58,chroma_acts
7,3,57.25866666666666,80.77866666666667,23.520000000000003,120,169,49,chroma_acts
7,4,80.77866666666667,115.33866666666665,34.55999999999999,169,241,72,chroma_acts
7,5,115.33866666666665,149.89866666666666,34.56,241,313,72,chroma_acts
7,6,149.89866666666666,199.81866666666667,49.920000000000016,313,417,104,chroma_acts
7,7,199.81866666666667,233.41866666666667,33.599999999999994,417,487,70,chroma_acts
7,8,233.41866666666667,291.4986666666667,58.08000000000001,487,608,121,chroma_acts
7,9,291.4986666666667,323.466,31.96733333333333,608,673,65,chroma_acts
7,1,0.0,29.418666666666663,29.418666666666663,0,62,62,chroma_acts_smoothed
7,2,29.418666666666663,57.25866666666666,27.84,62,120,58,chroma_acts_smoothed
7,3,57.25866666666666,115.33866666666665,58.07999999999999,120,241,121,chroma_acts_smoothed
7,4,115.33866666666665,150.37866666666665,35.03999999999999,241,314,73,chroma_acts_smoothed
7,5,150.37866666666665,199.81866666666667,49.440000000000026,314,417,103,chroma_acts_smoothed
7,6,199.81866666666667,230.53866666666664,30.71999999999997,417,481,64,chroma_acts_smoothed
7,7,230.53866666666664,252.13866666666667,21.600000000000023,481,526,45,chroma_acts_smoothed
7,8,252.13866666666667,291.4986666666667,39.360000000000014,526,608,82,chroma_acts_smoothed
7,9,291.4986666666667,323.466,31.96733333333333,608,673,65,chroma_acts_smoothed
7,1,0.0,29.898666666666664,29.898666666666664,0,63,63,ki_chroma
7,2,29.898666666666664,53.41866666666667,23.520000000000003,63,112,49,ki_chroma
7,3,53.41866666666667,76.93866666666666,23.519999999999996,112,161,49,ki_chroma
7,4,76.93866666666666,92.29866666666666,15.36,161,193,32,ki_chroma
7,5,92.29866666666666,149.89866666666666,57.599999999999994,193,313,120,ki_chroma
7,6,149.89866666666666,230.53866666666664,80.63999999999999,313,481,168,ki_chroma
7,7,230.53866666666664,253.57866666666666,23.04000000000002,481,529,48,ki_chroma
7,8,253.57866666666666,291.4986666666667,37.920000000000016,529,608,79,ki_chroma
7,9,291.4986666666667,323.466,31.96733333333333,608,673,65,ki_chroma
7,1,0.0,29.418666666666663,29.418666666666663,0,62,62,ki_chroma_acts
7,2,29.418666666666663,57.25866666666666,27.84,62,120,58,ki_chroma_acts
7,3,57.25866666666666,80.77866666666667,23.520000000000003,120,169,49,ki_chroma_acts
7,4,80.77866666666667,115.33866666666665,34.55999999999999,169,241,72,ki_chroma_acts
7,5,115.33866666666665,149.89866666666666,34.56,241,313,72,ki_chroma_acts
7,6,149.89866666666666,199.81866666666667,49.920000000000016,313,417,104,ki_chroma_acts
7,7,199.81866666666667,233.41866666666667,33.599999999999994,417,487,70,ki_chroma_acts
7,8,233.41866666666667,291.4986666666667,58.08000000000001,487,608,121,ki_chroma_acts
7,9,291.4986666666667,323.466,31.96733333333333,608,673,65,ki_chroma_acts
7,1,0.0,29.418666666666663,29.418666666666663,0,62,62,ki_chroma_acts_smoothed
7,2,29.418666666666663,57.25866666666666,27.84,62,120,58,ki_chroma_acts_smoothed
7,3,57.25866666666666,115.33866666666665,58.07999999999999,120,241,121,ki_chroma_acts_smoothed
7,4,115.33866666666665,150.37866666666665,35.03999999999999,241,314,73,ki_chroma_acts_smoothed
7,5,150.37866666666665,199.81866666666667,49.440000000000026,314,417,103,ki_chroma_acts_smoothed
7,6,199.81866666666667,230.53866666666664,30.71999999999997,417,481,64,ki_chroma_acts_smoothed
7,7,230.53866666666664,252.13866666666667,21.600000000000023,481,526,45,ki_chroma_acts_smoothed
7,8,252.13866666666667,291.4986666666667,39.360000000000014,526,608,82,ki_chroma_acts_smoothed
7,9,291.4986666666667,323.466,31.96733333333333,608,673,65,ki_chroma_acts_smoothed
8,1,0.0,9.621333333333332,9.621333333333332,0,19,19,chromagram
8,2,9.621333333333332,52.47999999999999,42.85866666666666,19,101,82,chromagram
8,3,52.47999999999999,56.661333333333324,4.181333333333335,101,109,8,chromagram
8,4,56.661333333333324,65.024,8.362666666666676,109,125,16,chromagram
8,5,65.024,129.83466666666666,64.81066666666666,125,249,124,chromagram
8,6,129.83466666666666,169.03466666666665,39.19999999999999,249,324,75,chromagram
8,7,169.03466666666665,181.57866666666666,12.544000000000011,324,348,24,chromagram
8,8,181.57866666666666,273.391,91.81233333333336,348,522,174,chromagram
8,1,0.0,8.575999999999999,8.575999999999999,0,17,17,chroma_acts
8,2,8.575999999999999,52.47999999999999,43.90399999999999,17,101,84,chroma_acts
8,3,52.47999999999999,65.024,12.544000000000011,101,125,24,chroma_acts
8,4,65.024,169.03466666666665,104.01066666666665,125,324,199,chroma_acts
8,5,169.03466666666665,173.73866666666666,4.704000000000008,324,333,9,chroma_acts
8,6,173.73866666666666,177.3973333333333,3.6586666666666474,333,340,7,chroma_acts
8,7,177.3973333333333,181.57866666666666,4.181333333333356,340,348,8,chroma_acts
8,8,181.57866666666666,273.391,91.81233333333336,348,522,174,chroma_acts
8,1,0.0,10.143999999999998,10.143999999999998,0,20,20,chroma_acts_smoothed
8,2,10.143999999999998,52.47999999999999,42.33599999999999,20,101,81,chroma_acts_smoothed
8,3,52.47999999999999,56.661333333333324,4.181333333333335,101,109,8,chroma_acts_smoothed
8,4,56.661333333333324,60.84266666666666,4.181333333333335,109,117,8,chroma_acts_smoothed
8,5,60.84266666666666,65.024,4.181333333333342,117,125,8,chroma_acts_smoothed
8,6,65.024,169.03466666666665,104.01066666666665,125,324,199,chroma_acts_smoothed
8,7,169.03466666666665,181.57866666666666,12.544000000000011,324,348,24,chroma_acts_smoothed
8,8,181.57866666666666,273.391,91.81233333333336,348,522,174,chroma_acts_smoothed
8,1,0.0,9.621333333333332,9.621333333333332,0,19,19,ki_chroma
8,2,9.621333333333332,52.47999999999999,42.85866666666666,19,101,82,ki_chroma
8,3,52.47999999999999,56.661333333333324,4.181333333333335,101,109,8,ki_chroma
8,4,56.661333333333324,65.024,8.362666666666676,109,125,16,ki_chroma
8,5,65.024,129.83466666666666,64.81066666666666,125,249,124,ki_chroma
8,6,129.83466666666666,169.03466666666665,39.19999999999999,249,324,75,ki_chroma
8,7,169.03466666666665,181.57866666666666,12.544000000000011,324,348,24,ki_chroma
8,8,181.57866666666666,273.391,91.81233333333336,348,522,174,ki_chroma
8,1,0.0,8.575999999999999,8.575999999999999,0,17,17,ki_chroma_acts
8,2,8.575999999999999,52.47999999999999,43.90399999999999,17,101,84,ki_chroma_acts
8,3,52.47999999999999,65.024,12.544000000000011,101,125,24,ki_chroma_acts
8,4,65.024,169.03466666666665,104.01066666666665,125,324,199,ki_chroma_acts
8,5,169.03466666666665,173.73866666666666,4.704000000000008,324,333,9,ki_chroma_acts
8,6,173.73866666666666,177.3973333333333,3.6586666666666474,333,340,7,ki_chroma_acts
8,7,177.3973333333333,181.57866666666666,4.181333333333356,340,348,8,ki_chroma_acts
8,8,181.57866666666666,273.391,91.81233333333336,348,522,174,ki_chroma_acts
8,1,0.0,10.143999999999998,10.143999999999998,0,20,20,ki_chroma_acts_smoothed
8,2,10.143999999999998,52.47999999999999,42.33599999999999,20,101,81,ki_chroma_acts_smoothed
8,3,52.47999999999999,56.661333333333324,4.181333333333335,101,109,8,ki_chroma_acts_smoothed
8,4,56.661333333333324,60.84266666666666,4.181333333333335,109,117,8,ki_chroma_acts_smoothed
8,5,60.84266666666666,65.024,4.181333333333342,117,125,8,ki_chroma_acts_smoothed
8,6,65.024,169.03466666666665,104.01066666666665,125,324,199,ki_chroma_acts_smoothed
8,7,169.03466666666665,181.57866666666666,12.544000000000011,324,348,24,ki_chroma_acts_smoothed
8,8,181.57866666666666,273.391,91.81233333333336,348,522,174,ki_chroma_acts_smoothed
10,1,0.0,30.186666666666667,30.186666666666667,0,62,62,chromagram
10,2,30.186666666666667,46.37866666666667,16.192,62,95,33,chromagram
10,3,46.37866666666667,93.97333333333334,47.594666666666676,95,192,97,chromagram
10,4,93.97333333333334,97.89866666666667,3.9253333333333273,192,200,8,chromagram
10,5,97.89866666666667,101.82400000000001,3.9253333333333416,200,208,8,chromagram
10,6,101.82400000000001,132.24533333333335,30.421333333333337,208,270,62,chromagram
10,7,132.24533333333335,135.68,3.434666666666658,270,277,7,chromagram
10,8,135.68,140.58666666666667,4.906666666666666,277,287,10,chromagram
10,9,140.58666666666667,172.83,32.24333333333334,287,351,64,chromagram
10,1,0.0,46.86933333333334,46.86933333333334,0,96,96,chroma_acts
10,2,46.86933333333334,93.48266666666667,46.61333333333334,96,191,95,chroma_acts
10,3,93.48266666666667,97.89866666666667,4.415999999999997,191,200,9,chroma_acts
10,4,97.89866666666667,101.82400000000001,3.9253333333333416,200,208,8,chroma_acts
10,5,101.82400000000001,105.74933333333334,3.9253333333333273,208,216,8,chroma_acts
10,6,105.74933333333334,113.60000000000001,7.850666666666669,216,232,16,chroma_acts
10,7,113.60000000000001,117.52533333333334,3.9253333333333273,232,240,8,chroma_acts
10,8,117.52533333333334,140.58666666666667,23.061333333333337,240,287,47,chroma_acts
10,9,140.58666666666667,172.83,32.24333333333334,287,351,64,chroma_acts
10,1,0.0,4.672000000000001,4.672000000000001,0,10,10,chroma_acts_smoothed
10,2,4.672000000000001,8.106666666666667,3.4346666666666668,10,17,7,chroma_acts_smoothed
10,3,8.106666666666667,19.88266666666667,11.776000000000002,17,41,24,chroma_acts_smoothed
10,4,19.88266666666667,47.85066666666667,27.968,41,98,57,chroma_acts_smoothed
10,5,47.85066666666667,94.464,46.61333333333333,98,193,95,chroma_acts_smoothed
10,6,94.464,97.89866666666667,3.434666666666672,193,200,7,chroma_acts_smoothed
10,7,97.89866666666667,101.82400000000001,3.9253333333333416,200,208,8,chroma_acts_smoothed
10,8,101.82400000000001,140.58666666666667,38.76266666666666,208,287,79,chroma_acts_smoothed
10,9,140.58666666666667,172.83,32.24333333333334,287,351,64,chroma_acts_smoothed
10,1,0.0,30.186666666666667,30.186666666666667,0,62,62,ki_chroma
10,2,30.186666666666667,46.37866666666667,16.192,62,95,33,ki_chroma
10,3,46.37866666666667,93.97333333333334,47.594666666666676,95,192,97,ki_chroma
10,4,93.97333333333334,97.89866666666667,3.9253333333333273,192,200,8,ki_chroma
10,5,97.89866666666667,101.82400000000001,3.9253333333333416,200,208,8,ki_chroma
10,6,101.82400000000001,132.24533333333335,30.421333333333337,208,270,62,ki_chroma
10,7,132.24533333333335,135.68,3.434666666666658,270,277,7,ki_chroma
10,8,135.68,140.58666666666667,4.906666666666666,277,287,10,ki_chroma
10,9,140.58666666666667,172.83,32.24333333333334,287,351,64,ki_chroma
10,1,0.0,46.86933333333334,46.86933333333334,0,96,96,ki_chroma_acts
10,2,46.86933333333334,93.48266666666667,46.61333333333334,96,191,95,ki_chroma_acts
10,3,93.48266666666667,97.89866666666667,4.415999999999997,191,200,9,ki_chroma_acts
10,4,97.89866666666667,101.82400000000001,3.9253333333333416,200,208,8,ki_chroma_acts
10,5,101.82400000000001,105.74933333333334,3.9253333333333273,208,216,8,ki_chroma_acts
10,6,105.74933333333334,113.60000000000001,7.850666666666669,216,232,16,ki_chroma_acts
10,7,113.60000000000001,117.52533333333334,3.9253333333333273,232,240,8,ki_chroma_acts
10,8,117.52533333333334,140.58666666666667,23.061333333333337,240,287,47,ki_chroma_acts
10,9,140.58666666666667,172.83,32.24333333333334,287,351,64,ki_chroma_acts
10,1,0.0,4.672000000000001,4.672000000000001,0,10,10,ki_chroma_acts_smoothed
10,2,4.672000000000001,8.106666666666667,3.4346666666666668,10,17,7,ki_chroma_acts_smoothed
10,3,8.106666666666667,19.88266666666667,11.776000000000002,17,41,24,ki_chroma_acts_smoothed
10,4,19.88266666666667,47.85066666666667,27.968,41,98,57,ki_chroma_acts_smoothed
10,5,47.85066666666667,94.464,46.61333333333333,98,193,95,ki_chroma_acts_smoothed
10,6,94.464,97.89866666666667,3.434666666666672,193,200,7,ki_chroma_acts_smoothed
10,7,97.89866666666667,101.82400000000001,3.9253333333333416,200,208,8,ki_chroma_acts_smoothed
10,8,101.82400000000001,140.58666666666667,38.76266666666666,208,287,79,ki_chroma_acts_smoothed
10,9,140.58666666666667,172.83,32.24333333333334,287,351,64,ki_chroma_acts_smoothed
11,1,0.0,23.808,23.808,0,50,50,chromagram
11,2,23.808,37.248,13.439999999999998,50,78,28,chromagram
11,3,37.248,81.888,44.64000000000001,78,171,93,chromagram
11,4,81.888,85.728,3.839999999999989,171,179,8,chromagram
11,5,85.728,116.928,31.200000000000003,179,244,65,chromagram
11,6,116.928,130.368,13.439999999999998,244,272,28,chromagram
11,7,130.368,174.528,44.16,272,364,92,chromagram
11,8,174.528,178.368,3.8400000000000034,364,372,8,chromagram
11,9,178.368,194.056,15.688000000000017,372,403,31,chromagram
11,1,0.0,23.808,23.808,0,50,50,chroma_acts
11,2,23.808,36.288,12.479999999999997,50,76,26,chroma_acts
11,3,36.288,81.888,45.60000000000001,76,171,95,chroma_acts
11,4,81.888,85.728,3.839999999999989,171,179,8,chroma_acts
11,5,85.728,116.928,31.200000000000003,179,244,65,chroma_acts
11,6,116.928,131.808,14.879999999999995,244,275,31,chroma_acts
11,7,131.808,170.688,38.879999999999995,275,356,81,chroma_acts
11,8,170.688,178.368,7.680000000000007,356,372,16,chroma_acts
11,9,178.368,194.056,15.688000000000017,372,403,31,chroma_acts
11,1,0.0,23.808,23.808,0,50,50,chroma_acts_smoothed
11,2,23.808,39.647999999999996,15.839999999999996,50,83,33,chroma_acts_smoothed
11,3,39.647999999999996,81.408,41.760000000000005,83,170,87,chroma_acts_smoothed
11,4,81.408,85.728,4.319999999999993,170,179,9,chroma_acts_smoothed
11,5,85.728,116.928,31.200000000000003,179,244,65,chroma_acts_smoothed
11,6,116.928,132.28799999999998,15.359999999999985,244,276,32,chroma_acts_smoothed
11,7,132.28799999999998,170.688,38.400000000000006,276,356,80,chroma_acts_smoothed
11,8,170.688,178.84799999999998,8.159999999999997,356,373,17,chroma_acts_smoothed
11,9,178.84799999999998,194.056,15.208000000000027,373,403,30,chroma_acts_smoothed
11,1,0.0,23.808,23.808,0,50,50,ki_chroma
11,2,23.808,37.248,13.439999999999998,50,78,28,ki_chroma
11,3,37.248,81.888,44.64000000000001,78,171,93,ki_chroma
11,4,81.888,85.728,3.839999999999989,171,179,8,ki_chroma
11,5,85.728,116.928,31.200000000000003,179,244,65,ki_chroma
11,6,116.928,130.368,13.439999999999998,244,272,28,ki_chroma
11,7,130.368,174.528,44.16,272,364,92,ki_chroma
11,8,174.528,178.368,3.8400000000000034,364,372,8,ki_chroma
11,9,178.368,194.056,15.688000000000017,372,403,31,ki_chroma
11,1,0.0,23.808,23.808,0,50,50,ki_chroma_acts
11,2,23.808,36.288,12.479999999999997,50,76,26,ki_chroma_acts
11,3,36.288,81.888,45.60000000000001,76,171,95,ki_chroma_acts
11,4,81.888,85.728,3.839999999999989,171,179,8,ki_chroma_acts
11,5,85.728,116.928,31.200000000000003,179,244,65,ki_chroma_acts
11,6,116.928,131.808,14.879999999999995,244,275,31,ki_chroma_acts
11,7,131.808,170.688,38.879999999999995,275,356,81,ki_chroma_acts
11,8,170.688,178.368,7.680000000000007,356,372,16,ki_chroma_acts
11,9,178.368,194.056,15.688000000000017,372,403,31,ki_chroma_acts
11,1,0.0,23.808,23.808,0,50,50,ki_chroma_acts_smoothed
11,2,23.808,39.647999999999996,15.839999999999996,50,83,33,ki_chroma_acts_smoothed
11,3,39.647999999999996,81.408,41.760000000000005,83,170,87,ki_chroma_acts_smoothed
11,4,81.408,85.728,4.319999999999993,170,179,9,ki_chroma_acts_smoothed
11,5,85.728,116.928,31.200000000000003,179,244,65,ki_chroma_acts_smoothed
11,6,116.928,132.28799999999998,15.359999999999985,244,276,32,ki_chroma_acts_smoothed
11,7,132.28799999999998,170.688,38.400000000000006,276,356,80,ki_chroma_acts_smoothed
11,8,170.688,178.84799999999998,8.159999999999997,356,373,17,ki_chroma_acts_smoothed
11,9,178.84799999999998,194.056,15.208000000000027,373,403,30,ki_chroma_acts_smoothed
12,1,0.0,32.160000000000004,32.160000000000004,0,66,66,chromagram
12,2,32.160000000000004,45.89866666666667,13.738666666666667,66,94,28,chromagram
12,3,45.89866666666667,48.352000000000004,2.453333333333333,94,99,5,chromagram
12,4,48.352000000000004,61.6,13.247999999999998,99,126,27,chromagram
12,5,61.6,87.11466666666666,25.514666666666663,126,178,52,chromagram
12,6,87.11466666666666,99.872,12.757333333333335,178,204,26,chromagram
12,7,99.872,126.36800000000001,26.49600000000001,204,258,54,chromagram
12,8,126.36800000000001,145.5,19.13199999999999,258,295,37,chromagram
12,1,0.0,23.818666666666665,23.818666666666665,0,49,49,chroma_acts
12,2,23.818666666666665,35.104,11.285333333333334,49,72,23,chroma_acts
12,3,35.104,45.89866666666667,10.794666666666672,72,94,22,chroma_acts
12,4,45.89866666666667,48.352000000000004,2.453333333333333,94,99,5,chroma_acts
12,5,48.352000000000004,60.61866666666667,12.266666666666666,99,124,25,chroma_acts
12,6,60.61866666666667,87.11466666666666,26.495999999999995,124,178,54,chroma_acts
12,7,87.11466666666666,126.36800000000001,39.253333333333345,178,258,80,chroma_acts
12,8,126.36800000000001,145.5,19.13199999999999,258,295,37,chroma_acts
12,1,0.0,26.762666666666668,26.762666666666668,0,55,55,chroma_acts_smoothed
12,2,26.762666666666668,44.91733333333333,18.154666666666664,55,92,37,chroma_acts_smoothed
12,3,44.91733333333333,48.352000000000004,3.434666666666672,92,99,7,chroma_acts_smoothed
12,4,48.352000000000004,60.61866666666667,12.266666666666666,99,124,25,chroma_acts_smoothed
12,5,60.61866666666667,87.11466666666666,26.495999999999995,124,178,54,chroma_acts_smoothed
12,6,87.11466666666666,97.90933333333334,10.794666666666672,178,200,22,chroma_acts_smoothed
12,7,97.90933333333334,126.36800000000001,28.458666666666673,200,258,58,chroma_acts_smoothed
12,8,126.36800000000001,145.5,19.13199999999999,258,295,37,chroma_acts_smoothed
12,1,0.0,32.160000000000004,32.160000000000004,0,66,66,ki_chroma
12,2,32.160000000000004,45.89866666666667,13.738666666666667,66,94,28,ki_chroma
12,3,45.89866666666667,48.352000000000004,2.453333333333333,94,99,5,ki_chroma
12,4,48.352000000000004,61.6,13.247999999999998,99,126,27,ki_chroma
12,5,61.6,87.11466666666666,25.514666666666663,126,178,52,ki_chroma
12,6,87.11466666666666,99.872,12.757333333333335,178,204,26,ki_chroma
12,7,99.872,126.36800000000001,26.49600000000001,204,258,54,ki_chroma
12,8,126.36800000000001,145.5,19.13199999999999,258,295,37,ki_chroma
12,1,0.0,23.818666666666665,23.818666666666665,0,49,49,ki_chroma_acts
12,2,23.818666666666665,35.104,11.285333333333334,49,72,23,ki_chroma_acts
12,3,35.104,45.89866666666667,10.794666666666672,72,94,22,ki_chroma_acts
12,4,45.89866666666667,48.352000000000004,2.453333333333333,94,99,5,ki_chroma_acts
12,5,48.352000000000004,60.61866666666667,12.266666666666666,99,124,25,ki_chroma_acts
12,6,60.61866666666667,87.11466666666666,26.495999999999995,124,178,54,ki_chroma_acts
12,7,87.11466666666666,126.36800000000001,39.253333333333345,178,258,80,ki_chroma_acts
12,8,126.36800000000001,145.5,19.13199999999999,258,295,37,ki_chroma_acts
12,1,0.0,26.762666666666668,26.762666666666668,0,55,55,ki_chroma_acts_smoothed
12,2,26.762666666666668,44.91733333333333,18.154666666666664,55,92,37,ki_chroma_acts_smoothed
12,3,44.91733333333333,48.352000000000004,3.434666666666672,92,99,7,ki_chroma_acts_smoothed
12,4,48.352000000000004,60.61866666666667,12.266666666666666,99,124,25,ki_chroma_acts_smoothed
12,5,60.61866666666667,87.11466666666666,26.495999999999995,124,178,54,ki_chroma_acts_smoothed
12,6,87.11466666666666,97.90933333333334,10.794666666666672,178,200,22,ki_chroma_acts_smoothed
12,7,97.90933333333334,126.36800000000001,28.458666666666673,200,258,58,ki_chroma_acts_smoothed
12,8,126.36800000000001,145.5,19.13199999999999,258,295,37,ki_chroma_acts_smoothed
13,1,0.0,22.56,22.56,0,49,49,chromagram
13,2,22.56,31.946666666666665,9.386666666666667,49,69,20,chromagram
13,3,31.946666666666665,57.76,25.813333333333333,69,124,55,chromagram
13,4,57.76,92.02133333333333,34.26133333333333,124,197,73,chromagram
13,5,92.02133333333333,110.79466666666666,18.773333333333326,197,237,40,chromagram
13,6,110.79466666666666,137.54666666666668,26.752000000000024,237,294,57,chromagram
13,7,137.54666666666668,144.58666666666667,7.039999999999992,294,309,15,chromagram
13,8,144.58666666666667,174.375,29.788333333333327,309,371,62,chromagram
13,1,0.0,17.397333333333332,17.397333333333332,0,38,38,chroma_acts
13,2,17.397333333333332,22.56,5.1626666666666665,38,49,11,chroma_acts
13,3,22.56,31.946666666666665,9.386666666666667,49,69,20,chroma_acts
13,4,31.946666666666665,92.02133333333333,60.074666666666666,69,197,128,chroma_acts
13,5,92.02133333333333,106.57066666666667,14.549333333333337,197,228,31,chroma_acts
13,6,106.57066666666667,137.54666666666668,30.976000000000013,228,294,66,chroma_acts
13,7,137.54666666666668,144.58666666666667,7.039999999999992,294,309,15,chroma_acts
13,8,144.58666666666667,174.375,29.788333333333327,309,371,62,chroma_acts
13,1,0.0,17.397333333333332,17.397333333333332,0,38,38,chroma_acts_smoothed
13,2,17.397333333333332,22.56,5.1626666666666665,38,49,11,chroma_acts_smoothed
13,3,22.56,31.946666666666665,9.386666666666667,49,69,20,chroma_acts_smoothed
13,4,31.946666666666665,92.02133333333333,60.074666666666666,69,197,128,chroma_acts_smoothed
13,5,92.02133333333333,109.38666666666666,17.365333333333325,197,234,37,chroma_acts_smoothed
13,6,109.38666666666666,137.54666666666668,28.160000000000025,234,294,60,chroma_acts_smoothed
13,7,137.54666666666668,144.58666666666667,7.039999999999992,294,309,15,chroma_acts_smoothed
13,8,144.58666666666667,174.375,29.788333333333327,309,371,62,chroma_acts_smoothed
13,1,0.0,22.56,22.56,0,49,49,ki_chroma
13,2,22.56,31.946666666666665,9.386666666666667,49,69,20,ki_chroma
13,3,31.946666666666665,57.76,25.813333333333333,69,124,55,ki_chroma
13,4,57.76,92.02133333333333,34.26133333333333,124,197,73,ki_chroma
13,5,92.02133333333333,110.79466666666666,18.773333333333326,197,237,40,ki_chroma
13,6,110.79466666666666,137.54666666666668,26.752000000000024,237,294,57,ki_chroma
13,7,137.54666666666668,144.58666666666667,7.039999999999992,294,309,15,ki_chroma
13,8,144.58666666666667,174.375,29.788333333333327,309,371,62,ki_chroma
13,1,0.0,17.397333333333332,17.397333333333332,0,38,38,ki_chroma_acts
13,2,17.397333333333332,22.56,5.1626666666666665,38,49,11,ki_chroma_acts
13,3,22.56,31.946666666666665,9.386666666666667,49,69,20,ki_chroma_acts
13,4,31.946666666666665,92.02133333333333,60.074666666666666,69,197,128,ki_chroma_acts
13,5,92.02133333333333,106.57066666666667,14.549333333333337,197,228,31,ki_chroma_acts
13,6,106.57066666666667,137.54666666666668,30.976000000000013,228,294,66,ki_chroma_acts
13,7,137.54666666666668,144.58666666666667,7.039999999999992,294,309,15,ki_chroma_acts
13,8,144.58666666666667,174.375,29.788333333333327,309,371,62,ki_chroma_acts
13,1,0.0,17.397333333333332,17.397333333333332,0,38,38,ki_chroma_acts_smoothed
13,2,17.397333333333332,22.56,5.1626666666666665,38,49,11,ki_chroma_acts_smoothed
13,3,22.56,31.946666666666665,9.386666666666667,49,69,20,ki_chroma_acts_smoothed
13,4,31.946666666666665,92.02133333333333,60.074666666666666,69,197,128,ki_chroma_acts_smoothed
13,5,92.02133333333333,109.38666666666666,17.365333333333325,197,234,37,ki_chroma_acts_smoothed
13,6,109.38666666666666,137.54666666666668,28.160000000000025,234,294,60,ki_chroma_acts_smoothed
13,7,137.54666666666668,144.58666666666667,7.039999999999992,294,309,15,ki_chroma_acts_smoothed
13,8,144.58666666666667,174.375,29.788333333333327,309,371,62,ki_chroma_acts_smoothed
18,1,0.0,28.906666666666666,28.906666666666666,0,62,62,chromagram
18,2,28.906666666666666,39.70133333333333,10.794666666666664,62,85,23,chromagram
18,3,39.70133333333333,43.455999999999996,3.7546666666666653,85,93,8,chromagram
18,4,43.455999999999996,47.21066666666666,3.7546666666666653,93,101,8,chromagram
18,5,47.21066666666666,65.984,18.773333333333333,101,141,40,chromagram
18,6,65.984,99.776,33.792,141,213,72,chromagram
18,7,99.776,148.594,48.818,213,316,103,chromagram
18,1,0.0,25.152,25.152,0,54,54,chroma_acts
18,2,25.152,39.70133333333333,14.54933333333333,54,85,31,chroma_acts
18,3,39.70133333333333,43.455999999999996,3.7546666666666653,85,93,8,chroma_acts
18,4,43.455999999999996,58.474666666666664,15.018666666666668,93,125,32,chroma_acts
18,5,58.474666666666664,62.22933333333333,3.7546666666666653,125,133,8,chroma_acts
18,6,62.22933333333333,65.984,3.7546666666666653,133,141,8,chroma_acts
18,7,65.984,99.776,33.792,141,213,72,chroma_acts
18,8,99.776,137.792,38.016000000000005,213,294,81,chroma_acts
18,9,137.792,148.594,10.801999999999992,294,316,22,chroma_acts
18,1,0.0,25.152,25.152,0,54,54,chroma_acts_smoothed
18,2,25.152,39.70133333333333,14.54933333333333,54,85,31,chroma_acts_smoothed
18,3,39.70133333333333,43.455999999999996,3.7546666666666653,85,93,8,chroma_acts_smoothed
18,4,43.455999999999996,58.474666666666664,15.018666666666668,93,125,32,chroma_acts_smoothed
18,5,58.474666666666664,62.22933333333333,3.7546666666666653,125,133,8,chroma_acts_smoothed
18,6,62.22933333333333,65.984,3.7546666666666653,133,141,8,chroma_acts_smoothed
18,7,65.984,99.776,33.792,141,213,72,chroma_acts_smoothed
18,8,99.776,137.792,38.016000000000005,213,294,81,chroma_acts_smoothed
18,9,137.792,148.594,10.801999999999992,294,316,22,chroma_acts_smoothed
18,1,0.0,28.906666666666666,28.906666666666666,0,62,62,ki_chroma
18,2,28.906666666666666,39.70133333333333,10.794666666666664,62,85,23,ki_chroma
18,3,39.70133333333333,43.455999999999996,3.7546666666666653,85,93,8,ki_chroma
18,4,43.455999999999996,47.21066666666666,3.7546666666666653,93,101,8,ki_chroma
18,5,47.21066666666666,65.984,18.773333333333333,101,141,40,ki_chroma
18,6,65.984,99.776,33.792,141,213,72,ki_chroma
18,7,99.776,148.594,48.818,213,316,103,ki_chroma
18,1,0.0,25.152,25.152,0,54,54,ki_chroma_acts
18,2,25.152,39.70133333333333,14.54933333333333,54,85,31,ki_chroma_acts
18,3,39.70133333333333,43.455999999999996,3.7546666666666653,85,93,8,ki_chroma_acts
18,4,43.455999999999996,58.474666666666664,15.018666666666668,93,125,32,ki_chroma_acts
18,5,58.474666666666664,62.22933333333333,3.7546666666666653,125,133,8,ki_chroma_acts
18,6,62.22933333333333,65.984,3.7546666666666653,133,141,8,ki_chroma_acts
18,7,65.984,99.776,33.792,141,213,72,ki_chroma_acts
18,8,99.776,137.792,38.016000000000005,213,294,81,ki_chroma_acts
18,9,137.792,148.594,10.801999999999992,294,316,22,ki_chroma_acts
18,1,0.0,25.152,25.152,0,54,54,ki_chroma_acts_smoothed
18,2,25.152,39.70133333333333,14.54933333333333,54,85,31,ki_chroma_acts_smoothed
18,3,39.70133333333333,43.455999999999996,3.7546666666666653,85,93,8,ki_chroma_acts_smoothed
18,4,43.455999999999996,58.474666666666664,15.018666666666668,93,125,32,ki_chroma_acts_smoothed
18,5,58.474666666666664,62.22933333333333,3.7546666666666653,125,133,8,ki_chroma_acts_smoothed
18,6,62.22933333333333,65.984,3.7546666666666653,133,141,8,ki_chroma_acts_smoothed
18,7,65.984,99.776,33.792,141,213,72,ki_chroma_acts_smoothed
18,8,99.776,137.792,38.016000000000005,213,294,81,ki_chroma_acts_smoothed
18,9,137.792,148.594,10.801999999999992,294,316,22,ki_chroma_acts_smoothed
19,1,0.0,30.826666666666664,30.826666666666664,0,65,65,chromagram
19,2,30.826666666666664,61.06666666666667,30.240000000000006,65,128,63,chromagram
19,3,61.06666666666667,84.58666666666666,23.51999999999999,128,177,49,chromagram
19,4,84.58666666666666,95.62666666666667,11.040000000000006,177,200,23,chromagram
19,5,95.62666666666667,122.98666666666666,27.36,200,257,57,chromagram
19,6,122.98666666666666,130.18666666666664,7.199999999999974,257,272,15,chromagram
19,7,130.18666666666664,158.98666666666665,28.80000000000001,272,332,60,chromagram
19,8,158.98666666666665,199.462,40.47533333333334,332,415,83,chromagram
19,1,0.0,30.826666666666664,30.826666666666664,0,65,65,chroma_acts
19,2,30.826666666666664,61.06666666666667,30.240000000000006,65,128,63,chroma_acts
19,3,61.06666666666667,80.74666666666667,19.68,128,169,41,chroma_acts
19,4,80.74666666666667,84.58666666666666,3.839999999999989,169,177,8,chroma_acts
19,5,84.58666666666666,95.62666666666667,11.040000000000006,177,200,23,chroma_acts
19,6,95.62666666666667,130.18666666666664,34.559999999999974,200,272,72,chroma_acts
19,7,130.18666666666664,158.98666666666665,28.80000000000001,272,332,60,chroma_acts
19,8,158.98666666666665,190.66666666666666,31.680000000000007,332,398,66,chroma_acts
19,9,190.66666666666666,199.462,8.795333333333332,398,415,17,chroma_acts
19,1,0.0,30.346666666666664,30.346666666666664,0,64,64,chroma_acts_smoothed
19,2,30.346666666666664,61.06666666666667,30.720000000000006,64,128,64,chroma_acts_smoothed
19,3,61.06666666666667,84.58666666666666,23.51999999999999,128,177,49,chroma_acts_smoothed
19,4,84.58666666666666,95.62666666666667,11.040000000000006,177,200,23,chroma_acts_smoothed
19,5,95.62666666666667,120.10666666666667,24.480000000000004,200,251,51,chroma_acts_smoothed
19,6,120.10666666666667,130.66666666666666,10.559999999999988,251,273,22,chroma_acts_smoothed
19,7,130.66666666666666,158.98666666666665,28.319999999999993,273,332,59,chroma_acts_smoothed
19,8,158.98666666666665,190.66666666666666,31.680000000000007,332,398,66,chroma_acts_smoothed
19,9,190.66666666666666,199.462,8.795333333333332,398,415,17,chroma_acts_smoothed
19,1,0.0,30.826666666666664,30.826666666666664,0,65,65,ki_chroma
19,2,30.826666666666664,61.06666666666667,30.240000000000006,65,128,63,ki_chroma
19,3,61.06666666666667,84.58666666666666,23.51999999999999,128,177,49,ki_chroma
19,4,84.58666666666666,95.62666666666667,11.040000000000006,177,200,23,ki_chroma
19,5,95.62666666666667,122.98666666666666,27.36,200,257,57,ki_chroma
19,6,122.98666666666666,130.18666666666664,7.199999999999974,257,272,15,ki_chroma
19,7,130.18666666666664,158.98666666666665,28.80000000000001,272,332,60,ki_chroma
19,8,158.98666666666665,199.462,40.47533333333334,332,415,83,ki_chroma
19,1,0.0,30.826666666666664,30.826666666666664,0,65,65,ki_chroma_acts
19,2,30.826666666666664,61.06666666666667,30.240000000000006,65,128,63,ki_chroma_acts
19,3,61.06666666666667,80.74666666666667,19.68,128,169,41,ki_chroma_acts
19,4,80.74666666666667,84.58666666666666,3.839999999999989,169,177,8,ki_chroma_acts
19,5,84.58666666666666,95.62666666666667,11.040000000000006,177,200,23,ki_chroma_acts
19,6,95.62666666666667,130.18666666666664,34.559999999999974,200,272,72,ki_chroma_acts
19,7,130.18666666666664,158.98666666666665,28.80000000000001,272,332,60,ki_chroma_acts
19,8,158.98666666666665,190.66666666666666,31.680000000000007,332,398,66,ki_chroma_acts
19,9,190.66666666666666,199.462,8.795333333333332,398,415,17,ki_chroma_acts
19,1,0.0,30.346666666666664,30.346666666666664,0,64,64,ki_chroma_acts_smoothed
19,2,30.346666666666664,61.06666666666667,30.720000000000006,64,128,64,ki_chroma_acts_smoothed
19,3,61.06666666666667,84.58666666666666,23.51999999999999,128,177,49,ki_chroma_acts_smoothed
19,4,84.58666666666666,95.62666666666667,11.040000000000006,177,200,23,ki_chroma_acts_smoothed
19,5,95.62666666666667,120.10666666666667,24.480000000000004,200,251,51,ki_chroma_acts_smoothed
19,6,120.10666666666667,130.66666666666666,10.559999999999988,251,273,22,ki_chroma_acts_smoothed
19,7,130.66666666666666,158.98666666666665,28.319999999999993,273,332,59,ki_chroma_acts_smoothed
19,8,158.98666666666665,190.66666666666666,31.680000000000007,332,398,66,ki_chroma_acts_smoothed
19,9,190.66666666666666,199.462,8.795333333333332,398,415,17,ki_chroma_acts_smoothed
20,1,0.0,32.17066666666666,32.17066666666666,0,65,65,chromagram
20,2,32.17066666666666,63.75466666666666,31.583999999999996,65,128,63,chromagram
20,3,63.75466666666666,109.87733333333333,46.12266666666667,128,220,92,chromagram
20,4,109.87733333333333,112.384,2.506666666666675,220,225,5,chromagram
20,5,112.384,115.392,3.0079999999999956,225,231,6,chromagram
20,6,115.392,150.98666666666665,35.594666666666654,231,302,71,chromagram
20,7,150.98666666666665,181.253,30.266333333333336,302,361,59,chromagram
20,1,0.0,32.17066666666666,32.17066666666666,0,65,65,chroma_acts
20,2,32.17066666666666,63.75466666666666,31.583999999999996,65,128,63,chroma_acts
20,3,63.75466666666666,105.86666666666666,42.112,128,212,84,chroma_acts
20,4,105.86666666666666,107.872,2.00533333333334,212,216,4,chroma_acts
20,5,107.872,109.87733333333333,2.0053333333333256,216,220,4,chroma_acts
20,6,109.87733333333333,113.88799999999999,4.0106666666666655,220,228,8,chroma_acts
20,7,113.88799999999999,181.253,67.365,228,361,133,chroma_acts
20,1,0.0,31.669333333333334,31.669333333333334,0,64,64,chroma_acts_smoothed
20,2,31.669333333333334,63.25333333333333,31.583999999999996,64,127,63,chroma_acts_smoothed
20,3,63.25333333333333,97.84533333333333,34.592,127,196,69,chroma_acts_smoothed
20,4,97.84533333333333,109.87733333333333,12.031999999999996,196,220,24,chroma_acts_smoothed
20,5,109.87733333333333,114.38933333333333,4.5120000000000005,220,229,9,chroma_acts_smoothed
20,6,114.38933333333333,149.98399999999998,35.594666666666654,229,300,71,chroma_acts_smoothed
20,7,149.98399999999998,181.253,31.269000000000005,300,361,61,chroma_acts_smoothed
20,1,0.0,32.17066666666666,32.17066666666666,0,65,65,ki_chroma
20,2,32.17066666666666,63.75466666666666,31.583999999999996,65,128,63,ki_chroma
20,3,63.75466666666666,109.87733333333333,46.12266666666667,128,220,92,ki_chroma
20,4,109.87733333333333,112.384,2.506666666666675,220,225,5,ki_chroma
20,5,112.384,115.392,3.0079999999999956,225,231,6,ki_chroma
20,6,115.392,150.98666666666665,35.594666666666654,231,302,71,ki_chroma
20,7,150.98666666666665,181.253,30.266333333333336,302,361,59,ki_chroma
20,1,0.0,32.17066666666666,32.17066666666666,0,65,65,ki_chroma_acts
20,2,32.17066666666666,63.75466666666666,31.583999999999996,65,128,63,ki_chroma_acts
20,3,63.75466666666666,105.86666666666666,42.112,128,212,84,ki_chroma_acts
20,4,105.86666666666666,107.872,2.00533333333334,212,216,4,ki_chroma_acts
20,5,107.872,109.87733333333333,2.0053333333333256,216,220,4,ki_chroma_acts
20,6,109.87733333333333,113.88799999999999,4.0106666666666655,220,228,8,ki_chroma_acts
20,7,113.88799999999999,181.253,67.365,228,361,133,ki_chroma_acts
20,1,0.0,31.669333333333334,31.669333333333334,0,64,64,ki_chroma_acts_smoothed
20,2,31.669333333333334,63.25333333333333,31.583999999999996,64,127,63,ki_chroma_acts_smoothed
20,3,63.25333333333333,97.84533333333333,34.592,127,196,69,ki_chroma_acts_smoothed
20,4,97.84533333333333,109.87733333333333,12.031999999999996,196,220,24,ki_chroma_acts_smoothed
20,5,109.87733333333333,114.38933333333333,4.5120000000000005,220,229,9,ki_chroma_acts_smoothed
20,6,114.38933333333333,149.98399999999998,35.594666666666654,229,300,71,ki_chroma_acts_smoothed
20,7,149.98399999999998,181.253,31.269000000000005,300,361,61,ki_chroma_acts_smoothed
21,1,0.0,33.62133333333333,33.62133333333333,0,71,71,chromagram
21,2,33.62133333333333,61.46133333333333,27.839999999999996,71,129,58,chromagram
21,3,61.46133333333333,68.66133333333333,7.200000000000003,129,144,15,chromagram
21,4,68.66133333333333,100.34133333333332,31.679999999999993,144,210,66,chromagram
21,5,100.34133333333332,124.82133333333333,24.480000000000004,210,261,51,chromagram
21,6,124.82133333333333,144.98133333333334,20.16000000000001,261,303,42,chromagram
21,7,144.98133333333334,160.34133333333332,15.359999999999985,303,335,32,chromagram
21,8,160.34133333333332,190.58133333333333,30.24000000000001,335,398,63,chromagram
21,9,190.58133333333333,209.179,18.59766666666667,398,435,37,chromagram
21,1,0.0,39.38133333333333,39.38133333333333,0,83,83,chroma_acts
21,2,39.38133333333333,53.78133333333333,14.399999999999999,83,113,30,chroma_acts
21,3,53.78133333333333,68.66133333333333,14.880000000000003,113,144,31,chroma_acts
21,4,68.66133333333333,100.34133333333332,31.679999999999993,144,210,66,chroma_acts
21,5,100.34133333333332,124.82133333333333,24.480000000000004,210,261,51,chroma_acts
21,6,124.82133333333333,144.98133333333334,20.16000000000001,261,303,42,chroma_acts
21,7,144.98133333333334,160.34133333333332,15.359999999999985,303,335,32,chroma_acts
21,8,160.34133333333332,190.58133333333333,30.24000000000001,335,398,63,chroma_acts
21,9,190.58133333333333,209.179,18.59766666666667,398,435,37,chroma_acts
21,1,0.0,38.42133333333333,38.42133333333333,0,81,81,chroma_acts_smoothed
21,2,38.42133333333333,53.78133333333333,15.36,81,113,32,chroma_acts_smoothed
21,3,53.78133333333333,69.14133333333334,15.360000000000007,113,145,32,chroma_acts_smoothed
21,4,69.14133333333334,96.98133333333332,27.83999999999999,145,203,58,chroma_acts_smoothed
21,5,96.98133333333332,124.82133333333333,27.840000000000003,203,261,58,chroma_acts_smoothed
21,6,124.82133333333333,145.46133333333333,20.64,261,304,43,chroma_acts_smoothed
21,7,145.46133333333333,160.34133333333332,14.879999999999995,304,335,31,chroma_acts_smoothed
21,8,160.34133333333332,190.58133333333333,30.24000000000001,335,398,63,chroma_acts_smoothed
21,9,190.58133333333333,209.179,18.59766666666667,398,435,37,chroma_acts_smoothed
21,1,0.0,33.62133333333333,33.62133333333333,0,71,71,ki_chroma
21,2,33.62133333333333,61.46133333333333,27.839999999999996,71,129,58,ki_chroma
21,3,61.46133333333333,68.66133333333333,7.200000000000003,129,144,15,ki_chroma
21,4,68.66133333333333,100.34133333333332,31.679999999999993,144,210,66,ki_chroma
21,5,100.34133333333332,124.82133333333333,24.480000000000004,210,261,51,ki_chroma
21,6,124.82133333333333,144.98133333333334,20.16000000000001,261,303,42,ki_chroma
21,7,144.98133333333334,160.34133333333332,15.359999999999985,303,335,32,ki_chroma
21,8,160.34133333333332,190.58133333333333,30.24000000000001,335,398,63,ki_chroma
21,9,190.58133333333333,209.179,18.59766666666667,398,435,37,ki_chroma
21,1,0.0,39.38133333333333,39.38133333333333,0,83,83,ki_chroma_acts
21,2,39.38133333333333,53.78133333333333,14.399999999999999,83,113,30,ki_chroma_acts
21,3,53.78133333333333,68.66133333333333,14.880000000000003,113,144,31,ki_chroma_acts
21,4,68.66133333333333,100.34133333333332,31.679999999999993,144,210,66,ki_chroma_acts
21,5,100.34133333333332,124.82133333333333,24.480000000000004,210,261,51,ki_chroma_acts
21,6,124.82133333333333,144.98133333333334,20.16000000000001,261,303,42,ki_chroma_acts
21,7,144.98133333333334,160.34133333333332,15.359999999999985,303,335,32,ki_chroma_acts
21,8,160.34133333333332,190.58133333333333,30.24000000000001,335,398,63,ki_chroma_acts
21,9,190.58133333333333,209.179,18.59766666666667,398,435,37,ki_chroma_acts
21,1,0.0,38.42133333333333,38.42133333333333,0,81,81,ki_chroma_acts_smoothed
21,2,38.42133333333333,53.78133333333333,15.36,81,113,32,ki_chroma_acts_smoothed
21,3,53.78133333333333,69.14133333333334,15.360000000000007,113,145,32,ki_chroma_acts_smoothed
21,4,69.14133333333334,96.98133333333332,27.83999999999999,145,203,58,ki_chroma_acts_smoothed
21,5,96.98133333333332,124.82133333333333,27.840000000000003,203,261,58,ki_chroma_acts_smoothed
21,6,124.82133333333333,145.46133333333333,20.64,261,304,43,ki_chroma_acts_smoothed
21,7,145.46133333333333,160.34133333333332,14.879999999999995,304,335,31,ki_chroma_acts_smoothed
21,8,160.34133333333332,190.58133333333333,30.24000000000001,335,398,63,ki_chroma_acts_smoothed
21,9,190.58133333333333,209.179,18.59766666666667,398,435,37,ki_chroma_acts_smoothed
22,1,0.0,92.416,92.416,0,189,189,chromagram
22,2,92.416,156.69333333333336,64.27733333333336,189,320,131,chromagram
22,3,156.69333333333336,162.0906666666667,5.397333333333336,320,331,11,chromagram
22,4,162.0906666666667,167.9786666666667,5.888000000000005,331,343,12,chromagram
22,5,167.9786666666667,178.2826666666667,10.304000000000002,343,364,21,chromagram
22,6,178.2826666666667,183.68,5.397333333333307,364,375,11,chromagram
22,7,183.68,190.54933333333335,6.869333333333344,375,389,14,chromagram
22,8,190.54933333333335,255.37,64.82066666666665,389,520,131,chromagram
22,1,0.0,156.69333333333336,156.69333333333336,0,320,320,chroma_acts
22,2,156.69333333333336,159.63733333333334,2.9439999999999884,320,326,6,chroma_acts
22,3,159.63733333333334,162.58133333333336,2.944000000000017,326,332,6,chroma_acts
22,4,162.58133333333336,167.9786666666667,5.397333333333336,332,343,11,chroma_acts
22,5,167.9786666666667,170.43200000000002,2.453333333333319,343,348,5,chroma_acts
22,6,170.43200000000002,175.33866666666668,4.906666666666666,348,358,10,chroma_acts
22,7,175.33866666666668,178.2826666666667,2.944000000000017,358,364,6,chroma_acts
22,8,178.2826666666667,184.17066666666668,5.887999999999977,364,376,12,chroma_acts
22,9,184.17066666666668,255.37,71.19933333333333,376,520,144,chroma_acts
22,1,0.0,156.69333333333336,156.69333333333336,0,320,320,chroma_acts_smoothed
22,2,156.69333333333336,160.12800000000001,3.434666666666658,320,327,7,chroma_acts_smoothed
22,3,160.12800000000001,163.07200000000003,2.944000000000017,327,333,6,chroma_acts_smoothed
22,4,163.07200000000003,167.9786666666667,4.906666666666666,333,343,10,chroma_acts_smoothed
22,5,167.9786666666667,170.9226666666667,2.9439999999999884,343,349,6,chroma_acts_smoothed
22,6,170.9226666666667,175.82933333333335,4.906666666666666,349,359,10,chroma_acts_smoothed
22,7,175.82933333333335,178.2826666666667,2.4533333333333474,359,364,5,chroma_acts_smoothed
22,8,178.2826666666667,186.62400000000002,8.341333333333324,364,381,17,chroma_acts_smoothed
22,9,186.62400000000002,255.37,68.74599999999998,381,520,139,chroma_acts_smoothed
22,1,0.0,92.416,92.416,0,189,189,ki_chroma
22,2,92.416,156.69333333333336,64.27733333333336,189,320,131,ki_chroma
22,3,156.69333333333336,162.0906666666667,5.397333333333336,320,331,11,ki_chroma
22,4,162.0906666666667,167.9786666666667,5.888000000000005,331,343,12,ki_chroma
22,5,167.9786666666667,178.2826666666667,10.304000000000002,343,364,21,ki_chroma
22,6,178.2826666666667,183.68,5.397333333333307,364,375,11,ki_chroma
22,7,183.68,190.54933333333335,6.869333333333344,375,389,14,ki_chroma
22,8,190.54933333333335,255.37,64.82066666666665,389,520,131,ki_chroma
22,1,0.0,156.69333333333336,156.69333333333336,0,320,320,ki_chroma_acts
22,2,156.69333333333336,159.63733333333334,2.9439999999999884,320,326,6,ki_chroma_acts
22,3,159.63733333333334,162.58133333333336,2.944000000000017,326,332,6,ki_chroma_acts
22,4,162.58133333333336,167.9786666666667,5.397333333333336,332,343,11,ki_chroma_acts
22,5,167.9786666666667,170.43200000000002,2.453333333333319,343,348,5,ki_chroma_acts
22,6,170.43200000000002,175.33866666666668,4.906666666666666,348,358,10,ki_chroma_acts
22,7,175.33866666666668,178.2826666666667,2.944000000000017,358,364,6,ki_chroma_acts
22,8,178.2826666666667,184.17066666666668,5.887999999999977,364,376,12,ki_chroma_acts
22,9,184.17066666666668,255.37,71.19933333333333,376,520,144,ki_chroma_acts
22,1,0.0,156.69333333333336,156.69333333333336,0,320,320,ki_chroma_acts_smoothed
22,2,156.69333333333336,160.12800000000001,3.434666666666658,320,327,7,ki_chroma_acts_smoothed
22,3,160.12800000000001,163.07200000000003,2.944000000000017,327,333,6,ki_chroma_acts_smoothed
22,4,163.07200000000003,167.9786666666667,4.906666666666666,333,343,10,ki_chroma_acts_smoothed
22,5,167.9786666666667,170.9226666666667,2.9439999999999884,343,349,6,ki_chroma_acts_smoothed
22,6,170.9226666666667,175.82933333333335,4.906666666666666,349,359,10,ki_chroma_acts_smoothed
22,7,175.82933333333335,178.2826666666667,2.4533333333333474,359,364,5,ki_chroma_acts_smoothed
22,8,178.2826666666667,186.62400000000002,8.341333333333324,364,381,17,ki_chroma_acts_smoothed
22,9,186.62400000000002,255.37,68.74599999999998,381,520,139,ki_chroma_acts_smoothed
23,1,0.0,32.992,32.992,0,69,69,chromagram
23,2,32.992,41.152,8.160000000000004,69,86,17,chromagram
23,3,41.152,63.711999999999996,22.559999999999995,86,133,47,chromagram
23,4,63.711999999999996,77.152,13.440000000000005,133,161,28,chromagram
23,5,77.152,83.392,6.239999999999995,161,174,13,chromagram
23,6,83.392,117.952,34.56,174,246,72,chromagram
23,7,117.952,140.512,22.560000000000002,246,293,47,chromagram
23,8,140.512,155.87199999999999,15.359999999999985,293,325,32,chromagram
23,9,155.87199999999999,187.831,31.959000000000003,325,390,65,chromagram
23,1,0.0,32.992,32.992,0,69,69,chroma_acts
23,2,32.992,41.152,8.160000000000004,69,86,17,chroma_acts
23,3,41.152,63.711999999999996,22.559999999999995,86,133,47,chroma_acts
23,4,63.711999999999996,79.55199999999999,15.839999999999996,133,166,33,chroma_acts
23,5,79.55199999999999,83.392,3.8400000000000034,166,174,8,chroma_acts
23,6,83.392,117.952,34.56,174,246,72,chroma_acts
23,7,117.952,140.992,23.039999999999992,246,294,48,chroma_acts
23,8,140.992,154.432,13.439999999999998,294,322,28,chroma_acts
23,9,154.432,187.831,33.399,322,390,68,chroma_acts
23,1,0.0,32.992,32.992,0,69,69,chroma_acts_smoothed
23,2,32.992,41.152,8.160000000000004,69,86,17,chroma_acts_smoothed
23,3,41.152,63.711999999999996,22.559999999999995,86,133,47,chroma_acts_smoothed
23,4,63.711999999999996,79.55199999999999,15.839999999999996,133,166,33,chroma_acts_smoothed
23,5,79.55199999999999,83.392,3.8400000000000034,166,174,8,chroma_acts_smoothed
23,6,83.392,117.952,34.56,174,246,72,chroma_acts_smoothed
23,7,117.952,140.992,23.039999999999992,246,294,48,chroma_acts_smoothed
23,8,140.992,156.352,15.360000000000014,294,326,32,chroma_acts_smoothed
23,9,156.352,187.831,31.478999999999985,326,390,64,chroma_acts_smoothed
23,1,0.0,32.992,32.992,0,69,69,ki_chroma
23,2,32.992,41.152,8.160000000000004,69,86,17,ki_chroma
23,3,41.152,63.711999999999996,22.559999999999995,86,133,47,ki_chroma
23,4,63.711999999999996,77.152,13.440000000000005,133,161,28,ki_chroma
23,5,77.152,83.392,6.239999999999995,161,174,13,ki_chroma
23,6,83.392,117.952,34.56,174,246,72,ki_chroma
23,7,117.952,140.512,22.560000000000002,246,293,47,ki_chroma
23,8,140.512,155.87199999999999,15.359999999999985,293,325,32,ki_chroma
23,9,155.87199999999999,187.831,31.959000000000003,325,390,65,ki_chroma
23,1,0.0,32.992,32.992,0,69,69,ki_chroma_acts
23,2,32.992,41.152,8.160000000000004,69,86,17,ki_chroma_acts
23,3,41.152,63.711999999999996,22.559999999999995,86,133,47,ki_chroma_acts
23,4,63.711999999999996,79.55199999999999,15.839999999999996,133,166,33,ki_chroma_acts
23,5,79.55199999999999,83.392,3.8400000000000034,166,174,8,ki_chroma_acts
23,6,83.392,117.952,34.56,174,246,72,ki_chroma_acts
23,7,117.952,140.992,23.039999999999992,246,294,48,ki_chroma_acts
23,8,140.992,154.432,13.439999999999998,294,322,28,ki_chroma_acts
23,9,154.432,187.831,33.399,322,390,68,ki_chroma_acts
23,1,0.0,32.992,32.992,0,69,69,ki_chroma_acts_smoothed
23,2,32.992,41.152,8.160000000000004,69,86,17,ki_chroma_acts_smoothed
23,3,41.152,63.711999999999996,22.559999999999995,86,133,47,ki_chroma_acts_smoothed
23,4,63.711999999999996,79.55199999999999,15.839999999999996,133,166,33,ki_chroma_acts_smoothed
23,5,79.55199999999999,83.392,3.8400000000000034,166,174,8,ki_chroma_acts_smoothed
23,6,83.392,117.952,34.56,174,246,72,ki_chroma_acts_smoothed
23,7,117.952,140.992,23.039999999999992,246,294,48,ki_chroma_acts_smoothed
23,8,140.992,156.352,15.360000000000014,294,326,32,ki_chroma_acts_smoothed
23,9,156.352,187.831,31.478999999999985,326,390,64,ki_chroma_acts_smoothed
25,1,0.0,31.56266666666667,31.56266666666667,0,68,68,chromagram
25,2,31.56266666666667,60.66133333333333,29.098666666666663,68,130,62,chromagram
25,3,60.66133333333333,62.06933333333333,1.4080000000000013,130,133,3,chromagram
25,4,62.06933333333333,77.55733333333333,15.488,133,166,33,chromagram
25,5,77.55733333333333,107.12533333333333,29.567999999999998,166,229,63,chromagram
25,6,107.12533333333333,153.12,45.994666666666674,229,327,98,chromagram
25,7,153.12,154.528,1.407999999999987,327,330,3,chromagram
25,8,154.528,168.983,14.455000000000013,330,359,29,chromagram
25,1,0.0,31.56266666666667,31.56266666666667,0,68,68,chroma_acts
25,2,31.56266666666667,60.66133333333333,29.098666666666663,68,130,62,chroma_acts
25,3,60.66133333333333,62.06933333333333,1.4080000000000013,130,133,3,chroma_acts
25,4,62.06933333333333,77.55733333333333,15.488,133,166,33,chroma_acts
25,5,77.55733333333333,108.064,30.50666666666666,166,231,65,chroma_acts
25,6,108.064,153.12,45.05600000000001,231,327,96,chroma_acts
25,7,153.12,154.528,1.407999999999987,327,330,3,chroma_acts
25,8,154.528,168.983,14.455000000000013,330,359,29,chroma_acts
25,1,0.0,31.56266666666667,31.56266666666667,0,68,68,chroma_acts_smoothed
25,2,31.56266666666667,60.66133333333333,29.098666666666663,68,130,62,chroma_acts_smoothed
25,3,60.66133333333333,62.06933333333333,1.4080000000000013,130,133,3,chroma_acts_smoothed
25,4,62.06933333333333,77.55733333333333,15.488,133,166,33,chroma_acts_smoothed
25,5,77.55733333333333,107.59466666666667,30.037333333333336,166,230,64,chroma_acts_smoothed
25,6,107.59466666666667,153.12,45.525333333333336,230,327,97,chroma_acts_smoothed
25,7,153.12,154.528,1.407999999999987,327,330,3,chroma_acts_smoothed
25,8,154.528,168.983,14.455000000000013,330,359,29,chroma_acts_smoothed
25,1,0.0,31.56266666666667,31.56266666666667,0,68,68,ki_chroma
25,2,31.56266666666667,60.66133333333333,29.098666666666663,68,130,62,ki_chroma
25,3,60.66133333333333,62.06933333333333,1.4080000000000013,130,133,3,ki_chroma
25,4,62.06933333333333,77.55733333333333,15.488,133,166,33,ki_chroma
25,5,77.55733333333333,107.12533333333333,29.567999999999998,166,229,63,ki_chroma
25,6,107.12533333333333,153.12,45.994666666666674,229,327,98,ki_chroma
25,7,153.12,154.528,1.407999999999987,327,330,3,ki_chroma
25,8,154.528,168.983,14.455000000000013,330,359,29,ki_chroma
25,1,0.0,31.56266666666667,31.56266666666667,0,68,68,ki_chroma_acts
25,2,31.56266666666667,60.66133333333333,29.098666666666663,68,130,62,ki_chroma_acts
25,3,60.66133333333333,62.06933333333333,1.4080000000000013,130,133,3,ki_chroma_acts
25,4,62.06933333333333,77.55733333333333,15.488,133,166,33,ki_chroma_acts
25,5,77.55733333333333,108.064,30.50666666666666,166,231,65,ki_chroma_acts
25,6,108.064,153.12,45.05600000000001,231,327,96,ki_chroma_acts
25,7,153.12,154.528,1.407999999999987,327,330,3,ki_chroma_acts
25,8,154.528,168.983,14.455000000000013,330,359,29,ki_chroma_acts
25,1,0.0,31.56266666666667,31.56266666666667,0,68,68,ki_chroma_acts_smoothed
25,2,31.56266666666667,60.66133333333333,29.098666666666663,68,130,62,ki_chroma_acts_smoothed
25,3,60.66133333333333,62.06933333333333,1.4080000000000013,130,133,3,ki_chroma_acts_smoothed
25,4,62.06933333333333,77.55733333333333,15.488,133,166,33,ki_chroma_acts_smoothed
25,5,77.55733333333333,107.59466666666667,30.037333333333336,166,230,64,ki_chroma_acts_smoothed
25,6,107.59466666666667,153.12,45.525333333333336,230,327,97,ki_chroma_acts_smoothed
25,7,153.12,154.528,1.407999999999987,327,330,3,ki_chroma_acts_smoothed
25,8,154.528,168.983,14.455000000000013,330,359,29,ki_chroma_acts_smoothed
26,1,0.0,15.093333333333334,15.093333333333334,0,32,32,chromagram
26,2,15.093333333333334,32.85333333333333,17.759999999999998,32,69,37,chromagram
26,3,32.85333333333333,47.733333333333334,14.880000000000003,69,100,31,chromagram
26,4,47.733333333333334,51.57333333333334,3.8400000000000034,100,108,8,chromagram
26,5,51.57333333333334,109.17333333333333,57.599999999999994,108,228,120,chromagram
26,6,109.17333333333333,124.53333333333333,15.36,228,260,32,chromagram
26,7,124.53333333333333,127.89333333333333,3.3599999999999994,260,267,7,chromagram
26,8,127.89333333333333,156.744,28.85066666666667,267,326,59,chromagram
26,1,0.0,15.093333333333334,15.093333333333334,0,32,32,chroma_acts
26,2,15.093333333333334,32.85333333333333,17.759999999999998,32,69,37,chroma_acts
26,3,32.85333333333333,47.733333333333334,14.880000000000003,69,100,31,chroma_acts
26,4,47.733333333333334,50.61333333333334,2.8800000000000026,100,106,6,chroma_acts
26,5,50.61333333333334,107.25333333333333,56.63999999999999,106,224,118,chroma_acts
26,6,107.25333333333333,124.53333333333333,17.28,224,260,36,chroma_acts
26,7,124.53333333333333,127.41333333333333,2.8799999999999955,260,266,6,chroma_acts
26,8,127.41333333333333,156.744,29.330666666666673,266,326,60,chroma_acts
26,1,0.0,15.093333333333334,15.093333333333334,0,32,32,chroma_acts_smoothed
26,2,15.093333333333334,30.93333333333333,15.839999999999996,32,65,33,chroma_acts_smoothed
26,3,30.93333333333333,47.733333333333334,16.800000000000004,65,100,35,chroma_acts_smoothed
26,4,47.733333333333334,50.61333333333334,2.8800000000000026,100,106,6,chroma_acts_smoothed
26,5,50.61333333333334,107.73333333333333,57.12,106,225,119,chroma_acts_smoothed
26,6,107.73333333333333,124.53333333333333,16.799999999999997,225,260,35,chroma_acts_smoothed
26,7,124.53333333333333,127.41333333333333,2.8799999999999955,260,266,6,chroma_acts_smoothed
26,8,127.41333333333333,156.744,29.330666666666673,266,326,60,chroma_acts_smoothed
26,1,0.0,15.093333333333334,15.093333333333334,0,32,32,ki_chroma
26,2,15.093333333333334,32.85333333333333,17.759999999999998,32,69,37,ki_chroma
26,3,32.85333333333333,47.733333333333334,14.880000000000003,69,100,31,ki_chroma
26,4,47.733333333333334,51.57333333333334,3.8400000000000034,100,108,8,ki_chroma
26,5,51.57333333333334,109.17333333333333,57.599999999999994,108,228,120,ki_chroma
26,6,109.17333333333333,124.53333333333333,15.36,228,260,32,ki_chroma
26,7,124.53333333333333,127.89333333333333,3.3599999999999994,260,267,7,ki_chroma
26,8,127.89333333333333,156.744,28.85066666666667,267,326,59,ki_chroma
26,1,0.0,15.093333333333334,15.093333333333334,0,32,32,ki_chroma_acts
26,2,15.093333333333334,32.85333333333333,17.759999999999998,32,69,37,ki_chroma_acts
26,3,32.85333333333333,47.733333333333334,14.880000000000003,69,100,31,ki_chroma_acts
26,4,47.733333333333334,50.61333333333334,2.8800000000000026,100,106,6,ki_chroma_acts
26,5,50.61333333333334,107.25333333333333,56.63999999999999,106,224,118,ki_chroma_acts
26,6,107.25333333333333,124.53333333333333,17.28,224,260,36,ki_chroma_acts
26,7,124.53333333333333,127.41333333333333,2.8799999999999955,260,266,6,ki_chroma_acts
26,8,127.41333333333333,156.744,29.330666666666673,266,326,60,ki_chroma_acts
26,1,0.0,15.093333333333334,15.093333333333334,0,32,32,ki_chroma_acts_smoothed
26,2,15.093333333333334,30.93333333333333,15.839999999999996,32,65,33,ki_chroma_acts_smoothed
26,3,30.93333333333333,47.733333333333334,16.800000000000004,65,100,35,ki_chroma_acts_smoothed
26,4,47.733333333333334,50.61333333333334,2.8800000000000026,100,106,6,ki_chroma_acts_smoothed
26,5,50.61333333333334,107.73333333333333,57.12,106,225,119,ki_chroma_acts_smoothed
26,6,107.73333333333333,124.53333333333333,16.799999999999997,225,260,35,ki_chroma_acts_smoothed
26,7,124.53333333333333,127.41333333333333,2.8799999999999955,260,266,6,ki_chroma_acts_smoothed
26,8,127.41333333333333,156.744,29.330666666666673,266,326,60,ki_chroma_acts_smoothed
29,1,0.0,28.832,28.832,0,61,61,chromagram
29,2,28.832,69.152,40.32,61,145,84,chromagram
29,3,69.152,82.592,13.439999999999998,145,173,28,chromagram
29,4,82.592,84.512,1.9200000000000017,173,177,4,chromagram
29,5,84.512,115.71199999999999,31.19999999999999,177,242,65,chromagram
29,6,115.71199999999999,153.632,37.920000000000016,242,321,79,chromagram
29,7,153.632,167.072,13.439999999999998,321,349,28,chromagram
29,8,167.072,168.992,1.9199999999999875,349,353,4,chromagram
29,9,168.992,215.04,46.048,353,447,94,chromagram
29,1,0.0,28.832,28.832,0,61,61,chroma_acts
29,2,28.832,69.152,40.32,61,145,84,chroma_acts
29,3,69.152,82.592,13.439999999999998,145,173,28,chroma_acts
29,4,82.592,84.512,1.9200000000000017,173,177,4,chroma_acts
29,5,84.512,115.71199999999999,31.19999999999999,177,242,65,chroma_acts
29,6,115.71199999999999,153.632,37.920000000000016,242,321,79,chroma_acts
29,7,153.632,167.072,13.439999999999998,321,349,28,chroma_acts
29,8,167.072,168.992,1.9199999999999875,349,353,4,chroma_acts
29,9,168.992,215.04,46.048,353,447,94,chroma_acts
29,1,0.0,28.832,28.832,0,61,61,chroma_acts_smoothed
29,2,28.832,68.672,39.839999999999996,61,144,83,chroma_acts_smoothed
29,3,68.672,84.512,15.840000000000003,144,177,33,chroma_acts_smoothed
29,4,84.512,115.71199999999999,31.19999999999999,177,242,65,chroma_acts_smoothed
29,5,115.71199999999999,153.632,37.920000000000016,242,321,79,chroma_acts_smoothed
29,6,153.632,167.072,13.439999999999998,321,349,28,chroma_acts_smoothed
29,7,167.072,168.992,1.9199999999999875,349,353,4,chroma_acts_smoothed
29,8,168.992,184.352,15.360000000000014,353,385,32,chroma_acts_smoothed
29,9,184.352,215.04,30.687999999999988,385,447,62,chroma_acts_smoothed
29,1,0.0,28.832,28.832,0,61,61,ki_chroma
29,2,28.832,69.152,40.32,61,145,84,ki_chroma
29,3,69.152,82.592,13.439999999999998,145,173,28,ki_chroma
29,4,82.592,84.512,1.9200000000000017,173,177,4,ki_chroma
29,5,84.512,115.71199999999999,31.19999999999999,177,242,65,ki_chroma
29,6,115.71199999999999,153.632,37.920000000000016,242,321,79,ki_chroma
29,7,153.632,167.072,13.439999999999998,321,349,28,ki_chroma
29,8,167.072,168.992,1.9199999999999875,349,353,4,ki_chroma
29,9,168.992,215.04,46.048,353,447,94,ki_chroma
29,1,0.0,28.832,28.832,0,61,61,ki_chroma_acts
29,2,28.832,69.152,40.32,61,145,84,ki_chroma_acts
29,3,69.152,82.592,13.439999999999998,145,173,28,ki_chroma_acts
29,4,82.592,84.512,1.9200000000000017,173,177,4,ki_chroma_acts
29,5,84.512,115.71199999999999,31.19999999999999,177,242,65,ki_chroma_acts
29,6,115.71199999999999,153.632,37.920000000000016,242,321,79,ki_chroma_acts
29,7,153.632,167.072,13.439999999999998,321,349,28,ki_chroma_acts
29,8,167.072,168.992,1.9199999999999875,349,353,4,ki_chroma_acts
29,9,168.992,215.04,46.048,353,447,94,ki_chroma_acts
29,1,0.0,28.832,28.832,0,61,61,ki_chroma_acts_smoothed
29,2,28.832,68.672,39.839999999999996,61,144,83,ki_chroma_acts_smoothed
29,3,68.672,84.512,15.840000000000003,144,177,33,ki_chroma_acts_smoothed
29,4,84.512,115.71199999999999,31.19999999999999,177,242,65,ki_chroma_acts_smoothed
29,5,115.71199999999999,153.632,37.920000000000016,242,321,79,ki_chroma_acts_smoothed
29,6,153.632,167.072,13.439999999999998,321,349,28,ki_chroma_acts_smoothed
29,7,167.072,168.992,1.9199999999999875,349,353,4,ki_chroma_acts_smoothed
29,8,168.992,184.352,15.360000000000014,353,385,32,ki_chroma_acts_smoothed
29,9,184.352,215.04,30.687999999999988,385,447,62,ki_chroma_acts_smoothed
30,1,0.0,3.722666666666667,3.722666666666667,0,8,8,chromagram
30,2,3.722666666666667,73.184,69.46133333333333,8,156,148,chromagram
30,3,73.184,77.40799999999999,4.2239999999999895,156,165,9,chromagram
30,4,77.40799999999999,120.11733333333332,42.70933333333333,165,256,91,chromagram
30,5,120.11733333333332,121.99466666666666,1.8773333333333397,256,260,4,chromagram
30,6,121.99466666666666,163.296,41.30133333333333,260,348,88,chromagram
30,7,163.296,167.05066666666667,3.7546666666666795,348,356,8,chromagram
30,8,167.05066666666667,213.209,46.15833333333333,356,453,97,chromagram
30,1,0.0,71.30666666666666,71.30666666666666,0,152,152,chroma_acts
30,2,71.30666666666666,120.11733333333332,48.81066666666666,152,256,104,chroma_acts
30,3,120.11733333333332,125.74933333333333,5.632000000000005,256,268,12,chroma_acts
30,4,125.74933333333333,127.62666666666667,1.8773333333333397,268,272,4,chroma_acts
30,5,127.62666666666667,131.38133333333332,3.754666666666651,272,280,8,chroma_acts
30,6,131.38133333333332,133.25866666666667,1.877333333333354,280,284,4,chroma_acts
30,7,133.25866666666667,161.41866666666667,28.159999999999997,284,344,60,chroma_acts
30,8,161.41866666666667,213.209,51.790333333333336,344,453,109,chroma_acts
30,1,0.0,3.722666666666667,3.722666666666667,0,8,8,chroma_acts_smoothed
30,2,3.722666666666667,73.65333333333332,69.93066666666665,8,157,149,chroma_acts_smoothed
30,3,73.65333333333332,120.11733333333332,46.464,157,256,99,chroma_acts_smoothed
30,4,120.11733333333332,125.74933333333333,5.632000000000005,256,268,12,chroma_acts_smoothed
30,5,125.74933333333333,127.62666666666667,1.8773333333333397,268,272,4,chroma_acts_smoothed
30,6,127.62666666666667,163.296,35.66933333333333,272,348,76,chroma_acts_smoothed
30,7,163.296,167.05066666666667,3.7546666666666795,348,356,8,chroma_acts_smoothed
30,8,167.05066666666667,213.209,46.15833333333333,356,453,97,chroma_acts_smoothed
30,1,0.0,3.722666666666667,3.722666666666667,0,8,8,ki_chroma
30,2,3.722666666666667,73.184,69.46133333333333,8,156,148,ki_chroma
30,3,73.184,77.40799999999999,4.2239999999999895,156,165,9,ki_chroma
30,4,77.40799999999999,120.11733333333332,42.70933333333333,165,256,91,ki_chroma
30,5,120.11733333333332,121.99466666666666,1.8773333333333397,256,260,4,ki_chroma
30,6,121.99466666666666,163.296,41.30133333333333,260,348,88,ki_chroma
30,7,163.296,167.05066666666667,3.7546666666666795,348,356,8,ki_chroma
30,8,167.05066666666667,213.209,46.15833333333333,356,453,97,ki_chroma
30,1,0.0,71.30666666666666,71.30666666666666,0,152,152,ki_chroma_acts
30,2,71.30666666666666,120.11733333333332,48.81066666666666,152,256,104,ki_chroma_acts
30,3,120.11733333333332,125.74933333333333,5.632000000000005,256,268,12,ki_chroma_acts
30,4,125.74933333333333,127.62666666666667,1.8773333333333397,268,272,4,ki_chroma_acts
30,5,127.62666666666667,131.38133333333332,3.754666666666651,272,280,8,ki_chroma_acts
30,6,131.38133333333332,133.25866666666667,1.877333333333354,280,284,4,ki_chroma_acts
30,7,133.25866666666667,161.41866666666667,28.159999999999997,284,344,60,ki_chroma_acts
30,8,161.41866666666667,213.209,51.790333333333336,344,453,109,ki_chroma_acts
30,1,0.0,3.722666666666667,3.722666666666667,0,8,8,ki_chroma_acts_smoothed
30,2,3.722666666666667,73.65333333333332,69.93066666666665,8,157,149,ki_chroma_acts_smoothed
30,3,73.65333333333332,120.11733333333332,46.464,157,256,99,ki_chroma_acts_smoothed
30,4,120.11733333333332,125.74933333333333,5.632000000000005,256,268,12,ki_chroma_acts_smoothed
30,5,125.74933333333333,127.62666666666667,1.8773333333333397,268,272,4,ki_chroma_acts_smoothed
30,6,127.62666666666667,163.296,35.66933333333333,272,348,76,ki_chroma_acts_smoothed
30,7,163.296,167.05066666666667,3.7546666666666795,348,356,8,ki_chroma_acts_smoothed
30,8,167.05066666666667,213.209,46.15833333333333,356,453,97,ki_chroma_acts_smoothed
32,1,0.0,17.631999999999998,17.631999999999998,0,39,39,chromagram
32,2,17.631999999999998,26.346666666666664,8.714666666666666,39,58,19,chromagram
32,3,26.346666666666664,30.016,3.6693333333333342,58,66,8,chromagram
32,4,30.016,56.15999999999999,26.14399999999999,66,123,57,chromagram
32,5,56.15999999999999,59.37066666666666,3.2106666666666683,123,130,7,chromagram
32,6,59.37066666666666,72.21333333333332,12.842666666666666,130,158,28,chromagram
32,7,72.21333333333332,85.51466666666666,13.301333333333332,158,187,29,chromagram
32,8,85.51466666666666,89.18399999999998,3.669333333333327,187,195,8,chromagram
32,9,89.18399999999998,126.845,37.661000000000016,195,276,81,chromagram
32,1,0.0,11.669333333333332,11.669333333333332,0,26,26,chroma_acts
32,2,11.669333333333332,26.346666666666664,14.677333333333332,26,58,32,chroma_acts
32,3,26.346666666666664,30.016,3.6693333333333342,58,66,8,chroma_acts
32,4,30.016,56.618666666666655,26.602666666666657,66,124,58,chroma_acts
32,5,56.618666666666655,59.37066666666666,2.7520000000000024,124,130,6,chroma_acts
32,6,59.37066666666666,72.21333333333332,12.842666666666666,130,158,28,chroma_acts
32,7,72.21333333333332,85.51466666666666,13.301333333333332,158,187,29,chroma_acts
32,8,85.51466666666666,89.18399999999998,3.669333333333327,187,195,8,chroma_acts
32,9,89.18399999999998,126.845,37.661000000000016,195,276,81,chroma_acts
32,1,0.0,11.210666666666665,11.210666666666665,0,25,25,chroma_acts_smoothed
32,2,11.210666666666665,26.80533333333333,15.594666666666665,25,59,34,chroma_acts_smoothed
32,3,26.80533333333333,30.016,3.2106666666666683,59,66,7,chroma_acts_smoothed
32,4,30.016,56.15999999999999,26.14399999999999,66,123,57,chroma_acts_smoothed
32,5,56.15999999999999,59.829333333333324,3.6693333333333342,123,131,8,chroma_acts_smoothed
32,6,59.829333333333324,72.67199999999998,12.84266666666666,131,159,28,chroma_acts_smoothed
32,7,72.67199999999998,85.51466666666666,12.842666666666673,159,187,28,chroma_acts_smoothed
32,8,85.51466666666666,89.18399999999998,3.669333333333327,187,195,8,chroma_acts_smoothed
32,9,89.18399999999998,126.845,37.661000000000016,195,276,81,chroma_acts_smoothed
32,1,0.0,17.631999999999998,17.631999999999998,0,39,39,ki_chroma
32,2,17.631999999999998,26.346666666666664,8.714666666666666,39,58,19,ki_chroma
32,3,26.346666666666664,30.016,3.6693333333333342,58,66,8,ki_chroma
32,4,30.016,56.15999999999999,26.14399999999999,66,123,57,ki_chroma
32,5,56.15999999999999,59.37066666666666,3.2106666666666683,123,130,7,ki_chroma
32,6,59.37066666666666,72.21333333333332,12.842666666666666,130,158,28,ki_chroma
32,7,72.21333333333332,85.51466666666666,13.301333333333332,158,187,29,ki_chroma
32,8,85.51466666666666,89.18399999999998,3.669333333333327,187,195,8,ki_chroma
32,9,89.18399999999998,126.845,37.661000000000016,195,276,81,ki_chroma
32,1,0.0,11.669333333333332,11.669333333333332,0,26,26,ki_chroma_acts
32,2,11.669333333333332,26.346666666666664,14.677333333333332,26,58,32,ki_chroma_acts
32,3,26.346666666666664,30.016,3.6693333333333342,58,66,8,ki_chroma_acts
32,4,30.016,56.618666666666655,26.602666666666657,66,124,58,ki_chroma_acts
32,5,56.618666666666655,59.37066666666666,2.7520000000000024,124,130,6,ki_chroma_acts
32,6,59.37066666666666,72.21333333333332,12.842666666666666,130,158,28,ki_chroma_acts
32,7,72.21333333333332,85.51466666666666,13.301333333333332,158,187,29,ki_chroma_acts
32,8,85.51466666666666,89.18399999999998,3.669333333333327,187,195,8,ki_chroma_acts
32,9,89.18399999999998,126.845,37.661000000000016,195,276,81,ki_chroma_acts
32,1,0.0,11.210666666666665,11.210666666666665,0,25,25,ki_chroma_acts_smoothed
32,2,11.210666666666665,26.80533333333333,15.594666666666665,25,59,34,ki_chroma_acts_smoothed
32,3,26.80533333333333,30.016,3.2106666666666683,59,66,7,ki_chroma_acts_smoothed
32,4,30.016,56.15999999999999,26.14399999999999,66,123,57,ki_chroma_acts_smoothed
32,5,56.15999999999999,59.829333333333324,3.6693333333333342,123,131,8,ki_chroma_acts_smoothed
32,6,59.829333333333324,72.67199999999998,12.84266666666666,131,159,28,ki_chroma_acts_smoothed
32,7,72.67199999999998,85.51466666666666,12.842666666666673,159,187,28,ki_chroma_acts_smoothed
32,8,85.51466666666666,89.18399999999998,3.669333333333327,187,195,8,ki_chroma_acts_smoothed
32,9,89.18399999999998,126.845,37.661000000000016,195,276,81,ki_chroma_acts_smoothed
33,1,0.0,11.872,11.872,0,26,26,chromagram
33,2,11.872,45.19466666666666,33.32266666666666,26,97,71,chromagram
33,3,45.19466666666666,86.49600000000001,41.301333333333346,97,185,88,chromagram
33,4,86.49600000000001,97.76,11.263999999999996,185,209,24,chromagram
33,5,97.76,120.288,22.52799999999999,209,257,48,chromagram
33,6,120.288,133.89866666666666,13.61066666666666,257,286,29,chromagram
33,7,133.89866666666666,176.608,42.70933333333335,286,377,91,chromagram
33,8,176.608,184.787,8.179000000000002,377,393,16,chromagram
33,1,0.0,11.872,11.872,0,26,26,chroma_acts
33,2,11.872,45.19466666666666,33.32266666666666,26,97,71,chroma_acts
33,3,45.19466666666666,82.74133333333333,37.54666666666667,97,177,80,chroma_acts
33,4,82.74133333333333,97.76,15.018666666666675,177,209,32,chroma_acts
33,5,97.76,120.288,22.52799999999999,209,257,48,chroma_acts
33,6,120.288,134.83733333333333,14.549333333333337,257,288,31,chroma_acts
33,7,134.83733333333333,176.608,41.77066666666667,288,377,89,chroma_acts
33,8,176.608,184.787,8.179000000000002,377,393,16,chroma_acts
33,1,0.0,11.872,11.872,0,26,26,chroma_acts_smoothed
33,2,11.872,45.19466666666666,33.32266666666666,26,97,71,chroma_acts_smoothed
33,3,45.19466666666666,82.74133333333333,37.54666666666667,97,177,80,chroma_acts_smoothed
33,4,82.74133333333333,97.76,15.018666666666675,177,209,32,chroma_acts_smoothed
33,5,97.76,120.288,22.52799999999999,209,257,48,chroma_acts_smoothed
33,6,120.288,135.30666666666667,15.018666666666675,257,289,32,chroma_acts_smoothed
33,7,135.30666666666667,177.07733333333334,41.77066666666667,289,378,89,chroma_acts_smoothed
33,8,177.07733333333334,184.787,7.709666666666664,378,393,15,chroma_acts_smoothed
33,1,0.0,11.872,11.872,0,26,26,ki_chroma
33,2,11.872,45.19466666666666,33.32266666666666,26,97,71,ki_chroma
33,3,45.19466666666666,86.49600000000001,41.301333333333346,97,185,88,ki_chroma
33,4,86.49600000000001,97.76,11.263999999999996,185,209,24,ki_chroma
33,5,97.76,120.288,22.52799999999999,209,257,48,ki_chroma
33,6,120.288,133.89866666666666,13.61066666666666,257,286,29,ki_chroma
33,7,133.89866666666666,176.608,42.70933333333335,286,377,91,ki_chroma
33,8,176.608,184.787,8.179000000000002,377,393,16,ki_chroma
33,1,0.0,11.872,11.872,0,26,26,ki_chroma_acts
33,2,11.872,45.19466666666666,33.32266666666666,26,97,71,ki_chroma_acts
33,3,45.19466666666666,82.74133333333333,37.54666666666667,97,177,80,ki_chroma_acts
33,4,82.74133333333333,97.76,15.018666666666675,177,209,32,ki_chroma_acts
33,5,97.76,120.288,22.52799999999999,209,257,48,ki_chroma_acts
33,6,120.288,134.83733333333333,14.549333333333337,257,288,31,ki_chroma_acts
33,7,134.83733333333333,176.608,41.77066666666667,288,377,89,ki_chroma_acts
33,8,176.608,184.787,8.179000000000002,377,393,16,ki_chroma_acts
33,1,0.0,11.872,11.872,0,26,26,ki_chroma_acts_smoothed
33,2,11.872,45.19466666666666,33.32266666666666,26,97,71,ki_chroma_acts_smoothed
33,3,45.19466666666666,82.74133333333333,37.54666666666667,97,177,80,ki_chroma_acts_smoothed
33,4,82.74133333333333,97.76,15.018666666666675,177,209,32,ki_chroma_acts_smoothed
33,5,97.76,120.288,22.52799999999999,209,257,48,ki_chroma_acts_smoothed
33,6,120.288,135.30666666666667,15.018666666666675,257,289,32,ki_chroma_acts_smoothed
33,7,135.30666666666667,177.07733333333334,41.77066666666667,289,378,89,ki_chroma_acts_smoothed
33,8,177.07733333333334,184.787,7.709666666666664,378,393,15,ki_chroma_acts_smoothed
36,1,0.0,16.78933333333333,16.78933333333333,0,36,36,chromagram
36,2,16.78933333333333,43.541333333333334,26.752000000000002,36,93,57,chromagram
36,3,43.541333333333334,48.704,5.1626666666666665,93,104,11,chromagram
36,4,48.704,53.86666666666667,5.1626666666666665,104,115,11,chromagram
36,5,53.86666666666667,84.37333333333333,30.506666666666668,115,180,65,chromagram
36,6,84.37333333333333,96.10666666666667,11.733333333333334,180,205,25,chromagram
36,7,96.10666666666667,114.88,18.773333333333326,205,245,40,chromagram
36,8,114.88,135.53066666666666,20.650666666666666,245,289,44,chromagram
36,9,135.53066666666666,187.093,51.56233333333333,289,397,108,chromagram
36,1,0.0,16.78933333333333,16.78933333333333,0,36,36,chroma_acts
36,2,16.78933333333333,36.970666666666666,20.181333333333335,36,79,43,chroma_acts
36,3,36.970666666666666,77.33333333333333,40.36266666666666,79,165,86,chroma_acts
36,4,77.33333333333333,84.37333333333333,7.040000000000006,165,180,15,chroma_acts
36,5,84.37333333333333,96.10666666666667,11.733333333333334,180,205,25,chroma_acts
36,6,96.10666666666667,126.61333333333333,30.50666666666666,205,270,65,chroma_acts
36,7,126.61333333333333,130.368,3.7546666666666653,270,278,8,chroma_acts
36,8,130.368,135.53066666666666,5.1626666666666665,278,289,11,chroma_acts
36,9,135.53066666666666,187.093,51.56233333333333,289,397,108,chroma_acts
36,1,0.0,16.78933333333333,16.78933333333333,0,36,36,chroma_acts_smoothed
36,2,16.78933333333333,36.970666666666666,20.181333333333335,36,79,43,chroma_acts_smoothed
36,3,36.970666666666666,77.33333333333333,40.36266666666666,79,165,86,chroma_acts_smoothed
36,4,77.33333333333333,84.37333333333333,7.040000000000006,165,180,15,chroma_acts_smoothed
36,5,84.37333333333333,96.10666666666667,11.733333333333334,180,205,25,chroma_acts_smoothed
36,6,96.10666666666667,126.61333333333333,30.50666666666666,205,270,65,chroma_acts_smoothed
36,7,126.61333333333333,129.89866666666666,3.2853333333333268,270,277,7,chroma_acts_smoothed
36,8,129.89866666666666,135.06133333333332,5.1626666666666665,277,288,11,chroma_acts_smoothed
36,9,135.06133333333332,187.093,52.031666666666666,288,397,109,chroma_acts_smoothed
36,1,0.0,16.78933333333333,16.78933333333333,0,36,36,ki_chroma
36,2,16.78933333333333,43.541333333333334,26.752000000000002,36,93,57,ki_chroma
36,3,43.541333333333334,48.704,5.1626666666666665,93,104,11,ki_chroma
36,4,48.704,53.86666666666667,5.1626666666666665,104,115,11,ki_chroma
36,5,53.86666666666667,84.37333333333333,30.506666666666668,115,180,65,ki_chroma
36,6,84.37333333333333,96.10666666666667,11.733333333333334,180,205,25,ki_chroma
36,7,96.10666666666667,114.88,18.773333333333326,205,245,40,ki_chroma
36,8,114.88,135.53066666666666,20.650666666666666,245,289,44,ki_chroma
36,9,135.53066666666666,187.093,51.56233333333333,289,397,108,ki_chroma
36,1,0.0,16.78933333333333,16.78933333333333,0,36,36,ki_chroma_acts
36,2,16.78933333333333,36.970666666666666,20.181333333333335,36,79,43,ki_chroma_acts
36,3,36.970666666666666,77.33333333333333,40.36266666666666,79,165,86,ki_chroma_acts
36,4,77.33333333333333,84.37333333333333,7.040000000000006,165,180,15,ki_chroma_acts
36,5,84.37333333333333,96.10666666666667,11.733333333333334,180,205,25,ki_chroma_acts
36,6,96.10666666666667,126.61333333333333,30.50666666666666,205,270,65,ki_chroma_acts
36,7,126.61333333333333,130.368,3.7546666666666653,270,278,8,ki_chroma_acts
36,8,130.368,135.53066666666666,5.1626666666666665,278,289,11,ki_chroma_acts
36,9,135.53066666666666,187.093,51.56233333333333,289,397,108,ki_chroma_acts
36,1,0.0,16.78933333333333,16.78933333333333,0,36,36,ki_chroma_acts_smoothed
36,2,16.78933333333333,36.970666666666666,20.181333333333335,36,79,43,ki_chroma_acts_smoothed
36,3,36.970666666666666,77.33333333333333,40.36266666666666,79,165,86,ki_chroma_acts_smoothed
36,4,77.33333333333333,84.37333333333333,7.040000000000006,165,180,15,ki_chroma_acts_smoothed
36,5,84.37333333333333,96.10666666666667,11.733333333333334,180,205,25,ki_chroma_acts_smoothed
36,6,96.10666666666667,126.61333333333333,30.50666666666666,205,270,65,ki_chroma_acts_smoothed
36,7,126.61333333333333,129.89866666666666,3.2853333333333268,270,277,7,ki_chroma_acts_smoothed
36,8,129.89866666666666,135.06133333333332,5.1626666666666665,277,288,11,ki_chroma_acts_smoothed
36,9,135.06133333333332,187.093,52.031666666666666,288,397,109,ki_chroma_acts_smoothed
37,1,0.0,9.717333333333332,9.717333333333332,0,14,14,chromagram
37,2,9.717333333333332,74.752,65.03466666666667,14,105,91,chromagram
37,3,74.752,88.33066666666666,13.578666666666663,105,124,19,chromagram
37,4,88.33066666666666,90.47466666666666,2.1440000000000055,124,127,3,chromagram
37,5,90.47466666666666,115.488,25.013333333333335,127,162,35,chromagram
37,6,115.488,124.77866666666667,9.290666666666667,162,175,13,chromagram
37,7,124.77866666666667,136.928,12.149333333333331,175,192,17,chromagram
37,8,136.928,183.629,46.70099999999999,192,256,64,chromagram
37,1,0.0,9.717333333333332,9.717333333333332,0,14,14,chroma_acts
37,2,9.717333333333332,74.752,65.03466666666667,14,105,91,chroma_acts
37,3,74.752,84.75733333333334,10.00533333333334,105,119,14,chroma_acts
37,4,84.75733333333334,90.47466666666666,5.717333333333329,119,127,8,chroma_acts
37,5,90.47466666666666,111.91466666666666,21.439999999999998,127,157,30,chroma_acts
37,6,111.91466666666666,124.77866666666667,12.864000000000004,157,175,18,chroma_acts
37,7,124.77866666666667,136.928,12.149333333333331,175,192,17,chroma_acts
37,8,136.928,183.629,46.70099999999999,192,256,64,chroma_acts
37,1,0.0,9.002666666666666,9.002666666666666,0,13,13,chroma_acts_smoothed
37,2,9.002666666666666,11.146666666666667,2.144,13,16,3,chroma_acts_smoothed
37,3,11.146666666666667,74.752,63.60533333333333,16,105,89,chroma_acts_smoothed
37,4,74.752,84.75733333333334,10.00533333333334,105,119,14,chroma_acts_smoothed
37,5,84.75733333333334,90.47466666666666,5.717333333333329,119,127,8,chroma_acts_smoothed
37,6,90.47466666666666,124.77866666666667,34.304,127,175,48,chroma_acts_smoothed
37,7,124.77866666666667,136.928,12.149333333333331,175,192,17,chroma_acts_smoothed
37,8,136.928,183.629,46.70099999999999,192,256,64,chroma_acts_smoothed
37,1,0.0,9.717333333333332,9.717333333333332,0,14,14,ki_chroma
37,2,9.717333333333332,74.752,65.03466666666667,14,105,91,ki_chroma
37,3,74.752,88.33066666666666,13.578666666666663,105,124,19,ki_chroma
37,4,88.33066666666666,90.47466666666666,2.1440000000000055,124,127,3,ki_chroma
37,5,90.47466666666666,115.488,25.013333333333335,127,162,35,ki_chroma
37,6,115.488,124.77866666666667,9.290666666666667,162,175,13,ki_chroma
37,7,124.77866666666667,136.928,12.149333333333331,175,192,17,ki_chroma
37,8,136.928,183.629,46.70099999999999,192,256,64,ki_chroma
37,1,0.0,9.717333333333332,9.717333333333332,0,14,14,ki_chroma_acts
37,2,9.717333333333332,74.752,65.03466666666667,14,105,91,ki_chroma_acts
37,3,74.752,84.75733333333334,10.00533333333334,105,119,14,ki_chroma_acts
37,4,84.75733333333334,90.47466666666666,5.717333333333329,119,127,8,ki_chroma_acts
37,5,90.47466666666666,111.91466666666666,21.439999999999998,127,157,30,ki_chroma_acts
37,6,111.91466666666666,124.77866666666667,12.864000000000004,157,175,18,ki_chroma_acts
37,7,124.77866666666667,136.928,12.149333333333331,175,192,17,ki_chroma_acts
37,8,136.928,183.629,46.70099999999999,192,256,64,ki_chroma_acts
37,1,0.0,9.002666666666666,9.002666666666666,0,13,13,ki_chroma_acts_smoothed
37,2,9.002666666666666,11.146666666666667,2.144,13,16,3,ki_chroma_acts_smoothed
37,3,11.146666666666667,74.752,63.60533333333333,16,105,89,ki_chroma_acts_smoothed
37,4,74.752,84.75733333333334,10.00533333333334,105,119,14,ki_chroma_acts_smoothed
37,5,84.75733333333334,90.47466666666666,5.717333333333329,119,127,8,ki_chroma_acts_smoothed
37,6,90.47466666666666,124.77866666666667,34.304,127,175,48,ki_chroma_acts_smoothed
37,7,124.77866666666667,136.928,12.149333333333331,175,192,17,ki_chroma_acts_smoothed
37,8,136.928,183.629,46.70099999999999,192,256,64,ki_chroma_acts_smoothed
38,1,0.0,14.677333333333332,14.677333333333332,0,31,31,chromagram
38,2,14.677333333333332,15.157333333333332,0.4800000000000004,31,32,1,chromagram
38,3,15.157333333333332,44.91733333333333,29.759999999999998,32,94,62,chromagram
38,4,44.91733333333333,106.35733333333333,61.44,94,222,128,chromagram
38,5,106.35733333333333,122.19733333333333,15.840000000000003,222,255,33,chromagram
38,6,122.19733333333333,124.11733333333332,1.9199999999999875,255,259,4,chromagram
38,7,124.11733333333332,151.95733333333334,27.840000000000018,259,317,58,chromagram
38,8,151.95733333333334,185.005,33.04766666666666,317,384,67,chromagram
38,1,0.0,14.677333333333332,14.677333333333332,0,31,31,chroma_acts
38,2,14.677333333333332,15.157333333333332,0.4800000000000004,31,32,1,chroma_acts
38,3,15.157333333333332,44.91733333333333,29.759999999999998,32,94,62,chroma_acts
38,4,44.91733333333333,99.15733333333333,54.239999999999995,94,207,113,chroma_acts
38,5,99.15733333333333,106.35733333333333,7.200000000000003,207,222,15,chroma_acts
38,6,106.35733333333333,122.19733333333333,15.840000000000003,222,255,33,chroma_acts
38,7,122.19733333333333,151.95733333333334,29.760000000000005,255,317,62,chroma_acts
38,8,151.95733333333334,185.005,33.04766666666666,317,384,67,chroma_acts
38,1,0.0,14.677333333333332,14.677333333333332,0,31,31,chroma_acts_smoothed
38,2,14.677333333333332,30.517333333333333,15.840000000000002,31,64,33,chroma_acts_smoothed
38,3,30.517333333333333,45.39733333333333,14.879999999999995,64,95,31,chroma_acts_smoothed
38,4,45.39733333333333,105.87733333333333,60.48,95,221,126,chroma_acts_smoothed
38,5,105.87733333333333,122.19733333333333,16.320000000000007,221,255,34,chroma_acts_smoothed
38,6,122.19733333333333,142.35733333333332,20.159999999999982,255,297,42,chroma_acts_smoothed
38,7,142.35733333333332,151.47733333333332,9.120000000000005,297,316,19,chroma_acts_smoothed
38,8,151.47733333333332,185.005,33.527666666666676,316,384,68,chroma_acts_smoothed
38,1,0.0,14.677333333333332,14.677333333333332,0,31,31,ki_chroma
38,2,14.677333333333332,15.157333333333332,0.4800000000000004,31,32,1,ki_chroma
38,3,15.157333333333332,44.91733333333333,29.759999999999998,32,94,62,ki_chroma
38,4,44.91733333333333,106.35733333333333,61.44,94,222,128,ki_chroma
38,5,106.35733333333333,122.19733333333333,15.840000000000003,222,255,33,ki_chroma
38,6,122.19733333333333,124.11733333333332,1.9199999999999875,255,259,4,ki_chroma
38,7,124.11733333333332,151.95733333333334,27.840000000000018,259,317,58,ki_chroma
38,8,151.95733333333334,185.005,33.04766666666666,317,384,67,ki_chroma
38,1,0.0,14.677333333333332,14.677333333333332,0,31,31,ki_chroma_acts
38,2,14.677333333333332,15.157333333333332,0.4800000000000004,31,32,1,ki_chroma_acts
38,3,15.157333333333332,44.91733333333333,29.759999999999998,32,94,62,ki_chroma_acts
38,4,44.91733333333333,99.15733333333333,54.239999999999995,94,207,113,ki_chroma_acts
38,5,99.15733333333333,106.35733333333333,7.200000000000003,207,222,15,ki_chroma_acts
38,6,106.35733333333333,122.19733333333333,15.840000000000003,222,255,33,ki_chroma_acts
38,7,122.19733333333333,151.95733333333334,29.760000000000005,255,317,62,ki_chroma_acts
38,8,151.95733333333334,185.005,33.04766666666666,317,384,67,ki_chroma_acts
38,1,0.0,14.677333333333332,14.677333333333332,0,31,31,ki_chroma_acts_smoothed
38,2,14.677333333333332,30.517333333333333,15.840000000000002,31,64,33,ki_chroma_acts_smoothed
38,3,30.517333333333333,45.39733333333333,14.879999999999995,64,95,31,ki_chroma_acts_smoothed
38,4,45.39733333333333,105.87733333333333,60.48,95,221,126,ki_chroma_acts_smoothed
38,5,105.87733333333333,122.19733333333333,16.320000000000007,221,255,34,ki_chroma_acts_smoothed
38,6,122.19733333333333,142.35733333333332,20.159999999999982,255,297,42,ki_chroma_acts_smoothed
38,7,142.35733333333332,151.47733333333332,9.120000000000005,297,316,19,ki_chroma_acts_smoothed
38,8,151.47733333333332,185.005,33.527666666666676,316,384,68,ki_chroma_acts_smoothed
40,1,0.0,29.855999999999998,29.855999999999998,0,64,64,chromagram
40,2,29.855999999999998,90.86933333333333,61.013333333333335,64,194,130,chromagram
40,3,90.86933333333333,106.35733333333333,15.488,194,227,33,chromagram
40,4,106.35733333333333,122.784,16.426666666666677,227,262,35,chromagram
40,5,122.784,133.10933333333332,10.325333333333319,262,284,22,chromagram
40,6,133.10933333333332,136.86399999999998,3.754666666666651,284,292,8,chromagram
40,7,136.86399999999998,164.55466666666666,27.690666666666687,292,351,59,chromagram
40,8,164.55466666666666,166.432,1.8773333333333255,351,355,4,chromagram
40,9,166.432,181.875,15.443000000000012,355,386,31,chromagram
40,1,0.0,31.73333333333333,31.73333333333333,0,68,68,chroma_acts
40,2,31.73333333333333,58.95466666666667,27.221333333333337,68,126,58,chroma_acts
40,3,58.95466666666667,62.24,3.285333333333334,126,133,7,chroma_acts
40,4,62.24,90.86933333333333,28.629333333333328,133,194,61,chroma_acts
40,5,90.86933333333333,105.41866666666667,14.549333333333337,194,225,31,chroma_acts
40,6,105.41866666666667,122.784,17.36533333333334,225,262,37,chroma_acts
40,7,122.784,132.17066666666665,9.386666666666642,262,282,20,chroma_acts
40,8,132.17066666666665,136.86399999999998,4.693333333333328,282,292,10,chroma_acts
40,9,136.86399999999998,181.875,45.011000000000024,292,386,94,chroma_acts
40,1,0.0,31.73333333333333,31.73333333333333,0,68,68,chroma_acts_smoothed
40,2,31.73333333333333,58.016,26.282666666666668,68,124,56,chroma_acts_smoothed
40,3,58.016,61.77066666666667,3.7546666666666724,124,132,8,chroma_acts_smoothed
40,4,61.77066666666667,90.86933333333333,29.09866666666666,132,194,62,chroma_acts_smoothed
40,5,90.86933333333333,104.48,13.610666666666674,194,223,29,chroma_acts_smoothed
40,6,104.48,122.784,18.304000000000002,223,262,39,chroma_acts_smoothed
40,7,122.784,131.7013333333333,8.917333333333303,262,281,19,chroma_acts_smoothed
40,8,131.7013333333333,136.86399999999998,5.1626666666666665,281,292,11,chroma_acts_smoothed
40,9,136.86399999999998,181.875,45.011000000000024,292,386,94,chroma_acts_smoothed
40,1,0.0,29.855999999999998,29.855999999999998,0,64,64,ki_chroma
40,2,29.855999999999998,90.86933333333333,61.013333333333335,64,194,130,ki_chroma
40,3,90.86933333333333,106.35733333333333,15.488,194,227,33,ki_chroma
40,4,106.35733333333333,122.784,16.426666666666677,227,262,35,ki_chroma
40,5,122.784,133.10933333333332,10.325333333333319,262,284,22,ki_chroma
40,6,133.10933333333332,136.86399999999998,3.754666666666651,284,292,8,ki_chroma
40,7,136.86399999999998,164.55466666666666,27.690666666666687,292,351,59,ki_chroma
40,8,164.55466666666666,166.432,1.8773333333333255,351,355,4,ki_chroma
40,9,166.432,181.875,15.443000000000012,355,386,31,ki_chroma
40,1,0.0,31.73333333333333,31.73333333333333,0,68,68,ki_chroma_acts
40,2,31.73333333333333,58.95466666666667,27.221333333333337,68,126,58,ki_chroma_acts
40,3,58.95466666666667,62.24,3.285333333333334,126,133,7,ki_chroma_acts
40,4,62.24,90.86933333333333,28.629333333333328,133,194,61,ki_chroma_acts
40,5,90.86933333333333,105.41866666666667,14.549333333333337,194,225,31,ki_chroma_acts
40,6,105.41866666666667,122.784,17.36533333333334,225,262,37,ki_chroma_acts
40,7,122.784,132.17066666666665,9.386666666666642,262,282,20,ki_chroma_acts
40,8,132.17066666666665,136.86399999999998,4.693333333333328,282,292,10,ki_chroma_acts
40,9,136.86399999999998,181.875,45.011000000000024,292,386,94,ki_chroma_acts
40,1,0.0,31.73333333333333,31.73333333333333,0,68,68,ki_chroma_acts_smoothed
40,2,31.73333333333333,58.016,26.282666666666668,68,124,56,ki_chroma_acts_smoothed
40,3,58.016,61.77066666666667,3.7546666666666724,124,132,8,ki_chroma_acts_smoothed
40,4,61.77066666666667,90.86933333333333,29.09866666666666,132,194,62,ki_chroma_acts_smoothed
40,5,90.86933333333333,104.48,13.610666666666674,194,223,29,ki_chroma_acts_smoothed
40,6,104.48,122.784,18.304000000000002,223,262,39,ki_chroma_acts_smoothed
40,7,122.784,131.7013333333333,8.917333333333303,262,281,19,ki_chroma_acts_smoothed
40,8,131.7013333333333,136.86399999999998,5.1626666666666665,281,292,11,ki_chroma_acts_smoothed
40,9,136.86399999999998,181.875,45.011000000000024,292,386,94,ki_chroma_acts_smoothed
41,1,0.0,29.621333333333332,29.621333333333332,0,64,64,chromagram
41,2,29.621333333333332,43.70133333333333,14.079999999999998,64,94,30,chromagram
41,3,43.70133333333333,45.57866666666666,1.8773333333333326,94,98,4,chromagram
41,4,45.57866666666666,89.22666666666666,43.647999999999996,98,191,93,chromagram
41,5,89.22666666666666,100.49066666666667,11.26400000000001,191,215,24,chromagram
41,6,100.49066666666667,116.91733333333333,16.426666666666662,215,250,35,chromagram
41,7,116.91733333333333,128.18133333333333,11.263999999999996,250,274,24,chromagram
41,8,128.18133333333333,135.6906666666667,7.509333333333359,274,290,16,chromagram
41,9,135.6906666666667,166.53,30.839333333333315,290,354,64,chromagram
41,1,0.0,29.621333333333332,29.621333333333332,0,64,64,chroma_acts
41,2,29.621333333333332,74.208,44.586666666666666,64,159,95,chroma_acts
41,3,74.208,75.616,1.4080000000000013,159,162,3,chroma_acts
41,4,75.616,89.22666666666666,13.61066666666666,162,191,29,chroma_acts
41,5,89.22666666666666,100.02133333333333,10.794666666666672,191,214,23,chroma_acts
41,6,100.02133333333333,116.91733333333333,16.896,214,250,36,chroma_acts
41,7,116.91733333333333,128.18133333333333,11.263999999999996,250,274,24,chroma_acts
41,8,128.18133333333333,135.6906666666667,7.509333333333359,274,290,16,chroma_acts
41,9,135.6906666666667,166.53,30.839333333333315,290,354,64,chroma_acts
41,1,0.0,29.621333333333332,29.621333333333332,0,64,64,chroma_acts_smoothed
41,2,29.621333333333332,74.208,44.586666666666666,64,159,95,chroma_acts_smoothed
41,3,74.208,75.616,1.4080000000000013,159,162,3,chroma_acts_smoothed
41,4,75.616,89.22666666666666,13.61066666666666,162,191,29,chroma_acts_smoothed
41,5,89.22666666666666,100.02133333333333,10.794666666666672,191,214,23,chroma_acts_smoothed
41,6,100.02133333333333,111.28533333333333,11.263999999999996,214,238,24,chroma_acts_smoothed
41,7,111.28533333333333,128.18133333333333,16.896,238,274,36,chroma_acts_smoothed
41,8,128.18133333333333,135.6906666666667,7.509333333333359,274,290,16,chroma_acts_smoothed
41,9,135.6906666666667,166.53,30.839333333333315,290,354,64,chroma_acts_smoothed
41,1,0.0,29.621333333333332,29.621333333333332,0,64,64,ki_chroma
41,2,29.621333333333332,43.70133333333333,14.079999999999998,64,94,30,ki_chroma
41,3,43.70133333333333,45.57866666666666,1.8773333333333326,94,98,4,ki_chroma
41,4,45.57866666666666,89.22666666666666,43.647999999999996,98,191,93,ki_chroma
41,5,89.22666666666666,100.49066666666667,11.26400000000001,191,215,24,ki_chroma
41,6,100.49066666666667,116.91733333333333,16.426666666666662,215,250,35,ki_chroma
41,7,116.91733333333333,128.18133333333333,11.263999999999996,250,274,24,ki_chroma
41,8,128.18133333333333,135.6906666666667,7.509333333333359,274,290,16,ki_chroma
41,9,135.6906666666667,166.53,30.839333333333315,290,354,64,ki_chroma
41,1,0.0,29.621333333333332,29.621333333333332,0,64,64,ki_chroma_acts
41,2,29.621333333333332,74.208,44.586666666666666,64,159,95,ki_chroma_acts
41,3,74.208,75.616,1.4080000000000013,159,162,3,ki_chroma_acts
41,4,75.616,89.22666666666666,13.61066666666666,162,191,29,ki_chroma_acts
41,5,89.22666666666666,100.02133333333333,10.794666666666672,191,214,23,ki_chroma_acts
41,6,100.02133333333333,116.91733333333333,16.896,214,250,36,ki_chroma_acts
41,7,116.91733333333333,128.18133333333333,11.263999999999996,250,274,24,ki_chroma_acts
41,8,128.18133333333333,135.6906666666667,7.509333333333359,274,290,16,ki_chroma_acts
41,9,135.6906666666667,166.53,30.839333333333315,290,354,64,ki_chroma_acts
41,1,0.0,29.621333333333332,29.621333333333332,0,64,64,ki_chroma_acts_smoothed
41,2,29.621333333333332,74.208,44.586666666666666,64,159,95,ki_chroma_acts_smoothed
41,3,74.208,75.616,1.4080000000000013,159,162,3,ki_chroma_acts_smoothed
41,4,75.616,89.22666666666666,13.61066666666666,162,191,29,ki_chroma_acts_smoothed
41,5,89.22666666666666,100.02133333333333,10.794666666666672,191,214,23,ki_chroma_acts_smoothed
41,6,100.02133333333333,111.28533333333333,11.263999999999996,214,238,24,ki_chroma_acts_smoothed
41,7,111.28533333333333,128.18133333333333,16.896,238,274,36,ki_chroma_acts_smoothed
41,8,128.18133333333333,135.6906666666667,7.509333333333359,274,290,16,ki_chroma_acts_smoothed
41,9,135.6906666666667,166.53,30.839333333333315,290,354,64,ki_chroma_acts_smoothed
43,1,0.0,28.693333333333335,28.693333333333335,0,62,62,chromagram
43,2,28.693333333333335,58.26133333333333,29.567999999999998,62,125,63,chromagram
43,3,58.26133333333333,60.138666666666666,1.8773333333333326,125,129,4,chromagram
43,4,60.138666666666666,88.768,28.629333333333335,129,190,61,chromagram
43,5,88.768,105.19466666666666,16.426666666666662,190,225,35,chromagram
43,6,105.19466666666666,120.68266666666666,15.488,225,258,33,chromagram
43,7,120.68266666666666,135.232,14.549333333333337,258,289,31,chromagram
43,8,135.232,166.079,30.84700000000001,289,353,64,chromagram
43,1,0.0,28.693333333333335,28.693333333333335,0,62,62,chroma_acts
43,2,28.693333333333335,60.138666666666666,31.44533333333333,62,129,67,chroma_acts
43,3,60.138666666666666,88.768,28.629333333333335,129,190,61,chroma_acts
43,4,88.768,105.664,16.896,190,226,36,chroma_acts
43,5,105.664,120.68266666666666,15.018666666666661,226,258,32,chroma_acts
43,6,120.68266666666666,135.232,14.549333333333337,258,289,31,chroma_acts
43,7,135.232,166.079,30.84700000000001,289,353,64,chroma_acts
43,1,0.0,28.693333333333335,28.693333333333335,0,62,62,chroma_acts_smoothed
43,2,28.693333333333335,60.138666666666666,31.44533333333333,62,129,67,chroma_acts_smoothed
43,3,60.138666666666666,88.768,28.629333333333335,129,190,61,chroma_acts_smoothed
43,4,88.768,105.19466666666666,16.426666666666662,190,225,35,chroma_acts_smoothed
43,5,105.19466666666666,120.68266666666666,15.488,225,258,33,chroma_acts_smoothed
43,6,120.68266666666666,135.232,14.549333333333337,258,289,31,chroma_acts_smoothed
43,7,135.232,166.079,30.84700000000001,289,353,64,chroma_acts_smoothed
43,1,0.0,28.693333333333335,28.693333333333335,0,62,62,ki_chroma
43,2,28.693333333333335,58.26133333333333,29.567999999999998,62,125,63,ki_chroma
43,3,58.26133333333333,60.138666666666666,1.8773333333333326,125,129,4,ki_chroma
43,4,60.138666666666666,88.768,28.629333333333335,129,190,61,ki_chroma
43,5,88.768,105.19466666666666,16.426666666666662,190,225,35,ki_chroma
43,6,105.19466666666666,120.68266666666666,15.488,225,258,33,ki_chroma
43,7,120.68266666666666,135.232,14.549333333333337,258,289,31,ki_chroma
43,8,135.232,166.079,30.84700000000001,289,353,64,ki_chroma
43,1,0.0,28.693333333333335,28.693333333333335,0,62,62,ki_chroma_acts
43,2,28.693333333333335,60.138666666666666,31.44533333333333,62,129,67,ki_chroma_acts
43,3,60.138666666666666,88.768,28.629333333333335,129,190,61,ki_chroma_acts
43,4,88.768,105.664,16.896,190,226,36,ki_chroma_acts
43,5,105.664,120.68266666666666,15.018666666666661,226,258,32,ki_chroma_acts
43,6,120.68266666666666,135.232,14.549333333333337,258,289,31,ki_chroma_acts
43,7,135.232,166.079,30.84700000000001,289,353,64,ki_chroma_acts
43,1,0.0,28.693333333333335,28.693333333333335,0,62,62,ki_chroma_acts_smoothed
43,2,28.693333333333335,60.138666666666666,31.44533333333333,62,129,67,ki_chroma_acts_smoothed
43,3,60.138666666666666,88.768,28.629333333333335,129,190,61,ki_chroma_acts_smoothed
43,4,88.768,105.19466666666666,16.426666666666662,190,225,35,ki_chroma_acts_smoothed
43,5,105.19466666666666,120.68266666666666,15.488,225,258,33,ki_chroma_acts_smoothed
43,6,120.68266666666666,135.232,14.549333333333337,258,289,31,ki_chroma_acts_smoothed
43,7,135.232,166.079,30.84700000000001,289,353,64,ki_chroma_acts_smoothed
46,1,0.0,6.005333333333334,6.005333333333334,0,13,13,chromagram
46,2,6.005333333333334,41.333333333333336,35.328,13,85,72,chromagram
46,3,41.333333333333336,57.03466666666667,15.701333333333338,85,117,32,chromagram
46,4,57.03466666666667,74.69866666666667,17.663999999999994,117,153,36,chromagram
46,5,74.69866666666667,88.43733333333334,13.738666666666674,153,181,28,chromagram
46,6,88.43733333333334,106.10133333333334,17.664,181,217,36,chromagram
46,7,106.10133333333334,126.70933333333335,20.608000000000004,217,259,42,chromagram
46,8,126.70933333333335,130.63466666666667,3.9253333333333273,259,267,8,chromagram
46,9,130.63466666666667,168.058,37.42333333333332,267,342,75,chromagram
46,1,0.0,6.005333333333334,6.005333333333334,0,13,13,chroma_acts
46,2,6.005333333333334,41.333333333333336,35.328,13,85,72,chroma_acts
46,3,41.333333333333336,57.03466666666667,15.701333333333338,85,117,32,chroma_acts
46,4,57.03466666666667,74.69866666666667,17.663999999999994,117,153,36,chroma_acts
46,5,74.69866666666667,107.08266666666667,32.384,153,219,66,chroma_acts
46,6,107.08266666666667,124.25600000000001,17.173333333333346,219,254,35,chroma_acts
46,7,124.25600000000001,126.70933333333335,2.453333333333333,254,259,5,chroma_acts
46,8,126.70933333333335,132.10666666666668,5.397333333333336,259,270,11,chroma_acts
46,9,132.10666666666668,168.058,35.95133333333331,270,342,72,chroma_acts
46,1,0.0,6.005333333333334,6.005333333333334,0,13,13,chroma_acts_smoothed
46,2,6.005333333333334,41.824000000000005,35.81866666666667,13,86,73,chroma_acts_smoothed
46,3,41.824000000000005,57.03466666666667,15.210666666666668,86,117,31,chroma_acts_smoothed
46,4,57.03466666666667,74.69866666666667,17.663999999999994,117,153,36,chroma_acts_smoothed
46,5,74.69866666666667,106.10133333333334,31.402666666666676,153,217,64,chroma_acts_smoothed
46,6,106.10133333333334,124.25600000000001,18.15466666666667,217,254,37,chroma_acts_smoothed
46,7,124.25600000000001,126.70933333333335,2.453333333333333,254,259,5,chroma_acts_smoothed
46,8,126.70933333333335,132.10666666666668,5.397333333333336,259,270,11,chroma_acts_smoothed
46,9,132.10666666666668,168.058,35.95133333333331,270,342,72,chroma_acts_smoothed
46,1,0.0,6.005333333333334,6.005333333333334,0,13,13,ki_chroma
46,2,6.005333333333334,41.333333333333336,35.328,13,85,72,ki_chroma
46,3,41.333333333333336,57.03466666666667,15.701333333333338,85,117,32,ki_chroma
46,4,57.03466666666667,74.69866666666667,17.663999999999994,117,153,36,ki_chroma
46,5,74.69866666666667,88.43733333333334,13.738666666666674,153,181,28,ki_chroma
46,6,88.43733333333334,106.10133333333334,17.664,181,217,36,ki_chroma
46,7,106.10133333333334,126.70933333333335,20.608000000000004,217,259,42,ki_chroma
46,8,126.70933333333335,130.63466666666667,3.9253333333333273,259,267,8,ki_chroma
46,9,130.63466666666667,168.058,37.42333333333332,267,342,75,ki_chroma
46,1,0.0,6.005333333333334,6.005333333333334,0,13,13,ki_chroma_acts
46,2,6.005333333333334,41.333333333333336,35.328,13,85,72,ki_chroma_acts
46,3,41.333333333333336,57.03466666666667,15.701333333333338,85,117,32,ki_chroma_acts
46,4,57.03466666666667,74.69866666666667,17.663999999999994,117,153,36,ki_chroma_acts
46,5,74.69866666666667,107.08266666666667,32.384,153,219,66,ki_chroma_acts
46,6,107.08266666666667,124.25600000000001,17.173333333333346,219,254,35,ki_chroma_acts
46,7,124.25600000000001,126.70933333333335,2.453333333333333,254,259,5,ki_chroma_acts
46,8,126.70933333333335,132.10666666666668,5.397333333333336,259,270,11,ki_chroma_acts
46,9,132.10666666666668,168.058,35.95133333333331,270,342,72,ki_chroma_acts
46,1,0.0,6.005333333333334,6.005333333333334,0,13,13,ki_chroma_acts_smoothed
46,2,6.005333333333334,41.824000000000005,35.81866666666667,13,86,73,ki_chroma_acts_smoothed
46,3,41.824000000000005,57.03466666666667,15.210666666666668,86,117,31,ki_chroma_acts_smoothed
46,4,57.03466666666667,74.69866666666667,17.663999999999994,117,153,36,ki_chroma_acts_smoothed
46,5,74.69866666666667,106.10133333333334,31.402666666666676,153,217,64,ki_chroma_acts_smoothed
46,6,106.10133333333334,124.25600000000001,18.15466666666667,217,254,37,ki_chroma_acts_smoothed
46,7,124.25600000000001,126.70933333333335,2.453333333333333,254,259,5,ki_chroma_acts_smoothed
46,8,126.70933333333335,132.10666666666668,5.397333333333336,259,270,11,ki_chroma_acts_smoothed
46,9,132.10666666666668,168.058,35.95133333333331,270,342,72,ki_chroma_acts_smoothed
48,1,0.0,7.306666666666666,7.306666666666666,0,16,16,chromagram
48,2,7.306666666666666,26.026666666666664,18.72,16,55,39,chromagram
48,3,26.026666666666664,44.74666666666667,18.720000000000006,55,94,39,chromagram
48,4,44.74666666666667,56.74666666666667,12.0,94,119,25,chromagram
48,5,56.74666666666667,79.30666666666667,22.560000000000002,119,166,47,chromagram
48,6,79.30666666666667,86.98666666666666,7.679999999999993,166,182,16,chromagram
48,7,86.98666666666666,117.70666666666666,30.72,182,246,64,chromagram
48,8,117.70666666666666,153.667,35.96033333333334,246,319,73,chromagram
48,1,0.0,7.306666666666666,7.306666666666666,0,16,16,chroma_acts
48,2,7.306666666666666,26.026666666666664,18.72,16,55,39,chroma_acts
48,3,26.026666666666664,44.74666666666667,18.720000000000006,55,94,39,chroma_acts
48,4,44.74666666666667,56.74666666666667,12.0,94,119,25,chroma_acts
48,5,56.74666666666667,79.30666666666667,22.560000000000002,119,166,47,chroma_acts
48,6,79.30666666666667,86.98666666666666,7.679999999999993,166,182,16,chroma_acts
48,7,86.98666666666666,117.70666666666666,30.72,182,246,64,chroma_acts
48,8,117.70666666666666,153.667,35.96033333333334,246,319,73,chroma_acts
48,1,0.0,7.306666666666666,7.306666666666666,0,16,16,chroma_acts_smoothed
48,2,7.306666666666666,26.506666666666664,19.2,16,56,40,chroma_acts_smoothed
48,3,26.506666666666664,44.74666666666667,18.240000000000006,56,94,38,chroma_acts_smoothed
48,4,44.74666666666667,56.74666666666667,12.0,94,119,25,chroma_acts_smoothed
48,5,56.74666666666667,79.30666666666667,22.560000000000002,119,166,47,chroma_acts_smoothed
48,6,79.30666666666667,86.98666666666666,7.679999999999993,166,182,16,chroma_acts_smoothed
48,7,86.98666666666666,117.22666666666666,30.239999999999995,182,245,63,chroma_acts_smoothed
48,8,117.22666666666666,153.667,36.44033333333334,245,319,74,chroma_acts_smoothed
48,1,0.0,7.306666666666666,7.306666666666666,0,16,16,ki_chroma
48,2,7.306666666666666,26.026666666666664,18.72,16,55,39,ki_chroma
48,3,26.026666666666664,44.74666666666667,18.720000000000006,55,94,39,ki_chroma
48,4,44.74666666666667,56.74666666666667,12.0,94,119,25,ki_chroma
48,5,56.74666666666667,79.30666666666667,22.560000000000002,119,166,47,ki_chroma
48,6,79.30666666666667,86.98666666666666,7.679999999999993,166,182,16,ki_chroma
48,7,86.98666666666666,117.70666666666666,30.72,182,246,64,ki_chroma
48,8,117.70666666666666,153.667,35.96033333333334,246,319,73,ki_chroma
48,1,0.0,7.306666666666666,7.306666666666666,0,16,16,ki_chroma_acts
48,2,7.306666666666666,26.026666666666664,18.72,16,55,39,ki_chroma_acts
48,3,26.026666666666664,44.74666666666667,18.720000000000006,55,94,39,ki_chroma_acts
48,4,44.74666666666667,56.74666666666667,12.0,94,119,25,ki_chroma_acts
48,5,56.74666666666667,79.30666666666667,22.560000000000002,119,166,47,ki_chroma_acts
48,6,79.30666666666667,86.98666666666666,7.679999999999993,166,182,16,ki_chroma_acts
48,7,86.98666666666666,117.70666666666666,30.72,182,246,64,ki_chroma_acts
48,8,117.70666666666666,153.667,35.96033333333334,246,319,73,ki_chroma_acts
48,1,0.0,7.306666666666666,7.306666666666666,0,16,16,ki_chroma_acts_smoothed
48,2,7.306666666666666,26.506666666666664,19.2,16,56,40,ki_chroma_acts_smoothed
48,3,26.506666666666664,44.74666666666667,18.240000000000006,56,94,38,ki_chroma_acts_smoothed
48,4,44.74666666666667,56.74666666666667,12.0,94,119,25,ki_chroma_acts_smoothed
48,5,56.74666666666667,79.30666666666667,22.560000000000002,119,166,47,ki_chroma_acts_smoothed
48,6,79.30666666666667,86.98666666666666,7.679999999999993,166,182,16,ki_chroma_acts_smoothed
48,7,86.98666666666666,117.22666666666666,30.239999999999995,182,245,63,ki_chroma_acts_smoothed
48,8,117.22666666666666,153.667,36.44033333333334,245,319,74,ki_chroma_acts_smoothed
51,1,0.0,30.517333333333333,30.517333333333333,0,64,64,chromagram
51,2,30.517333333333333,59.31733333333333,28.799999999999997,64,124,60,chromagram
51,3,59.31733333333333,61.23733333333333,1.9200000000000017,124,128,4,chromagram
51,4,61.23733333333333,91.47733333333333,30.240000000000002,128,191,63,chromagram
51,5,91.47733333333333,120.75733333333332,29.279999999999987,191,252,61,chromagram
51,6,120.75733333333332,122.67733333333332,1.9200000000000017,252,256,4,chromagram
51,7,122.67733333333332,151.95733333333334,29.280000000000015,256,317,61,chromagram
51,8,151.95733333333334,153.39733333333334,1.4399999999999977,317,320,3,chromagram
51,9,153.39733333333334,184.32,30.922666666666657,320,383,63,chromagram
51,1,0.0,30.517333333333333,30.517333333333333,0,64,64,chroma_acts
51,2,30.517333333333333,59.31733333333333,28.799999999999997,64,124,60,chroma_acts
51,3,59.31733333333333,61.23733333333333,1.9200000000000017,124,128,4,chroma_acts
51,4,61.23733333333333,91.47733333333333,30.240000000000002,128,191,63,chroma_acts
51,5,91.47733333333333,121.23733333333332,29.75999999999999,191,253,62,chroma_acts
51,6,121.23733333333332,122.67733333333332,1.4399999999999977,253,256,3,chroma_acts
51,7,122.67733333333332,151.95733333333334,29.280000000000015,256,317,61,chroma_acts
51,8,151.95733333333334,153.39733333333334,1.4399999999999977,317,320,3,chroma_acts
51,9,153.39733333333334,184.32,30.922666666666657,320,383,63,chroma_acts
51,1,0.0,30.517333333333333,30.517333333333333,0,64,64,chroma_acts_smoothed
51,2,30.517333333333333,59.31733333333333,28.799999999999997,64,124,60,chroma_acts_smoothed
51,3,59.31733333333333,61.71733333333333,2.3999999999999986,124,129,5,chroma_acts_smoothed
51,4,61.71733333333333,91.47733333333333,29.760000000000005,129,191,62,chroma_acts_smoothed
51,5,91.47733333333333,121.23733333333332,29.75999999999999,191,253,62,chroma_acts_smoothed
51,6,121.23733333333332,122.67733333333332,1.4399999999999977,253,256,3,chroma_acts_smoothed
51,7,122.67733333333332,151.47733333333332,28.799999999999997,256,316,60,chroma_acts_smoothed
51,8,151.47733333333332,153.39733333333334,1.920000000000016,316,320,4,chroma_acts_smoothed
51,9,153.39733333333334,184.32,30.922666666666657,320,383,63,chroma_acts_smoothed
51,1,0.0,30.517333333333333,30.517333333333333,0,64,64,ki_chroma
51,2,30.517333333333333,59.31733333333333,28.799999999999997,64,124,60,ki_chroma
51,3,59.31733333333333,61.23733333333333,1.9200000000000017,124,128,4,ki_chroma
51,4,61.23733333333333,91.47733333333333,30.240000000000002,128,191,63,ki_chroma
51,5,91.47733333333333,120.75733333333332,29.279999999999987,191,252,61,ki_chroma
51,6,120.75733333333332,122.67733333333332,1.9200000000000017,252,256,4,ki_chroma
51,7,122.67733333333332,151.95733333333334,29.280000000000015,256,317,61,ki_chroma
51,8,151.95733333333334,153.39733333333334,1.4399999999999977,317,320,3,ki_chroma
51,9,153.39733333333334,184.32,30.922666666666657,320,383,63,ki_chroma
51,1,0.0,30.517333333333333,30.517333333333333,0,64,64,ki_chroma_acts
51,2,30.517333333333333,59.31733333333333,28.799999999999997,64,124,60,ki_chroma_acts
51,3,59.31733333333333,61.23733333333333,1.9200000000000017,124,128,4,ki_chroma_acts
51,4,61.23733333333333,91.47733333333333,30.240000000000002,128,191,63,ki_chroma_acts
51,5,91.47733333333333,121.23733333333332,29.75999999999999,191,253,62,ki_chroma_acts
51,6,121.23733333333332,122.67733333333332,1.4399999999999977,253,256,3,ki_chroma_acts
51,7,122.67733333333332,151.95733333333334,29.280000000000015,256,317,61,ki_chroma_acts
51,8,151.95733333333334,153.39733333333334,1.4399999999999977,317,320,3,ki_chroma_acts
51,9,153.39733333333334,184.32,30.922666666666657,320,383,63,ki_chroma_acts
51,1,0.0,30.517333333333333,30.517333333333333,0,64,64,ki_chroma_acts_smoothed
51,2,30.517333333333333,59.31733333333333,28.799999999999997,64,124,60,ki_chroma_acts_smoothed
51,3,59.31733333333333,61.71733333333333,2.3999999999999986,124,129,5,ki_chroma_acts_smoothed
51,4,61.71733333333333,91.47733333333333,29.760000000000005,129,191,62,ki_chroma_acts_smoothed
51,5,91.47733333333333,121.23733333333332,29.75999999999999,191,253,62,ki_chroma_acts_smoothed
51,6,121.23733333333332,122.67733333333332,1.4399999999999977,253,256,3,ki_chroma_acts_smoothed
51,7,122.67733333333332,151.47733333333332,28.799999999999997,256,316,60,ki_chroma_acts_smoothed
51,8,151.47733333333332,153.39733333333334,1.920000000000016,316,320,4,ki_chroma_acts_smoothed
51,9,153.39733333333334,184.32,30.922666666666657,320,383,63,ki_chroma_acts_smoothed
52,1,0.0,4.522666666666667,4.522666666666667,0,10,10,chromagram
52,2,4.522666666666667,8.362666666666668,3.8400000000000007,10,18,8,chromagram
52,3,8.362666666666668,12.202666666666667,3.84,18,26,8,chromagram
52,4,12.202666666666667,15.562666666666667,3.3599999999999994,26,33,7,chromagram
52,5,15.562666666666667,56.842666666666666,41.28,33,119,86,chromagram
52,6,56.842666666666666,71.72266666666667,14.880000000000003,119,150,31,chromagram
52,7,71.72266666666667,88.04266666666668,16.320000000000007,150,184,34,chromagram
52,8,88.04266666666668,92.84266666666667,4.799999999999997,184,194,10,chromagram
52,9,92.84266666666667,131.453,38.61033333333333,194,273,79,chromagram
52,1,0.0,4.522666666666667,4.522666666666667,0,10,10,chroma_acts
52,2,4.522666666666667,8.362666666666668,3.8400000000000007,10,18,8,chroma_acts
52,3,8.362666666666668,12.202666666666667,3.84,18,26,8,chroma_acts
52,4,12.202666666666667,15.562666666666667,3.3599999999999994,26,33,7,chroma_acts
52,5,15.562666666666667,56.842666666666666,41.28,33,119,86,chroma_acts
52,6,56.842666666666666,71.72266666666667,14.880000000000003,119,150,31,chroma_acts
52,7,71.72266666666667,88.04266666666668,16.320000000000007,150,184,34,chroma_acts
52,8,88.04266666666668,92.84266666666667,4.799999999999997,184,194,10,chroma_acts
52,9,92.84266666666667,131.453,38.61033333333333,194,273,79,chroma_acts
52,1,0.0,4.522666666666667,4.522666666666667,0,10,10,chroma_acts_smoothed
52,2,4.522666666666667,8.362666666666668,3.8400000000000007,10,18,8,chroma_acts_smoothed
52,3,8.362666666666668,12.202666666666667,3.84,18,26,8,chroma_acts_smoothed
52,4,12.202666666666667,15.562666666666667,3.3599999999999994,26,33,7,chroma_acts_smoothed
52,5,15.562666666666667,56.842666666666666,41.28,33,119,86,chroma_acts_smoothed
52,6,56.842666666666666,71.72266666666667,14.880000000000003,119,150,31,chroma_acts_smoothed
52,7,71.72266666666667,88.52266666666667,16.799999999999997,150,185,35,chroma_acts_smoothed
52,8,88.52266666666667,92.84266666666667,4.320000000000007,185,194,9,chroma_acts_smoothed
52,9,92.84266666666667,131.453,38.61033333333333,194,273,79,chroma_acts_smoothed
52,1,0.0,4.522666666666667,4.522666666666667,0,10,10,ki_chroma
52,2,4.522666666666667,8.362666666666668,3.8400000000000007,10,18,8,ki_chroma
52,3,8.362666666666668,12.202666666666667,3.84,18,26,8,ki_chroma
52,4,12.202666666666667,15.562666666666667,3.3599999999999994,26,33,7,ki_chroma
52,5,15.562666666666667,56.842666666666666,41.28,33,119,86,ki_chroma
52,6,56.842666666666666,71.72266666666667,14.880000000000003,119,150,31,ki_chroma
52,7,71.72266666666667,88.04266666666668,16.320000000000007,150,184,34,ki_chroma
52,8,88.04266666666668,92.84266666666667,4.799999999999997,184,194,10,ki_chroma
52,9,92.84266666666667,131.453,38.61033333333333,194,273,79,ki_chroma
52,1,0.0,4.522666666666667,4.522666666666667,0,10,10,ki_chroma_acts
52,2,4.522666666666667,8.362666666666668,3.8400000000000007,10,18,8,ki_chroma_acts
52,3,8.362666666666668,12.202666666666667,3.84,18,26,8,ki_chroma_acts
52,4,12.202666666666667,15.562666666666667,3.3599999999999994,26,33,7,ki_chroma_acts
52,5,15.562666666666667,56.842666666666666,41.28,33,119,86,ki_chroma_acts
52,6,56.842666666666666,71.72266666666667,14.880000000000003,119,150,31,ki_chroma_acts
52,7,71.72266666666667,88.04266666666668,16.320000000000007,150,184,34,ki_chroma_acts
52,8,88.04266666666668,92.84266666666667,4.799999999999997,184,194,10,ki_chroma_acts
52,9,92.84266666666667,131.453,38.61033333333333,194,273,79,ki_chroma_acts
52,1,0.0,4.522666666666667,4.522666666666667,0,10,10,ki_chroma_acts_smoothed
52,2,4.522666666666667,8.362666666666668,3.8400000000000007,10,18,8,ki_chroma_acts_smoothed
52,3,8.362666666666668,12.202666666666667,3.84,18,26,8,ki_chroma_acts_smoothed
52,4,12.202666666666667,15.562666666666667,3.3599999999999994,26,33,7,ki_chroma_acts_smoothed
52,5,15.562666666666667,56.842666666666666,41.28,33,119,86,ki_chroma_acts_smoothed
52,6,56.842666666666666,71.72266666666667,14.880000000000003,119,150,31,ki_chroma_acts_smoothed
52,7,71.72266666666667,88.52266666666667,16.799999999999997,150,185,35,ki_chroma_acts_smoothed
52,8,88.52266666666667,92.84266666666667,4.320000000000007,185,194,9,ki_chroma_acts_smoothed
52,9,92.84266666666667,131.453,38.61033333333333,194,273,79,ki_chroma_acts_smoothed
54,1,0.0,14.901333333333334,14.901333333333334,0,32,32,chromagram
54,2,14.901333333333334,22.410666666666668,7.509333333333334,32,48,16,chromagram
54,3,22.410666666666668,45.407999999999994,22.997333333333327,48,97,49,chromagram
54,4,45.407999999999994,52.44799999999999,7.039999999999999,97,112,15,chromagram
54,5,52.44799999999999,94.21866666666666,41.77066666666667,112,201,89,chromagram
54,6,94.21866666666666,132.23466666666667,38.016000000000005,201,282,81,chromagram
54,7,132.23466666666667,140.68266666666668,8.448000000000008,282,300,18,chromagram
54,8,140.68266666666668,202.844,62.16133333333332,300,431,131,chromagram
54,1,0.0,7.8613333333333335,7.8613333333333335,0,17,17,chroma_acts
54,2,7.8613333333333335,14.901333333333334,7.04,17,32,15,chroma_acts
54,3,14.901333333333334,22.410666666666668,7.509333333333334,32,48,16,chroma_acts
54,4,22.410666666666668,44.93866666666666,22.527999999999995,48,96,48,chroma_acts
54,5,44.93866666666666,52.44799999999999,7.5093333333333305,96,112,16,chroma_acts
54,6,52.44799999999999,95.15733333333334,42.70933333333335,112,203,91,chroma_acts
54,7,95.15733333333334,140.68266666666668,45.525333333333336,203,300,97,chroma_acts
54,8,140.68266666666668,202.844,62.16133333333332,300,431,131,chroma_acts
54,1,0.0,7.8613333333333335,7.8613333333333335,0,17,17,chroma_acts_smoothed
54,2,7.8613333333333335,14.901333333333334,7.04,17,32,15,chroma_acts_smoothed
54,3,14.901333333333334,22.410666666666668,7.509333333333334,32,48,16,chroma_acts_smoothed
54,4,22.410666666666668,44.93866666666666,22.527999999999995,48,96,48,chroma_acts_smoothed
54,5,44.93866666666666,52.44799999999999,7.5093333333333305,96,112,16,chroma_acts_smoothed
54,6,52.44799999999999,93.74933333333334,41.301333333333346,112,200,88,chroma_acts_smoothed
54,7,93.74933333333334,140.68266666666668,46.93333333333334,200,300,100,chroma_acts_smoothed
54,8,140.68266666666668,194.656,53.97333333333333,300,415,115,chroma_acts_smoothed
54,9,194.656,202.844,8.187999999999988,415,431,16,chroma_acts_smoothed
54,1,0.0,14.901333333333334,14.901333333333334,0,32,32,ki_chroma
54,2,14.901333333333334,22.410666666666668,7.509333333333334,32,48,16,ki_chroma
54,3,22.410666666666668,45.407999999999994,22.997333333333327,48,97,49,ki_chroma
54,4,45.407999999999994,52.44799999999999,7.039999999999999,97,112,15,ki_chroma
54,5,52.44799999999999,94.21866666666666,41.77066666666667,112,201,89,ki_chroma
54,6,94.21866666666666,132.23466666666667,38.016000000000005,201,282,81,ki_chroma
54,7,132.23466666666667,140.68266666666668,8.448000000000008,282,300,18,ki_chroma
54,8,140.68266666666668,202.844,62.16133333333332,300,431,131,ki_chroma
54,1,0.0,7.8613333333333335,7.8613333333333335,0,17,17,ki_chroma_acts
54,2,7.8613333333333335,14.901333333333334,7.04,17,32,15,ki_chroma_acts
54,3,14.901333333333334,22.410666666666668,7.509333333333334,32,48,16,ki_chroma_acts
54,4,22.410666666666668,44.93866666666666,22.527999999999995,48,96,48,ki_chroma_acts
54,5,44.93866666666666,52.44799999999999,7.5093333333333305,96,112,16,ki_chroma_acts
54,6,52.44799999999999,95.15733333333334,42.70933333333335,112,203,91,ki_chroma_acts
54,7,95.15733333333334,140.68266666666668,45.525333333333336,203,300,97,ki_chroma_acts
54,8,140.68266666666668,202.844,62.16133333333332,300,431,131,ki_chroma_acts
54,1,0.0,7.8613333333333335,7.8613333333333335,0,17,17,ki_chroma_acts_smoothed
54,2,7.8613333333333335,14.901333333333334,7.04,17,32,15,ki_chroma_acts_smoothed
54,3,14.901333333333334,22.410666666666668,7.509333333333334,32,48,16,ki_chroma_acts_smoothed
54,4,22.410666666666668,44.93866666666666,22.527999999999995,48,96,48,ki_chroma_acts_smoothed
54,5,44.93866666666666,52.44799999999999,7.5093333333333305,96,112,16,ki_chroma_acts_smoothed
54,6,52.44799999999999,93.74933333333334,41.301333333333346,112,200,88,ki_chroma_acts_smoothed
54,7,93.74933333333334,140.68266666666668,46.93333333333334,200,300,100,ki_chroma_acts_smoothed
54,8,140.68266666666668,194.656,53.97333333333333,300,415,115,ki_chroma_acts_smoothed
54,9,194.656,202.844,8.187999999999988,415,431,16,ki_chroma_acts_smoothed
55,1,0.0,28.544,28.544,0,61,61,chromagram
55,2,28.544,104.576,76.032,61,223,162,chromagram
55,3,104.576,117.248,12.672000000000011,223,250,27,chromagram
55,4,117.248,150.10133333333332,32.85333333333331,250,320,70,chromagram
55,5,150.10133333333332,163.712,13.610666666666674,320,349,29,chromagram
55,6,163.712,189.99466666666666,26.28266666666667,349,405,56,chromagram
55,7,189.99466666666666,193.27999999999997,3.2853333333333126,405,412,7,chromagram
55,8,193.27999999999997,223.669,30.38900000000004,412,475,63,chromagram
55,1,0.0,11.178666666666667,11.178666666666667,0,24,24,chroma_acts
55,2,11.178666666666667,28.544,17.365333333333332,24,61,37,chroma_acts
55,3,28.544,104.576,76.032,61,223,162,chroma_acts
55,4,104.576,117.248,12.672000000000011,223,250,27,chroma_acts
55,5,117.248,150.10133333333332,32.85333333333331,250,320,70,chroma_acts
55,6,150.10133333333332,163.712,13.610666666666674,320,349,29,chroma_acts
55,7,163.712,189.99466666666666,26.28266666666667,349,405,56,chroma_acts
55,8,189.99466666666666,193.27999999999997,3.2853333333333126,405,412,7,chroma_acts
55,9,193.27999999999997,223.669,30.38900000000004,412,475,63,chroma_acts
55,1,0.0,11.178666666666667,11.178666666666667,0,24,24,chroma_acts_smoothed
55,2,11.178666666666667,28.544,17.365333333333332,24,61,37,chroma_acts_smoothed
55,3,28.544,104.576,76.032,61,223,162,chroma_acts_smoothed
55,4,104.576,117.248,12.672000000000011,223,250,27,chroma_acts_smoothed
55,5,117.248,150.10133333333332,32.85333333333331,250,320,70,chroma_acts_smoothed
55,6,150.10133333333332,163.24266666666665,13.141333333333336,320,348,28,chroma_acts_smoothed
55,7,163.24266666666665,189.99466666666666,26.75200000000001,348,405,57,chroma_acts_smoothed
55,8,189.99466666666666,192.81066666666666,2.8160000000000025,405,411,6,chroma_acts_smoothed
55,9,192.81066666666666,223.669,30.85833333333335,411,475,64,chroma_acts_smoothed
55,1,0.0,28.544,28.544,0,61,61,ki_chroma
55,2,28.544,104.576,76.032,61,223,162,ki_chroma
55,3,104.576,117.248,12.672000000000011,223,250,27,ki_chroma
55,4,117.248,150.10133333333332,32.85333333333331,250,320,70,ki_chroma
55,5,150.10133333333332,163.712,13.610666666666674,320,349,29,ki_chroma
55,6,163.712,189.99466666666666,26.28266666666667,349,405,56,ki_chroma
55,7,189.99466666666666,193.27999999999997,3.2853333333333126,405,412,7,ki_chroma
55,8,193.27999999999997,223.669,30.38900000000004,412,475,63,ki_chroma
55,1,0.0,11.178666666666667,11.178666666666667,0,24,24,ki_chroma_acts
55,2,11.178666666666667,28.544,17.365333333333332,24,61,37,ki_chroma_acts
55,3,28.544,104.576,76.032,61,223,162,ki_chroma_acts
55,4,104.576,117.248,12.672000000000011,223,250,27,ki_chroma_acts
55,5,117.248,150.10133333333332,32.85333333333331,250,320,70,ki_chroma_acts
55,6,150.10133333333332,163.712,13.610666666666674,320,349,29,ki_chroma_acts
55,7,163.712,189.99466666666666,26.28266666666667,349,405,56,ki_chroma_acts
55,8,189.99466666666666,193.27999999999997,3.2853333333333126,405,412,7,ki_chroma_acts
55,9,193.27999999999997,223.669,30.38900000000004,412,475,63,ki_chroma_acts
55,1,0.0,11.178666666666667,11.178666666666667,0,24,24,ki_chroma_acts_smoothed
55,2,11.178666666666667,28.544,17.365333333333332,24,61,37,ki_chroma_acts_smoothed
55,3,28.544,104.576,76.032,61,223,162,ki_chroma_acts_smoothed
55,4,104.576,117.248,12.672000000000011,223,250,27,ki_chroma_acts_smoothed
55,5,117.248,150.10133333333332,32.85333333333331,250,320,70,ki_chroma_acts_smoothed
55,6,150.10133333333332,163.24266666666665,13.141333333333336,320,348,28,ki_chroma_acts_smoothed
55,7,163.24266666666665,189.99466666666666,26.75200000000001,348,405,57,ki_chroma_acts_smoothed
55,8,189.99466666666666,192.81066666666666,2.8160000000000025,405,411,6,ki_chroma_acts_smoothed
55,9,192.81066666666666,223.669,30.85833333333335,411,475,64,ki_chroma_acts_smoothed
56,1,0.0,14.837333333333333,14.837333333333333,0,32,32,chromagram
56,2,14.837333333333333,56.138666666666666,41.30133333333333,32,120,88,chromagram
56,3,56.138666666666666,59.424,3.285333333333334,120,127,7,chromagram
56,4,59.424,71.15733333333334,11.733333333333341,127,152,25,chromagram
56,5,71.15733333333334,96.97066666666667,25.813333333333333,152,207,55,chromagram
56,6,96.97066666666667,111.98933333333333,15.018666666666661,207,239,32,chromagram
56,7,111.98933333333333,119.968,7.978666666666669,239,256,17,chromagram
56,8,119.968,165.306,45.33800000000001,256,351,95,chromagram
56,1,0.0,14.837333333333333,14.837333333333333,0,32,32,chroma_acts
56,2,14.837333333333333,44.87466666666667,30.037333333333336,32,96,64,chroma_acts
56,3,44.87466666666667,56.138666666666666,11.263999999999996,96,120,24,chroma_acts
56,4,56.138666666666666,59.424,3.285333333333334,120,127,7,chroma_acts
56,5,59.424,71.15733333333334,11.733333333333341,127,152,25,chroma_acts
56,6,71.15733333333334,97.44,26.282666666666657,152,208,56,chroma_acts
56,7,97.44,119.968,22.528000000000006,208,256,48,chroma_acts
56,8,119.968,165.306,45.33800000000001,256,351,95,chroma_acts
56,1,0.0,14.837333333333333,14.837333333333333,0,32,32,chroma_acts_smoothed
56,2,14.837333333333333,56.138666666666666,41.30133333333333,32,120,88,chroma_acts_smoothed
56,3,56.138666666666666,60.36266666666667,4.224000000000004,120,129,9,chroma_acts_smoothed
56,4,60.36266666666667,71.15733333333334,10.794666666666672,129,152,23,chroma_acts_smoothed
56,5,71.15733333333334,96.97066666666667,25.813333333333333,152,207,55,chroma_acts_smoothed
56,6,96.97066666666667,115.744,18.773333333333326,207,247,40,chroma_acts_smoothed
56,7,115.744,119.968,4.224000000000004,247,256,9,chroma_acts_smoothed
56,8,119.968,165.306,45.33800000000001,256,351,95,chroma_acts_smoothed
56,1,0.0,14.837333333333333,14.837333333333333,0,32,32,ki_chroma
56,2,14.837333333333333,56.138666666666666,41.30133333333333,32,120,88,ki_chroma
56,3,56.138666666666666,59.424,3.285333333333334,120,127,7,ki_chroma
56,4,59.424,71.15733333333334,11.733333333333341,127,152,25,ki_chroma
56,5,71.15733333333334,96.97066666666667,25.813333333333333,152,207,55,ki_chroma
56,6,96.97066666666667,111.98933333333333,15.018666666666661,207,239,32,ki_chroma
56,7,111.98933333333333,119.968,7.978666666666669,239,256,17,ki_chroma
56,8,119.968,165.306,45.33800000000001,256,351,95,ki_chroma
56,1,0.0,14.837333333333333,14.837333333333333,0,32,32,ki_chroma_acts
56,2,14.837333333333333,44.87466666666667,30.037333333333336,32,96,64,ki_chroma_acts
56,3,44.87466666666667,56.138666666666666,11.263999999999996,96,120,24,ki_chroma_acts
56,4,56.138666666666666,59.424,3.285333333333334,120,127,7,ki_chroma_acts
56,5,59.424,71.15733333333334,11.733333333333341,127,152,25,ki_chroma_acts
56,6,71.15733333333334,97.44,26.282666666666657,152,208,56,ki_chroma_acts
56,7,97.44,119.968,22.528000000000006,208,256,48,ki_chroma_acts
56,8,119.968,165.306,45.33800000000001,256,351,95,ki_chroma_acts
56,1,0.0,14.837333333333333,14.837333333333333,0,32,32,ki_chroma_acts_smoothed
56,2,14.837333333333333,56.138666666666666,41.30133333333333,32,120,88,ki_chroma_acts_smoothed
56,3,56.138666666666666,60.36266666666667,4.224000000000004,120,129,9,ki_chroma_acts_smoothed
56,4,60.36266666666667,71.15733333333334,10.794666666666672,129,152,23,ki_chroma_acts_smoothed
56,5,71.15733333333334,96.97066666666667,25.813333333333333,152,207,55,ki_chroma_acts_smoothed
56,6,96.97066666666667,115.744,18.773333333333326,207,247,40,ki_chroma_acts_smoothed
56,7,115.744,119.968,4.224000000000004,247,256,9,ki_chroma_acts_smoothed
56,8,119.968,165.306,45.33800000000001,256,351,95,ki_chroma_acts_smoothed
58,1,0.0,31.104,31.104,0,67,67,chromagram
58,2,31.104,90.70933333333333,59.605333333333334,67,194,127,chromagram
58,3,90.70933333333333,137.17333333333332,46.463999999999984,194,293,99,chromagram
58,4,137.17333333333332,213.67466666666664,76.50133333333332,293,456,163,chromagram
58,5,213.67466666666664,259.2,45.52533333333335,456,553,97,chromagram
58,6,259.2,274.21866666666665,15.018666666666661,553,585,32,chromagram
58,7,274.21866666666665,335.23199999999997,61.01333333333332,585,715,130,chromagram
58,8,335.23199999999997,365.73866666666663,30.50666666666666,715,780,65,chromagram
58,9,365.73866666666663,381.109,15.370333333333349,780,811,31,chromagram
58,1,0.0,31.104,31.104,0,67,67,chroma_acts
58,2,31.104,90.24,59.135999999999996,67,193,126,chroma_acts
58,3,90.24,137.17333333333332,46.93333333333332,193,293,100,chroma_acts
58,4,137.17333333333332,212.26666666666665,75.09333333333333,293,453,160,chroma_acts
58,5,212.26666666666665,259.2,46.93333333333334,453,553,100,chroma_acts
58,6,259.2,274.21866666666665,15.018666666666661,553,585,32,chroma_acts
58,7,274.21866666666665,335.23199999999997,61.01333333333332,585,715,130,chroma_acts
58,8,335.23199999999997,365.73866666666663,30.50666666666666,715,780,65,chroma_acts
58,9,365.73866666666663,381.109,15.370333333333349,780,811,31,chroma_acts
58,1,0.0,30.634666666666668,30.634666666666668,0,66,66,chroma_acts_smoothed
58,2,30.634666666666668,90.70933333333333,60.074666666666666,66,194,128,chroma_acts_smoothed
58,3,90.70933333333333,137.17333333333332,46.463999999999984,194,293,99,chroma_acts_smoothed
58,4,137.17333333333332,212.26666666666665,75.09333333333333,293,453,160,chroma_acts_smoothed
58,5,212.26666666666665,259.2,46.93333333333334,453,553,100,chroma_acts_smoothed
58,6,259.2,274.21866666666665,15.018666666666661,553,585,32,chroma_acts_smoothed
58,7,274.21866666666665,335.7013333333333,61.48266666666666,585,716,131,chroma_acts_smoothed
58,8,335.7013333333333,365.73866666666663,30.037333333333322,716,780,64,chroma_acts_smoothed
58,9,365.73866666666663,381.109,15.370333333333349,780,811,31,chroma_acts_smoothed
58,1,0.0,31.104,31.104,0,67,67,ki_chroma
58,2,31.104,90.70933333333333,59.605333333333334,67,194,127,ki_chroma
58,3,90.70933333333333,137.17333333333332,46.463999999999984,194,293,99,ki_chroma
58,4,137.17333333333332,213.67466666666664,76.50133333333332,293,456,163,ki_chroma
58,5,213.67466666666664,259.2,45.52533333333335,456,553,97,ki_chroma
58,6,259.2,274.21866666666665,15.018666666666661,553,585,32,ki_chroma
58,7,274.21866666666665,335.23199999999997,61.01333333333332,585,715,130,ki_chroma
58,8,335.23199999999997,365.73866666666663,30.50666666666666,715,780,65,ki_chroma
58,9,365.73866666666663,381.109,15.370333333333349,780,811,31,ki_chroma
58,1,0.0,31.104,31.104,0,67,67,ki_chroma_acts
58,2,31.104,90.24,59.135999999999996,67,193,126,ki_chroma_acts
58,3,90.24,137.17333333333332,46.93333333333332,193,293,100,ki_chroma_acts
58,4,137.17333333333332,212.26666666666665,75.09333333333333,293,453,160,ki_chroma_acts
58,5,212.26666666666665,259.2,46.93333333333334,453,553,100,ki_chroma_acts
58,6,259.2,274.21866666666665,15.018666666666661,553,585,32,ki_chroma_acts
58,7,274.21866666666665,335.23199999999997,61.01333333333332,585,715,130,ki_chroma_acts
58,8,335.23199999999997,365.73866666666663,30.50666666666666,715,780,65,ki_chroma_acts
58,9,365.73866666666663,381.109,15.370333333333349,780,811,31,ki_chroma_acts
58,1,0.0,30.634666666666668,30.634666666666668,0,66,66,ki_chroma_acts_smoothed
58,2,30.634666666666668,90.70933333333333,60.074666666666666,66,194,128,ki_chroma_acts_smoothed
58,3,90.70933333333333,137.17333333333332,46.463999999999984,194,293,99,ki_chroma_acts_smoothed
58,4,137.17333333333332,212.26666666666665,75.09333333333333,293,453,160,ki_chroma_acts_smoothed
58,5,212.26666666666665,259.2,46.93333333333334,453,553,100,ki_chroma_acts_smoothed
58,6,259.2,274.21866666666665,15.018666666666661,553,585,32,ki_chroma_acts_smoothed
58,7,274.21866666666665,335.7013333333333,61.48266666666666,585,716,131,ki_chroma_acts_smoothed
58,8,335.7013333333333,365.73866666666663,30.037333333333322,716,780,64,ki_chroma_acts_smoothed
58,9,365.73866666666663,381.109,15.370333333333349,780,811,31,ki_chroma_acts_smoothed
61,1,0.0,14.837333333333333,14.837333333333333,0,32,32,chromagram
61,2,14.837333333333333,28.917333333333332,14.079999999999998,32,62,30,chromagram
61,3,28.917333333333332,59.89333333333333,30.976,62,128,66,chromagram
61,4,59.89333333333333,119.96799999999999,60.07466666666666,128,256,128,chromagram
61,5,119.96799999999999,145.78133333333335,25.81333333333336,256,311,55,chromagram
61,6,145.78133333333335,153.76000000000002,7.978666666666669,311,328,17,chromagram
61,7,153.76000000000002,210.08,56.31999999999999,328,448,120,chromagram
61,8,210.08,225.568,15.488,448,481,33,chromagram
61,9,225.568,240.392,14.823999999999984,481,511,30,chromagram
61,1,0.0,14.837333333333333,14.837333333333333,0,32,32,chroma_acts
61,2,14.837333333333333,28.917333333333332,14.079999999999998,32,62,30,chroma_acts
61,3,28.917333333333332,59.89333333333333,30.976,62,128,66,chroma_acts
61,4,59.89333333333333,119.96799999999999,60.07466666666666,128,256,128,chroma_acts
61,5,119.96799999999999,147.18933333333334,27.221333333333348,256,314,58,chroma_acts
61,6,147.18933333333334,149.536,2.346666666666664,314,319,5,chroma_acts
61,7,149.536,153.76000000000002,4.224000000000018,319,328,9,chroma_acts
61,8,153.76000000000002,210.08,56.31999999999999,328,448,120,chroma_acts
61,9,210.08,240.392,30.311999999999983,448,511,63,chroma_acts
61,1,0.0,14.837333333333333,14.837333333333333,0,32,32,chroma_acts_smoothed
61,2,14.837333333333333,28.448,13.610666666666667,32,61,29,chroma_acts_smoothed
61,3,28.448,59.89333333333333,31.44533333333333,61,128,67,chroma_acts_smoothed
61,4,59.89333333333333,120.43733333333333,60.544,128,257,129,chroma_acts_smoothed
61,5,120.43733333333333,134.98666666666668,14.549333333333351,257,288,31,chroma_acts_smoothed
61,6,134.98666666666668,145.312,10.325333333333333,288,310,22,chroma_acts_smoothed
61,7,145.312,153.76000000000002,8.448000000000008,310,328,18,chroma_acts_smoothed
61,8,153.76000000000002,210.08,56.31999999999999,328,448,120,chroma_acts_smoothed
61,9,210.08,240.392,30.311999999999983,448,511,63,chroma_acts_smoothed
61,1,0.0,14.837333333333333,14.837333333333333,0,32,32,ki_chroma
61,2,14.837333333333333,28.917333333333332,14.079999999999998,32,62,30,ki_chroma
61,3,28.917333333333332,59.89333333333333,30.976,62,128,66,ki_chroma
61,4,59.89333333333333,119.96799999999999,60.07466666666666,128,256,128,ki_chroma
61,5,119.96799999999999,145.78133333333335,25.81333333333336,256,311,55,ki_chroma
61,6,145.78133333333335,153.76000000000002,7.978666666666669,311,328,17,ki_chroma
61,7,153.76000000000002,210.08,56.31999999999999,328,448,120,ki_chroma
61,8,210.08,225.568,15.488,448,481,33,ki_chroma
61,9,225.568,240.392,14.823999999999984,481,511,30,ki_chroma
61,1,0.0,14.837333333333333,14.837333333333333,0,32,32,ki_chroma_acts
61,2,14.837333333333333,28.917333333333332,14.079999999999998,32,62,30,ki_chroma_acts
61,3,28.917333333333332,59.89333333333333,30.976,62,128,66,ki_chroma_acts
61,4,59.89333333333333,119.96799999999999,60.07466666666666,128,256,128,ki_chroma_acts
61,5,119.96799999999999,147.18933333333334,27.221333333333348,256,314,58,ki_chroma_acts
61,6,147.18933333333334,149.536,2.346666666666664,314,319,5,ki_chroma_acts
61,7,149.536,153.76000000000002,4.224000000000018,319,328,9,ki_chroma_acts
61,8,153.76000000000002,210.08,56.31999999999999,328,448,120,ki_chroma_acts
61,9,210.08,240.392,30.311999999999983,448,511,63,ki_chroma_acts
61,1,0.0,14.837333333333333,14.837333333333333,0,32,32,ki_chroma_acts_smoothed
61,2,14.837333333333333,28.448,13.610666666666667,32,61,29,ki_chroma_acts_smoothed
61,3,28.448,59.89333333333333,31.44533333333333,61,128,67,ki_chroma_acts_smoothed
61,4,59.89333333333333,120.43733333333333,60.544,128,257,129,ki_chroma_acts_smoothed
61,5,120.43733333333333,134.98666666666668,14.549333333333351,257,288,31,ki_chroma_acts_smoothed
61,6,134.98666666666668,145.312,10.325333333333333,288,310,22,ki_chroma_acts_smoothed
61,7,145.312,153.76000000000002,8.448000000000008,310,328,18,ki_chroma_acts_smoothed
61,8,153.76000000000002,210.08,56.31999999999999,328,448,120,ki_chroma_acts_smoothed
61,9,210.08,240.392,30.311999999999983,448,511,63,ki_chroma_acts_smoothed
64,1,0.0,30.784,30.784,0,65,65,chromagram
64,2,30.784,60.06399999999999,29.279999999999994,65,126,61,chromagram
64,3,60.06399999999999,61.983999999999995,1.9200000000000017,126,130,4,chromagram
64,4,61.983999999999995,139.744,77.76,130,292,162,chromagram
64,5,139.744,184.38400000000001,44.640000000000015,292,385,93,chromagram
64,6,184.38400000000001,185.824,1.4399999999999977,385,388,3,chromagram
64,7,185.824,247.744,61.91999999999999,388,517,129,chromagram
64,8,247.744,278.926,31.181999999999988,517,580,63,chromagram
64,1,0.0,30.784,30.784,0,65,65,chroma_acts
64,2,30.784,35.104,4.32,65,74,9,chroma_acts
64,3,35.104,60.544,25.439999999999998,74,127,53,chroma_acts
64,4,60.544,139.744,79.2,127,292,165,chroma_acts
64,5,139.744,184.38400000000001,44.640000000000015,292,385,93,chroma_acts
64,6,184.38400000000001,185.824,1.4399999999999977,385,388,3,chroma_acts
64,7,185.824,247.744,61.91999999999999,388,517,129,chroma_acts
64,8,247.744,278.926,31.181999999999988,517,580,63,chroma_acts
64,1,0.0,30.304,30.304,0,64,64,chroma_acts_smoothed
64,2,30.304,35.104,4.800000000000001,64,74,10,chroma_acts_smoothed
64,3,35.104,60.06399999999999,24.959999999999994,74,126,52,chroma_acts_smoothed
64,4,60.06399999999999,139.264,79.20000000000002,126,291,165,chroma_acts_smoothed
64,5,139.264,143.584,4.319999999999993,291,300,9,chroma_acts_smoothed
64,6,143.584,185.824,42.24000000000001,300,388,88,chroma_acts_smoothed
64,7,185.824,248.224,62.39999999999998,388,518,130,chroma_acts_smoothed
64,8,248.224,278.926,30.701999999999998,518,580,62,chroma_acts_smoothed
64,1,0.0,30.784,30.784,0,65,65,ki_chroma
64,2,30.784,60.06399999999999,29.279999999999994,65,126,61,ki_chroma
64,3,60.06399999999999,61.983999999999995,1.9200000000000017,126,130,4,ki_chroma
64,4,61.983999999999995,139.744,77.76,130,292,162,ki_chroma
64,5,139.744,184.38400000000001,44.640000000000015,292,385,93,ki_chroma
64,6,184.38400000000001,185.824,1.4399999999999977,385,388,3,ki_chroma
64,7,185.824,247.744,61.91999999999999,388,517,129,ki_chroma
64,8,247.744,278.926,31.181999999999988,517,580,63,ki_chroma
64,1,0.0,30.784,30.784,0,65,65,ki_chroma_acts
64,2,30.784,35.104,4.32,65,74,9,ki_chroma_acts
64,3,35.104,60.544,25.439999999999998,74,127,53,ki_chroma_acts
64,4,60.544,139.744,79.2,127,292,165,ki_chroma_acts
64,5,139.744,184.38400000000001,44.640000000000015,292,385,93,ki_chroma_acts
64,6,184.38400000000001,185.824,1.4399999999999977,385,388,3,ki_chroma_acts
64,7,185.824,247.744,61.91999999999999,388,517,129,ki_chroma_acts
64,8,247.744,278.926,31.181999999999988,517,580,63,ki_chroma_acts
64,1,0.0,30.304,30.304,0,64,64,ki_chroma_acts_smoothed
64,2,30.304,35.104,4.800000000000001,64,74,10,ki_chroma_acts_smoothed
64,3,35.104,60.06399999999999,24.959999999999994,74,126,52,ki_chroma_acts_smoothed
64,4,60.06399999999999,139.264,79.20000000000002,126,291,165,ki_chroma_acts_smoothed
64,5,139.264,143.584,4.319999999999993,291,300,9,ki_chroma_acts_smoothed
64,6,143.584,185.824,42.24000000000001,300,388,88,ki_chroma_acts_smoothed
64,7,185.824,248.224,62.39999999999998,388,518,130,ki_chroma_acts_smoothed
64,8,248.224,278.926,30.701999999999998,518,580,62,ki_chroma_acts_smoothed
65,1,0.0,16.11733333333333,16.11733333333333,0,34,34,chromagram
65,2,16.11733333333333,48.757333333333335,32.64,34,102,68,chromagram
65,3,48.757333333333335,108.27733333333333,59.519999999999996,102,226,124,chromagram
65,4,108.27733333333333,118.35733333333333,10.079999999999998,226,247,21,chromagram
65,5,118.35733333333333,133.2373333333333,14.879999999999981,247,278,31,chromagram
65,6,133.2373333333333,136.1173333333333,2.8799999999999955,278,284,6,chromagram
65,7,136.1173333333333,142.35733333333332,6.240000000000009,284,297,13,chromagram
65,8,142.35733333333332,150.5173333333333,8.159999999999997,297,314,17,chromagram
65,9,150.5173333333333,196.5,45.98266666666669,314,408,94,chromagram
65,1,0.0,16.11733333333333,16.11733333333333,0,34,34,chroma_acts
65,2,16.11733333333333,48.757333333333335,32.64,34,102,68,chroma_acts
65,3,48.757333333333335,108.75733333333334,60.0,102,227,125,chroma_acts
65,4,108.75733333333334,116.43733333333333,7.679999999999993,227,243,16,chroma_acts
65,5,116.43733333333333,133.2373333333333,16.799999999999983,243,278,35,chroma_acts
65,6,133.2373333333333,136.59733333333332,3.3600000000000136,278,285,7,chroma_acts
65,7,136.59733333333332,139.9573333333333,3.359999999999985,285,292,7,chroma_acts
65,8,139.9573333333333,150.5173333333333,10.560000000000002,292,314,22,chroma_acts
65,9,150.5173333333333,196.5,45.98266666666669,314,408,94,chroma_acts
65,1,0.0,16.59733333333333,16.59733333333333,0,35,35,chroma_acts_smoothed
65,2,16.59733333333333,48.757333333333335,32.160000000000004,35,102,67,chroma_acts_smoothed
65,3,48.757333333333335,108.27733333333333,59.519999999999996,102,226,124,chroma_acts_smoothed
65,4,108.27733333333333,118.35733333333333,10.079999999999998,226,247,21,chroma_acts_smoothed
65,5,118.35733333333333,133.2373333333333,14.879999999999981,247,278,31,chroma_acts_smoothed
65,6,133.2373333333333,136.1173333333333,2.8799999999999955,278,284,6,chroma_acts_smoothed
65,7,136.1173333333333,139.47733333333332,3.3600000000000136,284,291,7,chroma_acts_smoothed
65,8,139.47733333333332,150.5173333333333,11.039999999999992,291,314,23,chroma_acts_smoothed
65,9,150.5173333333333,196.5,45.98266666666669,314,408,94,chroma_acts_smoothed
65,1,0.0,16.11733333333333,16.11733333333333,0,34,34,ki_chroma
65,2,16.11733333333333,48.757333333333335,32.64,34,102,68,ki_chroma
65,3,48.757333333333335,108.27733333333333,59.519999999999996,102,226,124,ki_chroma
65,4,108.27733333333333,118.35733333333333,10.079999999999998,226,247,21,ki_chroma
65,5,118.35733333333333,133.2373333333333,14.879999999999981,247,278,31,ki_chroma
65,6,133.2373333333333,136.1173333333333,2.8799999999999955,278,284,6,ki_chroma
65,7,136.1173333333333,142.35733333333332,6.240000000000009,284,297,13,ki_chroma
65,8,142.35733333333332,150.5173333333333,8.159999999999997,297,314,17,ki_chroma
65,9,150.5173333333333,196.5,45.98266666666669,314,408,94,ki_chroma
65,1,0.0,16.11733333333333,16.11733333333333,0,34,34,ki_chroma_acts
65,2,16.11733333333333,48.757333333333335,32.64,34,102,68,ki_chroma_acts
65,3,48.757333333333335,108.75733333333334,60.0,102,227,125,ki_chroma_acts
65,4,108.75733333333334,116.43733333333333,7.679999999999993,227,243,16,ki_chroma_acts
65,5,116.43733333333333,133.2373333333333,16.799999999999983,243,278,35,ki_chroma_acts
65,6,133.2373333333333,136.59733333333332,3.3600000000000136,278,285,7,ki_chroma_acts
65,7,136.59733333333332,139.9573333333333,3.359999999999985,285,292,7,ki_chroma_acts
65,8,139.9573333333333,150.5173333333333,10.560000000000002,292,314,22,ki_chroma_acts
65,9,150.5173333333333,196.5,45.98266666666669,314,408,94,ki_chroma_acts
65,1,0.0,16.59733333333333,16.59733333333333,0,35,35,ki_chroma_acts_smoothed
65,2,16.59733333333333,48.757333333333335,32.160000000000004,35,102,67,ki_chroma_acts_smoothed
65,3,48.757333333333335,108.27733333333333,59.519999999999996,102,226,124,ki_chroma_acts_smoothed
65,4,108.27733333333333,118.35733333333333,10.079999999999998,226,247,21,ki_chroma_acts_smoothed
65,5,118.35733333333333,133.2373333333333,14.879999999999981,247,278,31,ki_chroma_acts_smoothed
65,6,133.2373333333333,136.1173333333333,2.8799999999999955,278,284,6,ki_chroma_acts_smoothed
65,7,136.1173333333333,139.47733333333332,3.3600000000000136,284,291,7,ki_chroma_acts_smoothed
65,8,139.47733333333332,150.5173333333333,11.039999999999992,291,314,23,ki_chroma_acts_smoothed
65,9,150.5173333333333,196.5,45.98266666666669,314,408,94,ki_chroma_acts_smoothed
66,1,0.0,28.895999999999997,28.895999999999997,0,61,61,chromagram
66,2,28.895999999999997,46.175999999999995,17.279999999999998,61,97,36,chromagram
66,3,46.175999999999995,56.25599999999999,10.079999999999998,97,118,21,chromagram
66,4,56.25599999999999,59.61599999999999,3.3599999999999994,118,125,7,chromagram
66,5,59.61599999999999,103.296,43.680000000000014,125,216,91,chromagram
66,6,103.296,107.136,3.839999999999989,216,224,8,chromagram
66,7,107.136,138.336,31.200000000000017,224,289,65,chromagram
66,8,138.336,180.576,42.23999999999998,289,377,88,chromagram
66,9,180.576,245.769,65.19300000000001,377,511,134,chromagram
66,1,0.0,28.895999999999997,28.895999999999997,0,61,61,chroma_acts
66,2,28.895999999999997,46.175999999999995,17.279999999999998,61,97,36,chroma_acts
66,3,46.175999999999995,62.495999999999995,16.32,97,131,34,chroma_acts
66,4,62.495999999999995,92.256,29.760000000000005,131,193,62,chroma_acts
66,5,92.256,103.296,11.040000000000006,193,216,23,chroma_acts
66,6,103.296,107.136,3.839999999999989,216,224,8,chroma_acts
66,7,107.136,138.336,31.200000000000017,224,289,65,chroma_acts
66,8,138.336,182.496,44.16,289,381,92,chroma_acts
66,9,182.496,245.769,63.272999999999996,381,511,130,chroma_acts
66,1,0.0,28.895999999999997,28.895999999999997,0,61,61,chroma_acts_smoothed
66,2,28.895999999999997,46.175999999999995,17.279999999999998,61,97,36,chroma_acts_smoothed
66,3,46.175999999999995,59.61599999999999,13.439999999999998,97,125,28,chroma_acts_smoothed
66,4,59.61599999999999,92.256,32.64000000000001,125,193,68,chroma_acts_smoothed
66,5,92.256,102.816,10.560000000000002,193,215,22,chroma_acts_smoothed
66,6,102.816,107.136,4.319999999999993,215,224,9,chroma_acts_smoothed
66,7,107.136,137.856,30.72,224,288,64,chroma_acts_smoothed
66,8,137.856,182.496,44.640000000000015,288,381,93,chroma_acts_smoothed
66,9,182.496,245.769,63.272999999999996,381,511,130,chroma_acts_smoothed
66,1,0.0,28.895999999999997,28.895999999999997,0,61,61,ki_chroma
66,2,28.895999999999997,46.175999999999995,17.279999999999998,61,97,36,ki_chroma
66,3,46.175999999999995,56.25599999999999,10.079999999999998,97,118,21,ki_chroma
66,4,56.25599999999999,59.61599999999999,3.3599999999999994,118,125,7,ki_chroma
66,5,59.61599999999999,103.296,43.680000000000014,125,216,91,ki_chroma
66,6,103.296,107.136,3.839999999999989,216,224,8,ki_chroma
66,7,107.136,138.336,31.200000000000017,224,289,65,ki_chroma
66,8,138.336,180.576,42.23999999999998,289,377,88,ki_chroma
66,9,180.576,245.769,65.19300000000001,377,511,134,ki_chroma
66,1,0.0,28.895999999999997,28.895999999999997,0,61,61,ki_chroma_acts
66,2,28.895999999999997,46.175999999999995,17.279999999999998,61,97,36,ki_chroma_acts
66,3,46.175999999999995,62.495999999999995,16.32,97,131,34,ki_chroma_acts
66,4,62.495999999999995,92.256,29.760000000000005,131,193,62,ki_chroma_acts
66,5,92.256,103.296,11.040000000000006,193,216,23,ki_chroma_acts
66,6,103.296,107.136,3.839999999999989,216,224,8,ki_chroma_acts
66,7,107.136,138.336,31.200000000000017,224,289,65,ki_chroma_acts
66,8,138.336,182.496,44.16,289,381,92,ki_chroma_acts
66,9,182.496,245.769,63.272999999999996,381,511,130,ki_chroma_acts
66,1,0.0,28.895999999999997,28.895999999999997,0,61,61,ki_chroma_acts_smoothed
66,2,28.895999999999997,46.175999999999995,17.279999999999998,61,97,36,ki_chroma_acts_smoothed
66,3,46.175999999999995,59.61599999999999,13.439999999999998,97,125,28,ki_chroma_acts_smoothed
66,4,59.61599999999999,92.256,32.64000000000001,125,193,68,ki_chroma_acts_smoothed
66,5,92.256,102.816,10.560000000000002,193,215,22,ki_chroma_acts_smoothed
66,6,102.816,107.136,4.319999999999993,215,224,9,ki_chroma_acts_smoothed
66,7,107.136,137.856,30.72,224,288,64,ki_chroma_acts_smoothed
66,8,137.856,182.496,44.640000000000015,288,381,93,ki_chroma_acts_smoothed
66,9,182.496,245.769,63.272999999999996,381,511,130,ki_chroma_acts_smoothed
67,1,0.0,181.03466666666665,181.03466666666665,0,378,378,chromagram
67,2,181.03466666666665,183.43466666666666,2.4000000000000057,378,383,5,chromagram
67,3,183.43466666666666,199.75466666666665,16.319999999999993,383,417,34,chromagram
67,4,199.75466666666665,245.83466666666666,46.08000000000001,417,513,96,chromagram
67,5,245.83466666666666,255.43466666666666,9.599999999999994,513,533,20,chromagram
67,6,255.43466666666666,288.07466666666664,32.639999999999986,533,601,68,chromagram
67,7,288.07466666666664,291.43466666666666,3.3600000000000136,601,608,7,chromagram
67,8,291.43466666666666,358.856,67.42133333333334,608,747,139,chromagram
67,1,0.0,183.43466666666666,183.43466666666666,0,383,383,chroma_acts
67,2,183.43466666666666,199.75466666666665,16.319999999999993,383,417,34,chroma_acts
67,3,199.75466666666665,245.83466666666666,46.08000000000001,417,513,96,chroma_acts
67,4,245.83466666666666,261.19466666666665,15.359999999999985,513,545,32,chroma_acts
67,5,261.19466666666665,288.07466666666664,26.879999999999995,545,601,56,chroma_acts
67,6,288.07466666666664,291.43466666666666,3.3600000000000136,601,608,7,chroma_acts
67,7,291.43466666666666,322.63466666666665,31.19999999999999,608,673,65,chroma_acts
67,8,322.63466666666665,358.856,36.22133333333335,673,747,74,chroma_acts
67,1,0.0,183.91466666666665,183.91466666666665,0,384,384,chroma_acts_smoothed
67,2,183.91466666666665,199.75466666666665,15.840000000000003,384,417,33,chroma_acts_smoothed
67,3,199.75466666666665,245.83466666666666,46.08000000000001,417,513,96,chroma_acts_smoothed
67,4,245.83466666666666,261.19466666666665,15.359999999999985,513,545,32,chroma_acts_smoothed
67,5,261.19466666666665,288.07466666666664,26.879999999999995,545,601,56,chroma_acts_smoothed
67,6,288.07466666666664,291.9146666666667,3.840000000000032,601,609,8,chroma_acts_smoothed
67,7,291.9146666666667,322.63466666666665,30.71999999999997,609,673,64,chroma_acts_smoothed
67,8,322.63466666666665,358.856,36.22133333333335,673,747,74,chroma_acts_smoothed
67,1,0.0,181.03466666666665,181.03466666666665,0,378,378,ki_chroma
67,2,181.03466666666665,183.43466666666666,2.4000000000000057,378,383,5,ki_chroma
67,3,183.43466666666666,199.75466666666665,16.319999999999993,383,417,34,ki_chroma
67,4,199.75466666666665,245.83466666666666,46.08000000000001,417,513,96,ki_chroma
67,5,245.83466666666666,255.43466666666666,9.599999999999994,513,533,20,ki_chroma
67,6,255.43466666666666,288.07466666666664,32.639999999999986,533,601,68,ki_chroma
67,7,288.07466666666664,291.43466666666666,3.3600000000000136,601,608,7,ki_chroma
67,8,291.43466666666666,358.856,67.42133333333334,608,747,139,ki_chroma
67,1,0.0,183.43466666666666,183.43466666666666,0,383,383,ki_chroma_acts
67,2,183.43466666666666,199.75466666666665,16.319999999999993,383,417,34,ki_chroma_acts
67,3,199.75466666666665,245.83466666666666,46.08000000000001,417,513,96,ki_chroma_acts
67,4,245.83466666666666,261.19466666666665,15.359999999999985,513,545,32,ki_chroma_acts
67,5,261.19466666666665,288.07466666666664,26.879999999999995,545,601,56,ki_chroma_acts
67,6,288.07466666666664,291.43466666666666,3.3600000000000136,601,608,7,ki_chroma_acts
67,7,291.43466666666666,322.63466666666665,31.19999999999999,608,673,65,ki_chroma_acts
67,8,322.63466666666665,358.856,36.22133333333335,673,747,74,ki_chroma_acts
67,1,0.0,183.91466666666665,183.91466666666665,0,384,384,ki_chroma_acts_smoothed
67,2,183.91466666666665,199.75466666666665,15.840000000000003,384,417,33,ki_chroma_acts_smoothed
67,3,199.75466666666665,245.83466666666666,46.08000000000001,417,513,96,ki_chroma_acts_smoothed
67,4,245.83466666666666,261.19466666666665,15.359999999999985,513,545,32,ki_chroma_acts_smoothed
67,5,261.19466666666665,288.07466666666664,26.879999999999995,545,601,56,ki_chroma_acts_smoothed
67,6,288.07466666666664,291.9146666666667,3.840000000000032,601,609,8,ki_chroma_acts_smoothed
67,7,291.9146666666667,322.63466666666665,30.71999999999997,609,673,64,ki_chroma_acts_smoothed
67,8,322.63466666666665,358.856,36.22133333333335,673,747,74,ki_chroma_acts_smoothed
68,1,0.0,4.2986666666666675,4.2986666666666675,0,8,8,chromagram
68,2,4.2986666666666675,54.47466666666667,50.176,8,92,84,chromagram
68,3,54.47466666666667,76.57600000000001,22.101333333333336,92,129,37,chromagram
68,4,76.57600000000001,108.23466666666668,31.658666666666676,129,182,53,chromagram
68,5,108.23466666666668,147.06133333333335,38.82666666666667,182,247,65,chromagram
68,6,147.06133333333335,154.82666666666668,7.765333333333331,247,260,13,chromagram
68,7,154.82666666666668,166.17600000000002,11.349333333333334,260,279,19,chromagram
68,8,166.17600000000002,181.70666666666668,15.530666666666662,279,305,26,chromagram
68,9,181.70666666666668,219.967,38.260333333333335,305,368,63,chromagram
68,1,0.0,4.2986666666666675,4.2986666666666675,0,8,8,chroma_acts
68,2,4.2986666666666675,54.47466666666667,50.176,8,92,84,chroma_acts
68,3,54.47466666666667,76.57600000000001,22.101333333333336,92,129,37,chroma_acts
68,4,76.57600000000001,147.06133333333335,70.48533333333334,129,247,118,chroma_acts
68,5,147.06133333333335,154.82666666666668,7.765333333333331,247,260,13,chroma_acts
68,6,154.82666666666668,162.592,7.765333333333331,260,273,13,chroma_acts
68,7,162.592,166.17600000000002,3.584000000000003,273,279,6,chroma_acts
68,8,166.17600000000002,181.70666666666668,15.530666666666662,279,305,26,chroma_acts
68,9,181.70666666666668,219.967,38.260333333333335,305,368,63,chroma_acts
68,1,0.0,4.2986666666666675,4.2986666666666675,0,8,8,chroma_acts_smoothed
68,2,4.2986666666666675,54.47466666666667,50.176,8,92,84,chroma_acts_smoothed
68,3,54.47466666666667,62.24000000000001,7.765333333333338,92,105,13,chroma_acts_smoothed
68,4,62.24000000000001,76.57600000000001,14.335999999999999,105,129,24,chroma_acts_smoothed
68,5,76.57600000000001,108.23466666666668,31.658666666666676,129,182,53,chroma_acts_smoothed
68,6,108.23466666666668,147.06133333333335,38.82666666666667,182,247,65,chroma_acts_smoothed
68,7,147.06133333333335,154.22933333333336,7.168000000000006,247,259,12,chroma_acts_smoothed
68,8,154.22933333333336,181.70666666666668,27.47733333333332,259,305,46,chroma_acts_smoothed
68,9,181.70666666666668,219.967,38.260333333333335,305,368,63,chroma_acts_smoothed
68,1,0.0,4.2986666666666675,4.2986666666666675,0,8,8,ki_chroma
68,2,4.2986666666666675,54.47466666666667,50.176,8,92,84,ki_chroma
68,3,54.47466666666667,76.57600000000001,22.101333333333336,92,129,37,ki_chroma
68,4,76.57600000000001,108.23466666666668,31.658666666666676,129,182,53,ki_chroma
68,5,108.23466666666668,147.06133333333335,38.82666666666667,182,247,65,ki_chroma
68,6,147.06133333333335,154.82666666666668,7.765333333333331,247,260,13,ki_chroma
68,7,154.82666666666668,166.17600000000002,11.349333333333334,260,279,19,ki_chroma
68,8,166.17600000000002,181.70666666666668,15.530666666666662,279,305,26,ki_chroma
68,9,181.70666666666668,219.967,38.260333333333335,305,368,63,ki_chroma
68,1,0.0,4.2986666666666675,4.2986666666666675,0,8,8,ki_chroma_acts
68,2,4.2986666666666675,54.47466666666667,50.176,8,92,84,ki_chroma_acts
68,3,54.47466666666667,76.57600000000001,22.101333333333336,92,129,37,ki_chroma_acts
68,4,76.57600000000001,147.06133333333335,70.48533333333334,129,247,118,ki_chroma_acts
68,5,147.06133333333335,154.82666666666668,7.765333333333331,247,260,13,ki_chroma_acts
68,6,154.82666666666668,162.592,7.765333333333331,260,273,13,ki_chroma_acts
68,7,162.592,166.17600000000002,3.584000000000003,273,279,6,ki_chroma_acts
68,8,166.17600000000002,181.70666666666668,15.530666666666662,279,305,26,ki_chroma_acts
68,9,181.70666666666668,219.967,38.260333333333335,305,368,63,ki_chroma_acts
68,1,0.0,4.2986666666666675,4.2986666666666675,0,8,8,ki_chroma_acts_smoothed
68,2,4.2986666666666675,54.47466666666667,50.176,8,92,84,ki_chroma_acts_smoothed
68,3,54.47466666666667,62.24000000000001,7.765333333333338,92,105,13,ki_chroma_acts_smoothed
68,4,62.24000000000001,76.57600000000001,14.335999999999999,105,129,24,ki_chroma_acts_smoothed
68,5,76.57600000000001,108.23466666666668,31.658666666666676,129,182,53,ki_chroma_acts_smoothed
68,6,108.23466666666668,147.06133333333335,38.82666666666667,182,247,65,ki_chroma_acts_smoothed
68,7,147.06133333333335,154.22933333333336,7.168000000000006,247,259,12,ki_chroma_acts_smoothed
68,8,154.22933333333336,181.70666666666668,27.47733333333332,259,305,46,ki_chroma_acts_smoothed
68,9,181.70666666666668,219.967,38.260333333333335,305,368,63,ki_chroma_acts_smoothed
69,1,0.0,17.461333333333332,17.461333333333332,0,37,37,chromagram
69,2,17.461333333333332,26.581333333333333,9.120000000000001,37,56,19,chromagram
69,3,26.581333333333333,31.38133333333333,4.799999999999997,56,66,10,chromagram
69,4,31.38133333333333,64.02133333333333,32.64,66,134,68,chromagram
69,5,64.02133333333333,79.38133333333333,15.36,134,166,32,chromagram
69,6,79.38133333333333,112.02133333333333,32.64,166,234,68,chromagram
69,7,112.02133333333333,156.18133333333333,44.16,234,326,92,chromagram
69,8,156.18133333333333,162.90133333333333,6.719999999999999,326,340,14,chromagram
69,9,162.90133333333333,205.043,42.14166666666668,340,426,86,chromagram
69,1,0.0,17.461333333333332,17.461333333333332,0,37,37,chroma_acts
69,2,17.461333333333332,26.101333333333333,8.64,37,55,18,chroma_acts
69,3,26.101333333333333,34.74133333333334,8.640000000000004,55,73,18,chroma_acts
69,4,34.74133333333334,64.02133333333333,29.279999999999994,73,134,61,chroma_acts
69,5,64.02133333333333,80.82133333333333,16.799999999999997,134,169,35,chroma_acts
69,6,80.82133333333333,111.06133333333332,30.239999999999995,169,232,63,chroma_acts
69,7,111.06133333333332,156.18133333333333,45.120000000000005,232,326,94,chroma_acts
69,8,156.18133333333333,164.82133333333334,8.640000000000015,326,344,18,chroma_acts
69,9,164.82133333333334,205.043,40.221666666666664,344,426,82,chroma_acts
69,1,0.0,17.461333333333332,17.461333333333332,0,37,37,chroma_acts_smoothed
69,2,17.461333333333332,26.101333333333333,8.64,37,55,18,chroma_acts_smoothed
69,3,26.101333333333333,31.86133333333333,5.759999999999998,55,67,12,chroma_acts_smoothed
69,4,31.86133333333333,64.02133333333333,32.16,67,134,67,chroma_acts_smoothed
69,5,64.02133333333333,81.30133333333333,17.28,134,170,36,chroma_acts_smoothed
69,6,81.30133333333333,110.10133333333333,28.799999999999997,170,230,60,chroma_acts_smoothed
69,7,110.10133333333333,156.18133333333333,46.08,230,326,96,chroma_acts_smoothed
69,8,156.18133333333333,166.26133333333334,10.080000000000013,326,347,21,chroma_acts_smoothed
69,9,166.26133333333334,205.043,38.781666666666666,347,426,79,chroma_acts_smoothed
69,1,0.0,17.461333333333332,17.461333333333332,0,37,37,ki_chroma
69,2,17.461333333333332,26.581333333333333,9.120000000000001,37,56,19,ki_chroma
69,3,26.581333333333333,31.38133333333333,4.799999999999997,56,66,10,ki_chroma
69,4,31.38133333333333,64.02133333333333,32.64,66,134,68,ki_chroma
69,5,64.02133333333333,79.38133333333333,15.36,134,166,32,ki_chroma
69,6,79.38133333333333,112.02133333333333,32.64,166,234,68,ki_chroma
69,7,112.02133333333333,156.18133333333333,44.16,234,326,92,ki_chroma
69,8,156.18133333333333,162.90133333333333,6.719999999999999,326,340,14,ki_chroma
69,9,162.90133333333333,205.043,42.14166666666668,340,426,86,ki_chroma
69,1,0.0,17.461333333333332,17.461333333333332,0,37,37,ki_chroma_acts
69,2,17.461333333333332,26.101333333333333,8.64,37,55,18,ki_chroma_acts
69,3,26.101333333333333,34.74133333333334,8.640000000000004,55,73,18,ki_chroma_acts
69,4,34.74133333333334,64.02133333333333,29.279999999999994,73,134,61,ki_chroma_acts
69,5,64.02133333333333,80.82133333333333,16.799999999999997,134,169,35,ki_chroma_acts
69,6,80.82133333333333,111.06133333333332,30.239999999999995,169,232,63,ki_chroma_acts
69,7,111.06133333333332,156.18133333333333,45.120000000000005,232,326,94,ki_chroma_acts
69,8,156.18133333333333,164.82133333333334,8.640000000000015,326,344,18,ki_chroma_acts
69,9,164.82133333333334,205.043,40.221666666666664,344,426,82,ki_chroma_acts
69,1,0.0,17.461333333333332,17.461333333333332,0,37,37,ki_chroma_acts_smoothed
69,2,17.461333333333332,26.101333333333333,8.64,37,55,18,ki_chroma_acts_smoothed
69,3,26.101333333333333,31.86133333333333,5.759999999999998,55,67,12,ki_chroma_acts_smoothed
69,4,31.86133333333333,64.02133333333333,32.16,67,134,67,ki_chroma_acts_smoothed
69,5,64.02133333333333,81.30133333333333,17.28,134,170,36,ki_chroma_acts_smoothed
69,6,81.30133333333333,110.10133333333333,28.799999999999997,170,230,60,ki_chroma_acts_smoothed
69,7,110.10133333333333,156.18133333333333,46.08,230,326,96,ki_chroma_acts_smoothed
69,8,156.18133333333333,166.26133333333334,10.080000000000013,326,347,21,ki_chroma_acts_smoothed
69,9,166.26133333333334,205.043,38.781666666666666,347,426,79,ki_chroma_acts_smoothed
70,1,0.0,9.525333333333334,9.525333333333334,0,20,20,chromagram
70,2,9.525333333333334,13.365333333333334,3.84,20,28,8,chromagram
70,3,13.365333333333334,30.165333333333333,16.799999999999997,28,63,35,chromagram
70,4,30.165333333333333,58.965333333333334,28.8,63,123,60,chromagram
70,5,58.965333333333334,75.76533333333333,16.799999999999997,123,158,35,chromagram
70,6,75.76533333333333,106.96533333333332,31.19999999999999,158,223,65,chromagram
70,7,106.96533333333332,121.84533333333333,14.88000000000001,223,254,31,chromagram
70,8,121.84533333333333,136.72533333333334,14.88000000000001,254,285,31,chromagram
70,9,136.72533333333334,183.397,46.67166666666665,285,381,96,chromagram
70,1,0.0,5.685333333333333,5.685333333333333,0,12,12,chroma_acts
70,2,5.685333333333333,30.165333333333333,24.48,12,63,51,chroma_acts
70,3,30.165333333333333,58.965333333333334,28.8,63,123,60,chroma_acts
70,4,58.965333333333334,75.76533333333333,16.799999999999997,123,158,35,chroma_acts
70,5,75.76533333333333,106.48533333333333,30.72,158,222,64,chroma_acts
70,6,106.48533333333333,121.84533333333333,15.36,222,254,32,chroma_acts
70,7,121.84533333333333,138.64533333333333,16.799999999999997,254,289,35,chroma_acts
70,8,138.64533333333333,183.397,44.751666666666665,289,381,92,chroma_acts
70,1,0.0,5.685333333333333,5.685333333333333,0,12,12,chroma_acts_smoothed
70,2,5.685333333333333,30.165333333333333,24.48,12,63,51,chroma_acts_smoothed
70,3,30.165333333333333,61.36533333333333,31.2,63,128,65,chroma_acts_smoothed
70,4,61.36533333333333,75.76533333333333,14.399999999999999,128,158,30,chroma_acts_smoothed
70,5,75.76533333333333,106.48533333333333,30.72,158,222,64,chroma_acts_smoothed
70,6,106.48533333333333,121.84533333333333,15.36,222,254,32,chroma_acts_smoothed
70,7,121.84533333333333,137.20533333333333,15.36,254,286,32,chroma_acts_smoothed
70,8,137.20533333333333,183.397,46.19166666666666,286,381,95,chroma_acts_smoothed
70,1,0.0,9.525333333333334,9.525333333333334,0,20,20,ki_chroma
70,2,9.525333333333334,13.365333333333334,3.84,20,28,8,ki_chroma
70,3,13.365333333333334,30.165333333333333,16.799999999999997,28,63,35,ki_chroma
70,4,30.165333333333333,58.965333333333334,28.8,63,123,60,ki_chroma
70,5,58.965333333333334,75.76533333333333,16.799999999999997,123,158,35,ki_chroma
70,6,75.76533333333333,106.96533333333332,31.19999999999999,158,223,65,ki_chroma
70,7,106.96533333333332,121.84533333333333,14.88000000000001,223,254,31,ki_chroma
70,8,121.84533333333333,136.72533333333334,14.88000000000001,254,285,31,ki_chroma
70,9,136.72533333333334,183.397,46.67166666666665,285,381,96,ki_chroma
70,1,0.0,5.685333333333333,5.685333333333333,0,12,12,ki_chroma_acts
70,2,5.685333333333333,30.165333333333333,24.48,12,63,51,ki_chroma_acts
70,3,30.165333333333333,58.965333333333334,28.8,63,123,60,ki_chroma_acts
70,4,58.965333333333334,75.76533333333333,16.799999999999997,123,158,35,ki_chroma_acts
70,5,75.76533333333333,106.48533333333333,30.72,158,222,64,ki_chroma_acts
70,6,106.48533333333333,121.84533333333333,15.36,222,254,32,ki_chroma_acts
70,7,121.84533333333333,138.64533333333333,16.799999999999997,254,289,35,ki_chroma_acts
70,8,138.64533333333333,183.397,44.751666666666665,289,381,92,ki_chroma_acts
70,1,0.0,5.685333333333333,5.685333333333333,0,12,12,ki_chroma_acts_smoothed
70,2,5.685333333333333,30.165333333333333,24.48,12,63,51,ki_chroma_acts_smoothed
70,3,30.165333333333333,61.36533333333333,31.2,63,128,65,ki_chroma_acts_smoothed
70,4,61.36533333333333,75.76533333333333,14.399999999999999,128,158,30,ki_chroma_acts_smoothed
70,5,75.76533333333333,106.48533333333333,30.72,158,222,64,ki_chroma_acts_smoothed
70,6,106.48533333333333,121.84533333333333,15.36,222,254,32,ki_chroma_acts_smoothed
70,7,121.84533333333333,137.20533333333333,15.36,254,286,32,ki_chroma_acts_smoothed
70,8,137.20533333333333,183.397,46.19166666666666,286,381,95,ki_chroma_acts_smoothed
71,1,0.0,8.768,8.768,0,19,19,chromagram
71,2,8.768,51.488,42.72,19,108,89,chromagram
71,3,51.488,60.128,8.64,108,126,18,chromagram
71,4,60.128,122.52799999999999,62.39999999999999,126,256,130,chromagram
71,5,122.52799999999999,130.688,8.159999999999997,256,273,17,chromagram
71,6,130.688,134.528,3.8400000000000034,273,281,8,chromagram
71,7,134.528,154.208,19.680000000000007,281,322,41,chromagram
71,8,154.208,215.648,61.44,322,450,128,chromagram
71,9,215.648,264.996,49.347999999999985,450,551,101,chromagram
71,1,0.0,8.768,8.768,0,19,19,chroma_acts
71,2,8.768,51.488,42.72,19,108,89,chroma_acts
71,3,51.488,60.128,8.64,108,126,18,chroma_acts
71,4,60.128,122.52799999999999,62.39999999999999,126,256,130,chroma_acts
71,5,122.52799999999999,130.688,8.159999999999997,256,273,17,chroma_acts
71,6,130.688,134.528,3.8400000000000034,273,281,8,chroma_acts
71,7,134.528,154.208,19.680000000000007,281,322,41,chroma_acts
71,8,154.208,215.648,61.44,322,450,128,chroma_acts
71,9,215.648,264.996,49.347999999999985,450,551,101,chroma_acts
71,1,0.0,9.248000000000001,9.248000000000001,0,20,20,chroma_acts_smoothed
71,2,9.248000000000001,51.007999999999996,41.75999999999999,20,107,87,chroma_acts_smoothed
71,3,51.007999999999996,59.647999999999996,8.64,107,125,18,chroma_acts_smoothed
71,4,59.647999999999996,122.52799999999999,62.879999999999995,125,256,131,chroma_acts_smoothed
71,5,122.52799999999999,130.688,8.159999999999997,256,273,17,chroma_acts_smoothed
71,6,130.688,134.528,3.8400000000000034,273,281,8,chroma_acts_smoothed
71,7,134.528,153.728,19.200000000000017,281,321,40,chroma_acts_smoothed
71,8,153.728,215.648,61.91999999999999,321,450,129,chroma_acts_smoothed
71,9,215.648,264.996,49.347999999999985,450,551,101,chroma_acts_smoothed
71,1,0.0,8.768,8.768,0,19,19,ki_chroma
71,2,8.768,51.488,42.72,19,108,89,ki_chroma
71,3,51.488,60.128,8.64,108,126,18,ki_chroma
71,4,60.128,122.52799999999999,62.39999999999999,126,256,130,ki_chroma
71,5,122.52799999999999,130.688,8.159999999999997,256,273,17,ki_chroma
71,6,130.688,134.528,3.8400000000000034,273,281,8,ki_chroma
71,7,134.528,154.208,19.680000000000007,281,322,41,ki_chroma
71,8,154.208,215.648,61.44,322,450,128,ki_chroma
71,9,215.648,264.996,49.347999999999985,450,551,101,ki_chroma
71,1,0.0,8.768,8.768,0,19,19,ki_chroma_acts
71,2,8.768,51.488,42.72,19,108,89,ki_chroma_acts
71,3,51.488,60.128,8.64,108,126,18,ki_chroma_acts
71,4,60.128,122.52799999999999,62.39999999999999,126,256,130,ki_chroma_acts
71,5,122.52799999999999,130.688,8.159999999999997,256,273,17,ki_chroma_acts
71,6,130.688,134.528,3.8400000000000034,273,281,8,ki_chroma_acts
71,7,134.528,154.208,19.680000000000007,281,322,41,ki_chroma_acts
71,8,154.208,215.648,61.44,322,450,128,ki_chroma_acts
71,9,215.648,264.996,49.347999999999985,450,551,101,ki_chroma_acts
71,1,0.0,9.248000000000001,9.248000000000001,0,20,20,ki_chroma_acts_smoothed
71,2,9.248000000000001,51.007999999999996,41.75999999999999,20,107,87,ki_chroma_acts_smoothed
71,3,51.007999999999996,59.647999999999996,8.64,107,125,18,ki_chroma_acts_smoothed
71,4,59.647999999999996,122.52799999999999,62.879999999999995,125,256,131,ki_chroma_acts_smoothed
71,5,122.52799999999999,130.688,8.159999999999997,256,273,17,ki_chroma_acts_smoothed
71,6,130.688,134.528,3.8400000000000034,273,281,8,ki_chroma_acts_smoothed
71,7,134.528,153.728,19.200000000000017,281,321,40,ki_chroma_acts_smoothed
71,8,153.728,215.648,61.91999999999999,321,450,129,ki_chroma_acts_smoothed
71,9,215.648,264.996,49.347999999999985,450,551,101,ki_chroma_acts_smoothed
72,1,0.0,7.018666666666666,7.018666666666666,0,15,15,chromagram
72,2,7.018666666666666,37.73866666666667,30.72,15,79,64,chromagram
72,3,37.73866666666667,45.41866666666667,7.68,79,95,16,chromagram
72,4,45.41866666666667,51.178666666666665,5.759999999999998,95,107,12,chromagram
72,5,51.178666666666665,83.33866666666665,32.15999999999999,107,174,67,chromagram
72,6,83.33866666666665,114.05866666666665,30.72,174,238,64,chromagram
72,7,114.05866666666665,129.41866666666667,15.360000000000014,238,270,32,chromagram
72,8,129.41866666666667,167.33866666666665,37.91999999999999,270,349,79,chromagram
72,9,167.33866666666665,175.856,8.51733333333334,349,365,16,chromagram
72,1,0.0,7.018666666666666,7.018666666666666,0,15,15,chroma_acts
72,2,7.018666666666666,37.73866666666667,30.72,15,79,64,chroma_acts
72,3,37.73866666666667,45.41866666666667,7.68,79,95,16,chroma_acts
72,4,45.41866666666667,51.178666666666665,5.759999999999998,95,107,12,chroma_acts
72,5,51.178666666666665,83.33866666666665,32.15999999999999,107,174,67,chroma_acts
72,6,83.33866666666665,114.05866666666665,30.72,174,238,64,chroma_acts
72,7,114.05866666666665,129.41866666666667,15.360000000000014,238,270,32,chroma_acts
72,8,129.41866666666667,167.33866666666665,37.91999999999999,270,349,79,chroma_acts
72,9,167.33866666666665,175.856,8.51733333333334,349,365,16,chroma_acts
72,1,0.0,7.018666666666666,7.018666666666666,0,15,15,chroma_acts_smoothed
72,2,7.018666666666666,37.73866666666667,30.72,15,79,64,chroma_acts_smoothed
72,3,37.73866666666667,45.41866666666667,7.68,79,95,16,chroma_acts_smoothed
72,4,45.41866666666667,51.178666666666665,5.759999999999998,95,107,12,chroma_acts_smoothed
72,5,51.178666666666665,83.33866666666665,32.15999999999999,107,174,67,chroma_acts_smoothed
72,6,83.33866666666665,114.05866666666665,30.72,174,238,64,chroma_acts_smoothed
72,7,114.05866666666665,129.41866666666667,15.360000000000014,238,270,32,chroma_acts_smoothed
72,8,129.41866666666667,167.33866666666665,37.91999999999999,270,349,79,chroma_acts_smoothed
72,9,167.33866666666665,175.856,8.51733333333334,349,365,16,chroma_acts_smoothed
72,1,0.0,7.018666666666666,7.018666666666666,0,15,15,ki_chroma
72,2,7.018666666666666,37.73866666666667,30.72,15,79,64,ki_chroma
72,3,37.73866666666667,45.41866666666667,7.68,79,95,16,ki_chroma
72,4,45.41866666666667,51.178666666666665,5.759999999999998,95,107,12,ki_chroma
72,5,51.178666666666665,83.33866666666665,32.15999999999999,107,174,67,ki_chroma
72,6,83.33866666666665,114.05866666666665,30.72,174,238,64,ki_chroma
72,7,114.05866666666665,129.41866666666667,15.360000000000014,238,270,32,ki_chroma
72,8,129.41866666666667,167.33866666666665,37.91999999999999,270,349,79,ki_chroma
72,9,167.33866666666665,175.856,8.51733333333334,349,365,16,ki_chroma
72,1,0.0,7.018666666666666,7.018666666666666,0,15,15,ki_chroma_acts
72,2,7.018666666666666,37.73866666666667,30.72,15,79,64,ki_chroma_acts
72,3,37.73866666666667,45.41866666666667,7.68,79,95,16,ki_chroma_acts
72,4,45.41866666666667,51.178666666666665,5.759999999999998,95,107,12,ki_chroma_acts
72,5,51.178666666666665,83.33866666666665,32.15999999999999,107,174,67,ki_chroma_acts
72,6,83.33866666666665,114.05866666666665,30.72,174,238,64,ki_chroma_acts
72,7,114.05866666666665,129.41866666666667,15.360000000000014,238,270,32,ki_chroma_acts
72,8,129.41866666666667,167.33866666666665,37.91999999999999,270,349,79,ki_chroma_acts
72,9,167.33866666666665,175.856,8.51733333333334,349,365,16,ki_chroma_acts
72,1,0.0,7.018666666666666,7.018666666666666,0,15,15,ki_chroma_acts_smoothed
72,2,7.018666666666666,37.73866666666667,30.72,15,79,64,ki_chroma_acts_smoothed
72,3,37.73866666666667,45.41866666666667,7.68,79,95,16,ki_chroma_acts_smoothed
72,4,45.41866666666667,51.178666666666665,5.759999999999998,95,107,12,ki_chroma_acts_smoothed
72,5,51.178666666666665,83.33866666666665,32.15999999999999,107,174,67,ki_chroma_acts_smoothed
72,6,83.33866666666665,114.05866666666665,30.72,174,238,64,ki_chroma_acts_smoothed
72,7,114.05866666666665,129.41866666666667,15.360000000000014,238,270,32,ki_chroma_acts_smoothed
72,8,129.41866666666667,167.33866666666665,37.91999999999999,270,349,79,ki_chroma_acts_smoothed
72,9,167.33866666666665,175.856,8.51733333333334,349,365,16,ki_chroma_acts_smoothed
73,1,0.0,15.424,15.424,0,33,33,chromagram
73,2,15.424,44.70399999999999,29.279999999999994,33,94,61,chromagram
73,3,44.70399999999999,48.544,3.8400000000000034,94,102,8,chromagram
73,4,48.544,52.38399999999999,3.8399999999999963,102,110,8,chromagram
73,5,52.38399999999999,56.224,3.8400000000000034,110,118,8,chromagram
73,6,56.224,123.904,67.68,118,259,141,chromagram
73,7,123.904,139.264,15.360000000000014,259,291,32,chromagram
73,8,139.264,185.824,46.56,291,388,97,chromagram
73,9,185.824,263.263,77.43899999999996,388,548,160,chromagram
73,1,0.0,15.424,15.424,0,33,33,chroma_acts
73,2,15.424,61.983999999999995,46.559999999999995,33,130,97,chroma_acts
73,3,61.983999999999995,123.904,61.92,130,259,129,chroma_acts
73,4,123.904,168.544,44.640000000000015,259,352,93,chroma_acts
73,5,168.544,172.38400000000001,3.8400000000000034,352,360,8,chroma_acts
73,6,172.38400000000001,176.704,4.319999999999993,360,369,9,chroma_acts
73,7,176.704,180.064,3.359999999999985,369,376,7,chroma_acts
73,8,180.064,185.824,5.760000000000019,376,388,12,chroma_acts
73,9,185.824,263.263,77.43899999999996,388,548,160,chroma_acts
73,1,0.0,13.984,13.984,0,30,30,chroma_acts_smoothed
73,2,13.984,17.824,3.8400000000000016,30,38,8,chroma_acts_smoothed
73,3,17.824,21.663999999999998,3.8399999999999963,38,46,8,chroma_acts_smoothed
73,4,21.663999999999998,25.504,3.8400000000000034,46,54,8,chroma_acts_smoothed
73,5,25.504,61.983999999999995,36.47999999999999,54,130,76,chroma_acts_smoothed
73,6,61.983999999999995,123.904,61.92,130,259,129,chroma_acts_smoothed
73,7,123.904,141.66400000000002,17.76000000000002,259,296,37,chroma_acts_smoothed
73,8,141.66400000000002,185.824,44.16,296,388,92,chroma_acts_smoothed
73,9,185.824,263.263,77.43899999999996,388,548,160,chroma_acts_smoothed
73,1,0.0,15.424,15.424,0,33,33,ki_chroma
73,2,15.424,44.70399999999999,29.279999999999994,33,94,61,ki_chroma
73,3,44.70399999999999,48.544,3.8400000000000034,94,102,8,ki_chroma
73,4,48.544,52.38399999999999,3.8399999999999963,102,110,8,ki_chroma
73,5,52.38399999999999,56.224,3.8400000000000034,110,118,8,ki_chroma
73,6,56.224,123.904,67.68,118,259,141,ki_chroma
73,7,123.904,139.264,15.360000000000014,259,291,32,ki_chroma
73,8,139.264,185.824,46.56,291,388,97,ki_chroma
73,9,185.824,263.263,77.43899999999996,388,548,160,ki_chroma
73,1,0.0,15.424,15.424,0,33,33,ki_chroma_acts
73,2,15.424,61.983999999999995,46.559999999999995,33,130,97,ki_chroma_acts
73,3,61.983999999999995,123.904,61.92,130,259,129,ki_chroma_acts
73,4,123.904,168.544,44.640000000000015,259,352,93,ki_chroma_acts
73,5,168.544,172.38400000000001,3.8400000000000034,352,360,8,ki_chroma_acts
73,6,172.38400000000001,176.704,4.319999999999993,360,369,9,ki_chroma_acts
73,7,176.704,180.064,3.359999999999985,369,376,7,ki_chroma_acts
73,8,180.064,185.824,5.760000000000019,376,388,12,ki_chroma_acts
73,9,185.824,263.263,77.43899999999996,388,548,160,ki_chroma_acts
73,1,0.0,13.984,13.984,0,30,30,ki_chroma_acts_smoothed
73,2,13.984,17.824,3.8400000000000016,30,38,8,ki_chroma_acts_smoothed
73,3,17.824,21.663999999999998,3.8399999999999963,38,46,8,ki_chroma_acts_smoothed
73,4,21.663999999999998,25.504,3.8400000000000034,46,54,8,ki_chroma_acts_smoothed
73,5,25.504,61.983999999999995,36.47999999999999,54,130,76,ki_chroma_acts_smoothed
73,6,61.983999999999995,123.904,61.92,130,259,129,ki_chroma_acts_smoothed
73,7,123.904,141.66400000000002,17.76000000000002,259,296,37,ki_chroma_acts_smoothed
73,8,141.66400000000002,185.824,44.16,296,388,92,ki_chroma_acts_smoothed
73,9,185.824,263.263,77.43899999999996,388,548,160,ki_chroma_acts_smoothed
75,1,0.0,12.277333333333333,12.277333333333333,0,27,27,chromagram
75,2,12.277333333333333,30.112,17.834666666666664,27,65,38,chromagram
75,3,30.112,59.21066666666666,29.098666666666663,65,127,62,chromagram
75,4,59.21066666666666,89.71733333333333,30.506666666666668,127,192,65,chromagram
75,5,89.71733333333333,119.75466666666667,30.037333333333336,192,256,64,chromagram
75,6,119.75466666666667,146.5066666666667,26.752000000000024,256,313,57,chromagram
75,7,146.5066666666667,163.872,17.365333333333325,313,350,37,chromagram
75,8,163.872,194.848,30.976,350,416,66,chromagram
75,9,194.848,225.489,30.64099999999999,416,480,64,chromagram
75,1,0.0,12.277333333333333,12.277333333333333,0,27,27,chroma_acts
75,2,12.277333333333333,43.72266666666666,31.44533333333333,27,94,67,chroma_acts
75,3,43.72266666666666,59.67999999999999,15.957333333333331,94,128,34,chroma_acts
75,4,59.67999999999999,89.71733333333333,30.037333333333336,128,192,64,chroma_acts
75,5,89.71733333333333,119.75466666666667,30.037333333333336,192,256,64,chroma_acts
75,6,119.75466666666667,154.01600000000002,34.261333333333354,256,329,73,chroma_acts
75,7,154.01600000000002,180.29866666666666,26.282666666666643,329,385,56,chroma_acts
75,8,180.29866666666666,194.848,14.549333333333351,385,416,31,chroma_acts
75,9,194.848,225.489,30.64099999999999,416,480,64,chroma_acts
75,1,0.0,12.746666666666666,12.746666666666666,0,28,28,chroma_acts_smoothed
75,2,12.746666666666666,43.72266666666666,30.975999999999996,28,94,66,chroma_acts_smoothed
75,3,43.72266666666666,60.14933333333333,16.42666666666667,94,129,35,chroma_acts_smoothed
75,4,60.14933333333333,89.24799999999999,29.09866666666666,129,191,62,chroma_acts_smoothed
75,5,89.24799999999999,119.75466666666667,30.506666666666675,191,256,65,chroma_acts_smoothed
75,6,119.75466666666667,154.95466666666667,35.2,256,331,75,chroma_acts_smoothed
75,7,154.95466666666667,178.89066666666668,23.936000000000007,331,382,51,chroma_acts_smoothed
75,8,178.89066666666668,194.848,15.957333333333338,382,416,34,chroma_acts_smoothed
75,9,194.848,225.489,30.64099999999999,416,480,64,chroma_acts_smoothed
75,1,0.0,12.277333333333333,12.277333333333333,0,27,27,ki_chroma
75,2,12.277333333333333,30.112,17.834666666666664,27,65,38,ki_chroma
75,3,30.112,59.21066666666666,29.098666666666663,65,127,62,ki_chroma
75,4,59.21066666666666,89.71733333333333,30.506666666666668,127,192,65,ki_chroma
75,5,89.71733333333333,119.75466666666667,30.037333333333336,192,256,64,ki_chroma
75,6,119.75466666666667,146.5066666666667,26.752000000000024,256,313,57,ki_chroma
75,7,146.5066666666667,163.872,17.365333333333325,313,350,37,ki_chroma
75,8,163.872,194.848,30.976,350,416,66,ki_chroma
75,9,194.848,225.489,30.64099999999999,416,480,64,ki_chroma
75,1,0.0,12.277333333333333,12.277333333333333,0,27,27,ki_chroma_acts
75,2,12.277333333333333,43.72266666666666,31.44533333333333,27,94,67,ki_chroma_acts
75,3,43.72266666666666,59.67999999999999,15.957333333333331,94,128,34,ki_chroma_acts
75,4,59.67999999999999,89.71733333333333,30.037333333333336,128,192,64,ki_chroma_acts
75,5,89.71733333333333,119.75466666666667,30.037333333333336,192,256,64,ki_chroma_acts
75,6,119.75466666666667,154.01600000000002,34.261333333333354,256,329,73,ki_chroma_acts
75,7,154.01600000000002,180.29866666666666,26.282666666666643,329,385,56,ki_chroma_acts
75,8,180.29866666666666,194.848,14.549333333333351,385,416,31,ki_chroma_acts
75,9,194.848,225.489,30.64099999999999,416,480,64,ki_chroma_acts
75,1,0.0,12.746666666666666,12.746666666666666,0,28,28,ki_chroma_acts_smoothed
75,2,12.746666666666666,43.72266666666666,30.975999999999996,28,94,66,ki_chroma_acts_smoothed
75,3,43.72266666666666,60.14933333333333,16.42666666666667,94,129,35,ki_chroma_acts_smoothed
75,4,60.14933333333333,89.24799999999999,29.09866666666666,129,191,62,ki_chroma_acts_smoothed
75,5,89.24799999999999,119.75466666666667,30.506666666666675,191,256,65,ki_chroma_acts_smoothed
75,6,119.75466666666667,154.95466666666667,35.2,256,331,75,ki_chroma_acts_smoothed
75,7,154.95466666666667,178.89066666666668,23.936000000000007,331,382,51,ki_chroma_acts_smoothed
75,8,178.89066666666668,194.848,15.957333333333338,382,416,34,ki_chroma_acts_smoothed
75,9,194.848,225.489,30.64099999999999,416,480,64,ki_chroma_acts_smoothed
76,1,0.0,7.946666666666666,7.946666666666666,0,17,17,chromagram
76,2,7.946666666666666,42.026666666666664,34.08,17,88,71,chromagram
76,3,42.026666666666664,96.26666666666667,54.24,88,201,113,chromagram
76,4,96.26666666666667,126.98666666666666,30.72,201,265,64,chromagram
76,5,126.98666666666666,130.34666666666666,3.3599999999999994,265,272,7,chromagram
76,6,130.34666666666666,161.54666666666668,31.200000000000017,272,337,65,chromagram
76,7,161.54666666666668,222.50666666666666,60.95999999999998,337,464,127,chromagram
76,8,222.50666666666666,253.22666666666666,30.72,464,528,64,chromagram
76,9,253.22666666666666,269.16,15.933333333333366,528,560,32,chromagram
76,1,0.0,7.946666666666666,7.946666666666666,0,17,17,chroma_acts
76,2,7.946666666666666,42.026666666666664,34.08,17,88,71,chroma_acts
76,3,42.026666666666664,96.26666666666667,54.24,88,201,113,chroma_acts
76,4,96.26666666666667,130.34666666666666,34.08,201,272,71,chroma_acts
76,5,130.34666666666666,161.54666666666668,31.200000000000017,272,337,65,chroma_acts
76,6,161.54666666666668,212.42666666666668,50.879999999999995,337,443,106,chroma_acts
76,7,212.42666666666668,222.50666666666666,10.079999999999984,443,464,21,chroma_acts
76,8,222.50666666666666,253.22666666666666,30.72,464,528,64,chroma_acts
76,9,253.22666666666666,269.16,15.933333333333366,528,560,32,chroma_acts
76,1,0.0,7.946666666666666,7.946666666666666,0,17,17,chroma_acts_smoothed
76,2,7.946666666666666,42.026666666666664,34.08,17,88,71,chroma_acts_smoothed
76,3,42.026666666666664,95.78666666666666,53.76,88,200,112,chroma_acts_smoothed
76,4,95.78666666666666,130.34666666666666,34.56,200,272,72,chroma_acts_smoothed
76,5,130.34666666666666,161.06666666666666,30.72,272,336,64,chroma_acts_smoothed
76,6,161.06666666666666,212.42666666666668,51.360000000000014,336,443,107,chroma_acts_smoothed
76,7,212.42666666666668,222.98666666666668,10.560000000000002,443,465,22,chroma_acts_smoothed
76,8,222.98666666666668,252.74666666666667,29.75999999999999,465,527,62,chroma_acts_smoothed
76,9,252.74666666666667,269.16,16.413333333333355,527,560,33,chroma_acts_smoothed
76,1,0.0,7.946666666666666,7.946666666666666,0,17,17,ki_chroma
76,2,7.946666666666666,42.026666666666664,34.08,17,88,71,ki_chroma
76,3,42.026666666666664,96.26666666666667,54.24,88,201,113,ki_chroma
76,4,96.26666666666667,126.98666666666666,30.72,201,265,64,ki_chroma
76,5,126.98666666666666,130.34666666666666,3.3599999999999994,265,272,7,ki_chroma
76,6,130.34666666666666,161.54666666666668,31.200000000000017,272,337,65,ki_chroma
76,7,161.54666666666668,222.50666666666666,60.95999999999998,337,464,127,ki_chroma
76,8,222.50666666666666,253.22666666666666,30.72,464,528,64,ki_chroma
76,9,253.22666666666666,269.16,15.933333333333366,528,560,32,ki_chroma
76,1,0.0,7.946666666666666,7.946666666666666,0,17,17,ki_chroma_acts
76,2,7.946666666666666,42.026666666666664,34.08,17,88,71,ki_chroma_acts
76,3,42.026666666666664,96.26666666666667,54.24,88,201,113,ki_chroma_acts
76,4,96.26666666666667,130.34666666666666,34.08,201,272,71,ki_chroma_acts
76,5,130.34666666666666,161.54666666666668,31.200000000000017,272,337,65,ki_chroma_acts
76,6,161.54666666666668,212.42666666666668,50.879999999999995,337,443,106,ki_chroma_acts
76,7,212.42666666666668,222.50666666666666,10.079999999999984,443,464,21,ki_chroma_acts
76,8,222.50666666666666,253.22666666666666,30.72,464,528,64,ki_chroma_acts
76,9,253.22666666666666,269.16,15.933333333333366,528,560,32,ki_chroma_acts
76,1,0.0,7.946666666666666,7.946666666666666,0,17,17,ki_chroma_acts_smoothed
76,2,7.946666666666666,42.026666666666664,34.08,17,88,71,ki_chroma_acts_smoothed
76,3,42.026666666666664,95.78666666666666,53.76,88,200,112,ki_chroma_acts_smoothed
76,4,95.78666666666666,130.34666666666666,34.56,200,272,72,ki_chroma_acts_smoothed
76,5,130.34666666666666,161.06666666666666,30.72,272,336,64,ki_chroma_acts_smoothed
76,6,161.06666666666666,212.42666666666668,51.360000000000014,336,443,107,ki_chroma_acts_smoothed
76,7,212.42666666666668,222.98666666666668,10.560000000000002,443,465,22,ki_chroma_acts_smoothed
76,8,222.98666666666668,252.74666666666667,29.75999999999999,465,527,62,ki_chroma_acts_smoothed
76,9,252.74666666666667,269.16,16.413333333333355,527,560,33,ki_chroma_acts_smoothed
78,1,0.0,16.821333333333335,16.821333333333335,0,36,36,chromagram
78,2,16.821333333333335,60.501333333333335,43.68,36,127,91,chromagram
78,3,60.501333333333335,91.22133333333333,30.72,127,191,64,chromagram
78,4,91.22133333333333,106.10133333333333,14.879999999999995,191,222,31,chromagram
78,5,106.10133333333333,151.7013333333333,45.59999999999998,222,317,95,chromagram
78,6,151.7013333333333,167.06133333333332,15.360000000000014,317,349,32,chromagram
78,7,167.06133333333332,197.78133333333332,30.72,349,413,64,chromagram
78,8,197.78133333333332,258.2613333333333,60.47999999999999,413,539,126,chromagram
78,9,258.2613333333333,289.524,31.26266666666669,539,603,64,chromagram
78,1,0.0,16.821333333333335,16.821333333333335,0,36,36,chroma_acts
78,2,16.821333333333335,60.501333333333335,43.68,36,127,91,chroma_acts
78,3,60.501333333333335,91.22133333333333,30.72,127,191,64,chroma_acts
78,4,91.22133333333333,106.10133333333333,14.879999999999995,191,222,31,chroma_acts
78,5,106.10133333333333,151.7013333333333,45.59999999999998,222,317,95,chroma_acts
78,6,151.7013333333333,167.06133333333332,15.360000000000014,317,349,32,chroma_acts
78,7,167.06133333333332,197.78133333333332,30.72,349,413,64,chroma_acts
78,8,197.78133333333332,258.2613333333333,60.47999999999999,413,539,126,chroma_acts
78,9,258.2613333333333,289.524,31.26266666666669,539,603,64,chroma_acts
78,1,0.0,16.821333333333335,16.821333333333335,0,36,36,chroma_acts_smoothed
78,2,16.821333333333335,60.501333333333335,43.68,36,127,91,chroma_acts_smoothed
78,3,60.501333333333335,91.22133333333333,30.72,127,191,64,chroma_acts_smoothed
78,4,91.22133333333333,106.10133333333333,14.879999999999995,191,222,31,chroma_acts_smoothed
78,5,106.10133333333333,151.7013333333333,45.59999999999998,222,317,95,chroma_acts_smoothed
78,6,151.7013333333333,167.06133333333332,15.360000000000014,317,349,32,chroma_acts_smoothed
78,7,167.06133333333332,196.8213333333333,29.75999999999999,349,411,62,chroma_acts_smoothed
78,8,196.8213333333333,258.2613333333333,61.44,411,539,128,chroma_acts_smoothed
78,9,258.2613333333333,289.524,31.26266666666669,539,603,64,chroma_acts_smoothed
78,1,0.0,16.821333333333335,16.821333333333335,0,36,36,ki_chroma
78,2,16.821333333333335,60.501333333333335,43.68,36,127,91,ki_chroma
78,3,60.501333333333335,91.22133333333333,30.72,127,191,64,ki_chroma
78,4,91.22133333333333,106.10133333333333,14.879999999999995,191,222,31,ki_chroma
78,5,106.10133333333333,151.7013333333333,45.59999999999998,222,317,95,ki_chroma
78,6,151.7013333333333,167.06133333333332,15.360000000000014,317,349,32,ki_chroma
78,7,167.06133333333332,197.78133333333332,30.72,349,413,64,ki_chroma
78,8,197.78133333333332,258.2613333333333,60.47999999999999,413,539,126,ki_chroma
78,9,258.2613333333333,289.524,31.26266666666669,539,603,64,ki_chroma
78,1,0.0,16.821333333333335,16.821333333333335,0,36,36,ki_chroma_acts
78,2,16.821333333333335,60.501333333333335,43.68,36,127,91,ki_chroma_acts
78,3,60.501333333333335,91.22133333333333,30.72,127,191,64,ki_chroma_acts
78,4,91.22133333333333,106.10133333333333,14.879999999999995,191,222,31,ki_chroma_acts
78,5,106.10133333333333,151.7013333333333,45.59999999999998,222,317,95,ki_chroma_acts
78,6,151.7013333333333,167.06133333333332,15.360000000000014,317,349,32,ki_chroma_acts
78,7,167.06133333333332,197.78133333333332,30.72,349,413,64,ki_chroma_acts
78,8,197.78133333333332,258.2613333333333,60.47999999999999,413,539,126,ki_chroma_acts
78,9,258.2613333333333,289.524,31.26266666666669,539,603,64,ki_chroma_acts
78,1,0.0,16.821333333333335,16.821333333333335,0,36,36,ki_chroma_acts_smoothed
78,2,16.821333333333335,60.501333333333335,43.68,36,127,91,ki_chroma_acts_smoothed
78,3,60.501333333333335,91.22133333333333,30.72,127,191,64,ki_chroma_acts_smoothed
78,4,91.22133333333333,106.10133333333333,14.879999999999995,191,222,31,ki_chroma_acts_smoothed
78,5,106.10133333333333,151.7013333333333,45.59999999999998,222,317,95,ki_chroma_acts_smoothed
78,6,151.7013333333333,167.06133333333332,15.360000000000014,317,349,32,ki_chroma_acts_smoothed
78,7,167.06133333333332,196.8213333333333,29.75999999999999,349,411,62,ki_chroma_acts_smoothed
78,8,196.8213333333333,258.2613333333333,61.44,411,539,128,ki_chroma_acts_smoothed
78,9,258.2613333333333,289.524,31.26266666666669,539,603,64,ki_chroma_acts_smoothed
79,1,0.0,11.562666666666665,11.562666666666665,0,25,25,chromagram
79,2,11.562666666666665,25.002666666666666,13.440000000000001,25,53,28,chromagram
79,3,25.002666666666666,27.402666666666665,2.3999999999999986,53,58,5,chromagram
79,4,27.402666666666665,57.64266666666666,30.24,58,121,63,chromagram
79,5,57.64266666666666,103.72266666666667,46.080000000000005,121,217,96,chromagram
79,6,103.72266666666667,145.96266666666668,42.24000000000001,217,305,88,chromagram
79,7,145.96266666666668,149.80266666666668,3.8400000000000034,305,313,8,chromagram
79,8,149.80266666666668,180.884,31.081333333333305,313,376,63,chromagram
79,1,0.0,11.562666666666665,11.562666666666665,0,25,25,chroma_acts
79,2,11.562666666666665,57.64266666666666,46.08,25,121,96,chroma_acts
79,3,57.64266666666666,103.72266666666667,46.080000000000005,121,217,96,chroma_acts
79,4,103.72266666666667,117.16266666666667,13.439999999999998,217,245,28,chroma_acts
79,5,117.16266666666667,119.08266666666667,1.9200000000000017,245,249,4,chroma_acts
79,6,119.08266666666667,145.96266666666668,26.88000000000001,249,305,56,chroma_acts
79,7,145.96266666666668,150.28266666666667,4.319999999999993,305,314,9,chroma_acts
79,8,150.28266666666667,180.884,30.601333333333315,314,376,62,chroma_acts
79,1,0.0,11.562666666666665,11.562666666666665,0,25,25,chroma_acts_smoothed
79,2,11.562666666666665,57.64266666666666,46.08,25,121,96,chroma_acts_smoothed
79,3,57.64266666666666,103.72266666666667,46.080000000000005,121,217,96,chroma_acts_smoothed
79,4,103.72266666666667,116.68266666666666,12.959999999999994,217,244,27,chroma_acts_smoothed
79,5,116.68266666666666,119.08266666666667,2.4000000000000057,244,249,5,chroma_acts_smoothed
79,6,119.08266666666667,145.4826666666667,26.40000000000002,249,304,55,chroma_acts_smoothed
79,7,145.4826666666667,150.28266666666667,4.799999999999983,304,314,10,chroma_acts_smoothed
79,8,150.28266666666667,180.884,30.601333333333315,314,376,62,chroma_acts_smoothed
79,1,0.0,11.562666666666665,11.562666666666665,0,25,25,ki_chroma
79,2,11.562666666666665,25.002666666666666,13.440000000000001,25,53,28,ki_chroma
79,3,25.002666666666666,27.402666666666665,2.3999999999999986,53,58,5,ki_chroma
79,4,27.402666666666665,57.64266666666666,30.24,58,121,63,ki_chroma
79,5,57.64266666666666,103.72266666666667,46.080000000000005,121,217,96,ki_chroma
79,6,103.72266666666667,145.96266666666668,42.24000000000001,217,305,88,ki_chroma
79,7,145.96266666666668,149.80266666666668,3.8400000000000034,305,313,8,ki_chroma
79,8,149.80266666666668,180.884,31.081333333333305,313,376,63,ki_chroma
79,1,0.0,11.562666666666665,11.562666666666665,0,25,25,ki_chroma_acts
79,2,11.562666666666665,57.64266666666666,46.08,25,121,96,ki_chroma_acts
79,3,57.64266666666666,103.72266666666667,46.080000000000005,121,217,96,ki_chroma_acts
79,4,103.72266666666667,117.16266666666667,13.439999999999998,217,245,28,ki_chroma_acts
79,5,117.16266666666667,119.08266666666667,1.9200000000000017,245,249,4,ki_chroma_acts
79,6,119.08266666666667,145.96266666666668,26.88000000000001,249,305,56,ki_chroma_acts
79,7,145.96266666666668,150.28266666666667,4.319999999999993,305,314,9,ki_chroma_acts
79,8,150.28266666666667,180.884,30.601333333333315,314,376,62,ki_chroma_acts
79,1,0.0,11.562666666666665,11.562666666666665,0,25,25,ki_chroma_acts_smoothed
79,2,11.562666666666665,57.64266666666666,46.08,25,121,96,ki_chroma_acts_smoothed
79,3,57.64266666666666,103.72266666666667,46.080000000000005,121,217,96,ki_chroma_acts_smoothed
79,4,103.72266666666667,116.68266666666666,12.959999999999994,217,244,27,ki_chroma_acts_smoothed
79,5,116.68266666666666,119.08266666666667,2.4000000000000057,244,249,5,ki_chroma_acts_smoothed
79,6,119.08266666666667,145.4826666666667,26.40000000000002,249,304,55,ki_chroma_acts_smoothed
79,7,145.4826666666667,150.28266666666667,4.799999999999983,304,314,10,ki_chroma_acts_smoothed
79,8,150.28266666666667,180.884,30.601333333333315,314,376,62,ki_chroma_acts_smoothed
82,1,0.0,14.975999999999999,14.975999999999999,0,32,32,chromagram
82,2,14.975999999999999,61.535999999999994,46.559999999999995,32,129,97,chromagram
82,3,61.535999999999994,91.776,30.240000000000002,129,192,63,chromagram
82,4,91.776,137.856,46.08,192,288,96,chromagram
82,5,137.856,168.096,30.24000000000001,288,351,63,chromagram
82,6,168.096,175.776,7.680000000000007,351,367,16,chromagram
82,7,175.776,230.49599999999998,54.71999999999997,367,481,114,chromagram
82,8,230.49599999999998,262.671,32.17500000000001,481,547,66,chromagram
82,1,0.0,14.975999999999999,14.975999999999999,0,32,32,chroma_acts
82,2,14.975999999999999,61.535999999999994,46.559999999999995,32,129,97,chroma_acts
82,3,61.535999999999994,91.776,30.240000000000002,129,192,63,chroma_acts
82,4,91.776,137.856,46.08,192,288,96,chroma_acts
82,5,137.856,143.61599999999999,5.759999999999991,288,300,12,chroma_acts
82,6,143.61599999999999,176.736,33.120000000000005,300,369,69,chroma_acts
82,7,176.736,230.49599999999998,53.75999999999999,369,481,112,chroma_acts
82,8,230.49599999999998,262.671,32.17500000000001,481,547,66,chroma_acts
82,1,0.0,15.456,15.456,0,33,33,chroma_acts_smoothed
82,2,15.456,61.535999999999994,46.08,33,129,96,chroma_acts_smoothed
82,3,61.535999999999994,91.776,30.240000000000002,129,192,63,chroma_acts_smoothed
82,4,91.776,137.376,45.60000000000001,192,287,95,chroma_acts_smoothed
82,5,137.376,144.096,6.719999999999999,287,301,14,chroma_acts_smoothed
82,6,144.096,176.736,32.639999999999986,301,369,68,chroma_acts_smoothed
82,7,176.736,230.49599999999998,53.75999999999999,369,481,112,chroma_acts_smoothed
82,8,230.49599999999998,262.671,32.17500000000001,481,547,66,chroma_acts_smoothed
82,1,0.0,14.975999999999999,14.975999999999999,0,32,32,ki_chroma
82,2,14.975999999999999,61.535999999999994,46.559999999999995,32,129,97,ki_chroma
82,3,61.535999999999994,91.776,30.240000000000002,129,192,63,ki_chroma
82,4,91.776,137.856,46.08,192,288,96,ki_chroma
82,5,137.856,168.096,30.24000000000001,288,351,63,ki_chroma
82,6,168.096,175.776,7.680000000000007,351,367,16,ki_chroma
82,7,175.776,230.49599999999998,54.71999999999997,367,481,114,ki_chroma
82,8,230.49599999999998,262.671,32.17500000000001,481,547,66,ki_chroma
82,1,0.0,14.975999999999999,14.975999999999999,0,32,32,ki_chroma_acts
82,2,14.975999999999999,61.535999999999994,46.559999999999995,32,129,97,ki_chroma_acts
82,3,61.535999999999994,91.776,30.240000000000002,129,192,63,ki_chroma_acts
82,4,91.776,137.856,46.08,192,288,96,ki_chroma_acts
82,5,137.856,143.61599999999999,5.759999999999991,288,300,12,ki_chroma_acts
82,6,143.61599999999999,176.736,33.120000000000005,300,369,69,ki_chroma_acts
82,7,176.736,230.49599999999998,53.75999999999999,369,481,112,ki_chroma_acts
82,8,230.49599999999998,262.671,32.17500000000001,481,547,66,ki_chroma_acts
82,1,0.0,15.456,15.456,0,33,33,ki_chroma_acts_smoothed
82,2,15.456,61.535999999999994,46.08,33,129,96,ki_chroma_acts_smoothed
82,3,61.535999999999994,91.776,30.240000000000002,129,192,63,ki_chroma_acts_smoothed
82,4,91.776,137.376,45.60000000000001,192,287,95,ki_chroma_acts_smoothed
82,5,137.376,144.096,6.719999999999999,287,301,14,ki_chroma_acts_smoothed
82,6,144.096,176.736,32.639999999999986,301,369,68,ki_chroma_acts_smoothed
82,7,176.736,230.49599999999998,53.75999999999999,369,481,112,ki_chroma_acts_smoothed
82,8,230.49599999999998,262.671,32.17500000000001,481,547,66,ki_chroma_acts_smoothed
83,1,0.0,53.312,53.312,0,112,112,chromagram
83,2,53.312,69.152,15.840000000000003,112,145,33,chromagram
83,3,69.152,98.432,29.28,145,206,61,chromagram
83,4,98.432,114.752,16.319999999999993,206,240,34,chromagram
83,5,114.752,191.07199999999997,76.31999999999998,240,399,159,chromagram
83,6,191.07199999999997,220.35199999999998,29.28,399,460,61,chromagram
83,7,220.35199999999998,238.112,17.76000000000002,460,497,37,chromagram
83,8,238.112,250.525,12.413000000000011,497,521,24,chromagram
83,1,0.0,52.831999999999994,52.831999999999994,0,111,111,chroma_acts
83,2,52.831999999999994,69.152,16.320000000000007,111,145,34,chroma_acts
83,3,69.152,98.432,29.28,145,206,61,chroma_acts
83,4,98.432,114.752,16.319999999999993,206,240,34,chroma_acts
83,5,114.752,191.07199999999997,76.31999999999998,240,399,159,chroma_acts
83,6,191.07199999999997,220.35199999999998,29.28,399,460,61,chroma_acts
83,7,220.35199999999998,238.112,17.76000000000002,460,497,37,chroma_acts
83,8,238.112,250.525,12.413000000000011,497,521,24,chroma_acts
83,1,0.0,52.831999999999994,52.831999999999994,0,111,111,chroma_acts_smoothed
83,2,52.831999999999994,69.152,16.320000000000007,111,145,34,chroma_acts_smoothed
83,3,69.152,98.432,29.28,145,206,61,chroma_acts_smoothed
83,4,98.432,191.07199999999997,92.63999999999997,206,399,193,chroma_acts_smoothed
83,5,191.07199999999997,220.35199999999998,29.28,399,460,61,chroma_acts_smoothed
83,6,220.35199999999998,236.67199999999997,16.319999999999993,460,494,34,chroma_acts_smoothed
83,7,236.67199999999997,238.59199999999998,1.920000000000016,494,498,4,chroma_acts_smoothed
83,8,238.59199999999998,250.525,11.933000000000021,498,521,23,chroma_acts_smoothed
83,1,0.0,53.312,53.312,0,112,112,ki_chroma
83,2,53.312,69.152,15.840000000000003,112,145,33,ki_chroma
83,3,69.152,98.432,29.28,145,206,61,ki_chroma
83,4,98.432,114.752,16.319999999999993,206,240,34,ki_chroma
83,5,114.752,191.07199999999997,76.31999999999998,240,399,159,ki_chroma
83,6,191.07199999999997,220.35199999999998,29.28,399,460,61,ki_chroma
83,7,220.35199999999998,238.112,17.76000000000002,460,497,37,ki_chroma
83,8,238.112,250.525,12.413000000000011,497,521,24,ki_chroma
83,1,0.0,52.831999999999994,52.831999999999994,0,111,111,ki_chroma_acts
83,2,52.831999999999994,69.152,16.320000000000007,111,145,34,ki_chroma_acts
83,3,69.152,98.432,29.28,145,206,61,ki_chroma_acts
83,4,98.432,114.752,16.319999999999993,206,240,34,ki_chroma_acts
83,5,114.752,191.07199999999997,76.31999999999998,240,399,159,ki_chroma_acts
83,6,191.07199999999997,220.35199999999998,29.28,399,460,61,ki_chroma_acts
83,7,220.35199999999998,238.112,17.76000000000002,460,497,37,ki_chroma_acts
83,8,238.112,250.525,12.413000000000011,497,521,24,ki_chroma_acts
83,1,0.0,52.831999999999994,52.831999999999994,0,111,111,ki_chroma_acts_smoothed
83,2,52.831999999999994,69.152,16.320000000000007,111,145,34,ki_chroma_acts_smoothed
83,3,69.152,98.432,29.28,145,206,61,ki_chroma_acts_smoothed
83,4,98.432,191.07199999999997,92.63999999999997,206,399,193,ki_chroma_acts_smoothed
83,5,191.07199999999997,220.35199999999998,29.28,399,460,61,ki_chroma_acts_smoothed
83,6,220.35199999999998,236.67199999999997,16.319999999999993,460,494,34,ki_chroma_acts_smoothed
83,7,236.67199999999997,238.59199999999998,1.920000000000016,494,498,4,ki_chroma_acts_smoothed
83,8,238.59199999999998,250.525,11.933000000000021,498,521,23,ki_chroma_acts_smoothed
86,1,0.0,7.690666666666667,7.690666666666667,0,17,17,chromagram
86,2,7.690666666666667,58.848,51.157333333333334,17,126,109,chromagram
86,3,58.848,89.35466666666666,30.50666666666666,126,191,65,chromagram
86,4,89.35466666666666,104.37333333333332,15.018666666666661,191,223,32,chromagram
86,5,104.37333333333332,139.10399999999998,34.730666666666664,223,297,74,chromagram
86,6,139.10399999999998,150.368,11.26400000000001,297,321,24,chromagram
86,7,150.368,168.20266666666666,17.834666666666664,321,359,38,chromagram
86,8,168.20266666666666,197.663,29.460333333333352,359,420,61,chromagram
86,1,0.0,7.690666666666667,7.690666666666667,0,17,17,chroma_acts
86,2,7.690666666666667,58.848,51.157333333333334,17,126,109,chroma_acts
86,3,58.848,89.35466666666666,30.50666666666666,126,191,65,chroma_acts
86,4,89.35466666666666,94.04799999999999,4.693333333333328,191,201,10,chroma_acts
86,5,94.04799999999999,96.86399999999999,2.8160000000000025,201,207,6,chroma_acts
86,6,96.86399999999999,139.10399999999998,42.239999999999995,207,297,90,chroma_acts
86,7,139.10399999999998,150.368,11.26400000000001,297,321,24,chroma_acts
86,8,150.368,158.816,8.448000000000008,321,339,18,chroma_acts
86,9,158.816,197.663,38.84700000000001,339,420,81,chroma_acts
86,1,0.0,14.261333333333333,14.261333333333333,0,31,31,chroma_acts_smoothed
86,2,14.261333333333333,58.848,44.586666666666666,31,126,95,chroma_acts_smoothed
86,3,58.848,89.35466666666666,30.50666666666666,126,191,65,chroma_acts_smoothed
86,4,89.35466666666666,94.04799999999999,4.693333333333328,191,201,10,chroma_acts_smoothed
86,5,94.04799999999999,104.37333333333332,10.325333333333333,201,223,22,chroma_acts_smoothed
86,6,104.37333333333332,138.63466666666665,34.261333333333326,223,296,73,chroma_acts_smoothed
86,7,138.63466666666665,150.368,11.733333333333348,296,321,25,chroma_acts_smoothed
86,8,150.368,158.816,8.448000000000008,321,339,18,chroma_acts_smoothed
86,9,158.816,197.663,38.84700000000001,339,420,81,chroma_acts_smoothed
86,1,0.0,7.690666666666667,7.690666666666667,0,17,17,ki_chroma
86,2,7.690666666666667,58.848,51.157333333333334,17,126,109,ki_chroma
86,3,58.848,89.35466666666666,30.50666666666666,126,191,65,ki_chroma
86,4,89.35466666666666,104.37333333333332,15.018666666666661,191,223,32,ki_chroma
86,5,104.37333333333332,139.10399999999998,34.730666666666664,223,297,74,ki_chroma
86,6,139.10399999999998,150.368,11.26400000000001,297,321,24,ki_chroma
86,7,150.368,168.20266666666666,17.834666666666664,321,359,38,ki_chroma
86,8,168.20266666666666,197.663,29.460333333333352,359,420,61,ki_chroma
86,1,0.0,7.690666666666667,7.690666666666667,0,17,17,ki_chroma_acts
86,2,7.690666666666667,58.848,51.157333333333334,17,126,109,ki_chroma_acts
86,3,58.848,89.35466666666666,30.50666666666666,126,191,65,ki_chroma_acts
86,4,89.35466666666666,94.04799999999999,4.693333333333328,191,201,10,ki_chroma_acts
86,5,94.04799999999999,96.86399999999999,2.8160000000000025,201,207,6,ki_chroma_acts
86,6,96.86399999999999,139.10399999999998,42.239999999999995,207,297,90,ki_chroma_acts
86,7,139.10399999999998,150.368,11.26400000000001,297,321,24,ki_chroma_acts
86,8,150.368,158.816,8.448000000000008,321,339,18,ki_chroma_acts
86,9,158.816,197.663,38.84700000000001,339,420,81,ki_chroma_acts
86,1,0.0,14.261333333333333,14.261333333333333,0,31,31,ki_chroma_acts_smoothed
86,2,14.261333333333333,58.848,44.586666666666666,31,126,95,ki_chroma_acts_smoothed
86,3,58.848,89.35466666666666,30.50666666666666,126,191,65,ki_chroma_acts_smoothed
86,4,89.35466666666666,94.04799999999999,4.693333333333328,191,201,10,ki_chroma_acts_smoothed
86,5,94.04799999999999,104.37333333333332,10.325333333333333,201,223,22,ki_chroma_acts_smoothed
86,6,104.37333333333332,138.63466666666665,34.261333333333326,223,296,73,ki_chroma_acts_smoothed
86,7,138.63466666666665,150.368,11.733333333333348,296,321,25,ki_chroma_acts_smoothed
86,8,150.368,158.816,8.448000000000008,321,339,18,ki_chroma_acts_smoothed
86,9,158.816,197.663,38.84700000000001,339,420,81,ki_chroma_acts_smoothed
88,1,0.0,11.52,11.52,0,25,25,chromagram
88,2,11.52,14.805333333333333,3.285333333333334,25,32,7,chromagram
88,3,14.805333333333333,30.293333333333333,15.488,32,65,33,chromagram
88,4,30.293333333333333,44.842666666666666,14.549333333333333,65,96,31,chromagram
88,5,44.842666666666666,73.472,28.629333333333328,96,157,61,chromagram
88,6,73.472,104.91733333333333,31.445333333333338,157,224,67,chromagram
88,7,104.91733333333333,116.65066666666667,11.733333333333334,224,249,25,chromagram
88,8,116.65066666666667,120.40533333333333,3.7546666666666653,249,257,8,chromagram
88,9,120.40533333333333,180.275,59.869666666666674,257,383,126,chromagram
88,1,0.0,11.52,11.52,0,25,25,chroma_acts
88,2,11.52,14.805333333333333,3.285333333333334,25,32,7,chroma_acts
88,3,14.805333333333333,30.293333333333333,15.488,32,65,33,chroma_acts
88,4,30.293333333333333,44.842666666666666,14.549333333333333,65,96,31,chroma_acts
88,5,44.842666666666666,73.472,28.629333333333328,96,157,61,chroma_acts
88,6,73.472,104.91733333333333,31.445333333333338,157,224,67,chroma_acts
88,7,104.91733333333333,120.40533333333333,15.488,224,257,33,chroma_acts
88,8,120.40533333333333,149.504,29.09866666666666,257,319,62,chroma_acts
88,9,149.504,180.275,30.771000000000015,319,383,64,chroma_acts
88,1,0.0,11.050666666666666,11.050666666666666,0,24,24,chroma_acts_smoothed
88,2,11.050666666666666,15.274666666666667,4.224,24,33,9,chroma_acts_smoothed
88,3,15.274666666666667,30.293333333333333,15.018666666666666,33,65,32,chroma_acts_smoothed
88,4,30.293333333333333,45.312,15.018666666666665,65,97,32,chroma_acts_smoothed
88,5,45.312,73.00266666666667,27.690666666666672,97,156,59,chroma_acts_smoothed
88,6,73.00266666666667,105.38666666666667,32.384,156,225,69,chroma_acts_smoothed
88,7,105.38666666666667,116.18133333333333,10.794666666666657,225,248,23,chroma_acts_smoothed
88,8,116.18133333333333,120.40533333333333,4.224000000000004,248,257,9,chroma_acts_smoothed
88,9,120.40533333333333,180.275,59.869666666666674,257,383,126,chroma_acts_smoothed
88,1,0.0,11.52,11.52,0,25,25,ki_chroma
88,2,11.52,14.805333333333333,3.285333333333334,25,32,7,ki_chroma
88,3,14.805333333333333,30.293333333333333,15.488,32,65,33,ki_chroma
88,4,30.293333333333333,44.842666666666666,14.549333333333333,65,96,31,ki_chroma
88,5,44.842666666666666,73.472,28.629333333333328,96,157,61,ki_chroma
88,6,73.472,104.91733333333333,31.445333333333338,157,224,67,ki_chroma
88,7,104.91733333333333,116.65066666666667,11.733333333333334,224,249,25,ki_chroma
88,8,116.65066666666667,120.40533333333333,3.7546666666666653,249,257,8,ki_chroma
88,9,120.40533333333333,180.275,59.869666666666674,257,383,126,ki_chroma
88,1,0.0,11.52,11.52,0,25,25,ki_chroma_acts
88,2,11.52,14.805333333333333,3.285333333333334,25,32,7,ki_chroma_acts
88,3,14.805333333333333,30.293333333333333,15.488,32,65,33,ki_chroma_acts
88,4,30.293333333333333,44.842666666666666,14.549333333333333,65,96,31,ki_chroma_acts
88,5,44.842666666666666,73.472,28.629333333333328,96,157,61,ki_chroma_acts
88,6,73.472,104.91733333333333,31.445333333333338,157,224,67,ki_chroma_acts
88,7,104.91733333333333,120.40533333333333,15.488,224,257,33,ki_chroma_acts
88,8,120.40533333333333,149.504,29.09866666666666,257,319,62,ki_chroma_acts
88,9,149.504,180.275,30.771000000000015,319,383,64,ki_chroma_acts
88,1,0.0,11.050666666666666,11.050666666666666,0,24,24,ki_chroma_acts_smoothed
88,2,11.050666666666666,15.274666666666667,4.224,24,33,9,ki_chroma_acts_smoothed
88,3,15.274666666666667,30.293333333333333,15.018666666666666,33,65,32,ki_chroma_acts_smoothed
88,4,30.293333333333333,45.312,15.018666666666665,65,97,32,ki_chroma_acts_smoothed
88,5,45.312,73.00266666666667,27.690666666666672,97,156,59,ki_chroma_acts_smoothed
88,6,73.00266666666667,105.38666666666667,32.384,156,225,69,ki_chroma_acts_smoothed
88,7,105.38666666666667,116.18133333333333,10.794666666666657,225,248,23,ki_chroma_acts_smoothed
88,8,116.18133333333333,120.40533333333333,4.224000000000004,248,257,9,ki_chroma_acts_smoothed
88,9,120.40533333333333,180.275,59.869666666666674,257,383,126,ki_chroma_acts_smoothed
89,1,0.0,29.077333333333332,29.077333333333332,0,61,61,chromagram
89,2,29.077333333333332,45.87733333333333,16.8,61,96,35,chromagram
89,3,45.87733333333333,61.23733333333333,15.36,96,128,32,chromagram
89,4,61.23733333333333,90.51733333333333,29.279999999999994,128,189,61,chromagram
89,5,90.51733333333333,122.67733333333332,32.16,189,256,67,chromagram
89,6,122.67733333333332,139.95733333333334,17.280000000000015,256,292,36,chromagram
89,7,139.95733333333334,186.03733333333332,46.079999999999984,292,388,96,chromagram
89,8,186.03733333333332,203.53,17.49266666666668,388,423,35,chromagram
89,1,0.0,29.077333333333332,29.077333333333332,0,61,61,chroma_acts
89,2,29.077333333333332,30.997333333333334,1.9200000000000017,61,65,4,chroma_acts
89,3,30.997333333333334,45.87733333333333,14.879999999999999,65,96,31,chroma_acts
89,4,45.87733333333333,61.23733333333333,15.36,96,128,32,chroma_acts
89,5,61.23733333333333,90.51733333333333,29.279999999999994,128,189,61,chroma_acts
89,6,90.51733333333333,139.95733333333334,49.44000000000001,189,292,103,chroma_acts
89,7,139.95733333333334,186.03733333333332,46.079999999999984,292,388,96,chroma_acts
89,8,186.03733333333332,203.53,17.49266666666668,388,423,35,chroma_acts
89,1,0.0,28.597333333333335,28.597333333333335,0,60,60,chroma_acts_smoothed
89,2,28.597333333333335,30.997333333333334,2.3999999999999986,60,65,5,chroma_acts_smoothed
89,3,30.997333333333334,45.39733333333333,14.399999999999995,65,95,30,chroma_acts_smoothed
89,4,45.39733333333333,61.23733333333333,15.840000000000003,95,128,33,chroma_acts_smoothed
89,5,61.23733333333333,90.51733333333333,29.279999999999994,128,189,61,chroma_acts_smoothed
89,6,90.51733333333333,139.95733333333334,49.44000000000001,189,292,103,chroma_acts_smoothed
89,7,139.95733333333334,186.5173333333333,46.559999999999974,292,389,97,chroma_acts_smoothed
89,8,186.5173333333333,203.53,17.01266666666669,389,423,34,chroma_acts_smoothed
89,1,0.0,29.077333333333332,29.077333333333332,0,61,61,ki_chroma
89,2,29.077333333333332,45.87733333333333,16.8,61,96,35,ki_chroma
89,3,45.87733333333333,61.23733333333333,15.36,96,128,32,ki_chroma
89,4,61.23733333333333,90.51733333333333,29.279999999999994,128,189,61,ki_chroma
89,5,90.51733333333333,122.67733333333332,32.16,189,256,67,ki_chroma
89,6,122.67733333333332,139.95733333333334,17.280000000000015,256,292,36,ki_chroma
89,7,139.95733333333334,186.03733333333332,46.079999999999984,292,388,96,ki_chroma
89,8,186.03733333333332,203.53,17.49266666666668,388,423,35,ki_chroma
89,1,0.0,29.077333333333332,29.077333333333332,0,61,61,ki_chroma_acts
89,2,29.077333333333332,30.997333333333334,1.9200000000000017,61,65,4,ki_chroma_acts
89,3,30.997333333333334,45.87733333333333,14.879999999999999,65,96,31,ki_chroma_acts
89,4,45.87733333333333,61.23733333333333,15.36,96,128,32,ki_chroma_acts
89,5,61.23733333333333,90.51733333333333,29.279999999999994,128,189,61,ki_chroma_acts
89,6,90.51733333333333,139.95733333333334,49.44000000000001,189,292,103,ki_chroma_acts
89,7,139.95733333333334,186.03733333333332,46.079999999999984,292,388,96,ki_chroma_acts
89,8,186.03733333333332,203.53,17.49266666666668,388,423,35,ki_chroma_acts
89,1,0.0,28.597333333333335,28.597333333333335,0,60,60,ki_chroma_acts_smoothed
89,2,28.597333333333335,30.997333333333334,2.3999999999999986,60,65,5,ki_chroma_acts_smoothed
89,3,30.997333333333334,45.39733333333333,14.399999999999995,65,95,30,ki_chroma_acts_smoothed
89,4,45.39733333333333,61.23733333333333,15.840000000000003,95,128,33,ki_chroma_acts_smoothed
89,5,61.23733333333333,90.51733333333333,29.279999999999994,128,189,61,ki_chroma_acts_smoothed
89,6,90.51733333333333,139.95733333333334,49.44000000000001,189,292,103,ki_chroma_acts_smoothed
89,7,139.95733333333334,186.5173333333333,46.559999999999974,292,389,97,ki_chroma_acts_smoothed
89,8,186.5173333333333,203.53,17.01266666666669,389,423,34,ki_chroma_acts_smoothed
90,1,0.0,6.826666666666666,6.826666666666666,0,15,15,chromagram
90,2,6.826666666666666,21.226666666666663,14.399999999999997,15,45,30,chromagram
90,3,21.226666666666663,28.426666666666666,7.200000000000003,45,60,15,chromagram
90,4,28.426666666666666,36.10666666666667,7.680000000000003,60,76,16,chromagram
90,5,36.10666666666667,67.78666666666666,31.679999999999993,76,142,66,chromagram
90,6,67.78666666666666,97.06666666666666,29.28,142,203,61,chromagram
90,7,97.06666666666666,118.66666666666667,21.60000000000001,203,248,45,chromagram
90,8,118.66666666666667,125.86666666666666,7.199999999999989,248,263,15,chromagram
90,9,125.86666666666666,174.549,48.68233333333335,263,363,100,chromagram
90,1,0.0,6.826666666666666,6.826666666666666,0,15,15,chroma_acts
90,2,6.826666666666666,21.226666666666663,14.399999999999997,15,45,30,chroma_acts
90,3,21.226666666666663,28.426666666666666,7.200000000000003,45,60,15,chroma_acts
90,4,28.426666666666666,36.10666666666667,7.680000000000003,60,76,16,chroma_acts
90,5,36.10666666666667,67.78666666666666,31.679999999999993,76,142,66,chroma_acts
90,6,67.78666666666666,97.06666666666666,29.28,142,203,61,chroma_acts
90,7,97.06666666666666,118.66666666666667,21.60000000000001,203,248,45,chroma_acts
90,8,118.66666666666667,125.86666666666666,7.199999999999989,248,263,15,chroma_acts
90,9,125.86666666666666,174.549,48.68233333333335,263,363,100,chroma_acts
90,1,0.0,5.386666666666666,5.386666666666666,0,12,12,chroma_acts_smoothed
90,2,5.386666666666666,21.226666666666663,15.839999999999996,12,45,33,chroma_acts_smoothed
90,3,21.226666666666663,28.426666666666666,7.200000000000003,45,60,15,chroma_acts_smoothed
90,4,28.426666666666666,67.78666666666666,39.36,60,142,82,chroma_acts_smoothed
90,5,67.78666666666666,82.66666666666667,14.88000000000001,142,173,31,chroma_acts_smoothed
90,6,82.66666666666667,97.54666666666667,14.879999999999995,173,204,31,chroma_acts_smoothed
90,7,97.54666666666667,119.14666666666666,21.599999999999994,204,249,45,chroma_acts_smoothed
90,8,119.14666666666666,125.86666666666666,6.719999999999999,249,263,14,chroma_acts_smoothed
90,9,125.86666666666666,174.549,48.68233333333335,263,363,100,chroma_acts_smoothed
90,1,0.0,6.826666666666666,6.826666666666666,0,15,15,ki_chroma
90,2,6.826666666666666,21.226666666666663,14.399999999999997,15,45,30,ki_chroma
90,3,21.226666666666663,28.426666666666666,7.200000000000003,45,60,15,ki_chroma
90,4,28.426666666666666,36.10666666666667,7.680000000000003,60,76,16,ki_chroma
90,5,36.10666666666667,67.78666666666666,31.679999999999993,76,142,66,ki_chroma
90,6,67.78666666666666,97.06666666666666,29.28,142,203,61,ki_chroma
90,7,97.06666666666666,118.66666666666667,21.60000000000001,203,248,45,ki_chroma
90,8,118.66666666666667,125.86666666666666,7.199999999999989,248,263,15,ki_chroma
90,9,125.86666666666666,174.549,48.68233333333335,263,363,100,ki_chroma
90,1,0.0,6.826666666666666,6.826666666666666,0,15,15,ki_chroma_acts
90,2,6.826666666666666,21.226666666666663,14.399999999999997,15,45,30,ki_chroma_acts
90,3,21.226666666666663,28.426666666666666,7.200000000000003,45,60,15,ki_chroma_acts
90,4,28.426666666666666,36.10666666666667,7.680000000000003,60,76,16,ki_chroma_acts
90,5,36.10666666666667,67.78666666666666,31.679999999999993,76,142,66,ki_chroma_acts
90,6,67.78666666666666,97.06666666666666,29.28,142,203,61,ki_chroma_acts
90,7,97.06666666666666,118.66666666666667,21.60000000000001,203,248,45,ki_chroma_acts
90,8,118.66666666666667,125.86666666666666,7.199999999999989,248,263,15,ki_chroma_acts
90,9,125.86666666666666,174.549,48.68233333333335,263,363,100,ki_chroma_acts
90,1,0.0,5.386666666666666,5.386666666666666,0,12,12,ki_chroma_acts_smoothed
90,2,5.386666666666666,21.226666666666663,15.839999999999996,12,45,33,ki_chroma_acts_smoothed
90,3,21.226666666666663,28.426666666666666,7.200000000000003,45,60,15,ki_chroma_acts_smoothed
90,4,28.426666666666666,67.78666666666666,39.36,60,142,82,ki_chroma_acts_smoothed
90,5,67.78666666666666,82.66666666666667,14.88000000000001,142,173,31,ki_chroma_acts_smoothed
90,6,82.66666666666667,97.54666666666667,14.879999999999995,173,204,31,ki_chroma_acts_smoothed
90,7,97.54666666666667,119.14666666666666,21.599999999999994,204,249,45,ki_chroma_acts_smoothed
90,8,119.14666666666666,125.86666666666666,6.719999999999999,249,263,14,ki_chroma_acts_smoothed
90,9,125.86666666666666,174.549,48.68233333333335,263,363,100,ki_chroma_acts_smoothed
91,1,0.0,16.832,16.832,0,36,36,chromagram
91,2,16.832,24.991999999999997,8.159999999999997,36,53,17,chromagram
91,3,24.991999999999997,32.192,7.200000000000003,53,68,15,chromagram
91,4,32.192,61.952,29.759999999999998,68,130,62,chromagram
91,5,61.952,93.152,31.200000000000003,130,195,65,chromagram
91,6,93.152,101.312,8.159999999999997,195,212,17,chromagram
91,7,101.312,105.152,3.8400000000000034,212,220,8,chromagram
91,8,105.152,108.512,3.3599999999999994,220,227,7,chromagram
91,9,108.512,154.286,45.774,227,321,94,chromagram
91,1,0.0,17.311999999999998,17.311999999999998,0,37,37,chroma_acts
91,2,17.311999999999998,24.991999999999997,7.68,37,53,16,chroma_acts
91,3,24.991999999999997,32.192,7.200000000000003,53,68,15,chroma_acts
91,4,32.192,60.51199999999999,28.319999999999993,68,127,59,chroma_acts
91,5,60.51199999999999,93.152,32.64000000000001,127,195,68,chroma_acts
91,6,93.152,101.312,8.159999999999997,195,212,17,chroma_acts
91,7,101.312,105.152,3.8400000000000034,212,220,8,chroma_acts
91,8,105.152,108.512,3.3599999999999994,220,227,7,chroma_acts
91,9,108.512,154.286,45.774,227,321,94,chroma_acts
91,1,0.0,16.832,16.832,0,36,36,chroma_acts_smoothed
91,2,16.832,25.472,8.64,36,54,18,chroma_acts_smoothed
91,3,25.472,32.192,6.719999999999999,54,68,14,chroma_acts_smoothed
91,4,32.192,60.51199999999999,28.319999999999993,68,127,59,chroma_acts_smoothed
91,5,60.51199999999999,93.63199999999999,33.12,127,196,69,chroma_acts_smoothed
91,6,93.63199999999999,101.792,8.16000000000001,196,213,17,chroma_acts_smoothed
91,7,101.792,108.512,6.719999999999999,213,227,14,chroma_acts_smoothed
91,8,108.512,154.286,45.774,227,321,94,chroma_acts_smoothed
91,1,0.0,16.832,16.832,0,36,36,ki_chroma
91,2,16.832,24.991999999999997,8.159999999999997,36,53,17,ki_chroma
91,3,24.991999999999997,32.192,7.200000000000003,53,68,15,ki_chroma
91,4,32.192,61.952,29.759999999999998,68,130,62,ki_chroma
91,5,61.952,93.152,31.200000000000003,130,195,65,ki_chroma
91,6,93.152,101.312,8.159999999999997,195,212,17,ki_chroma
91,7,101.312,105.152,3.8400000000000034,212,220,8,ki_chroma
91,8,105.152,108.512,3.3599999999999994,220,227,7,ki_chroma
91,9,108.512,154.286,45.774,227,321,94,ki_chroma
91,1,0.0,17.311999999999998,17.311999999999998,0,37,37,ki_chroma_acts
91,2,17.311999999999998,24.991999999999997,7.68,37,53,16,ki_chroma_acts
91,3,24.991999999999997,32.192,7.200000000000003,53,68,15,ki_chroma_acts
91,4,32.192,60.51199999999999,28.319999999999993,68,127,59,ki_chroma_acts
91,5,60.51199999999999,93.152,32.64000000000001,127,195,68,ki_chroma_acts
91,6,93.152,101.312,8.159999999999997,195,212,17,ki_chroma_acts
91,7,101.312,105.152,3.8400000000000034,212,220,8,ki_chroma_acts
91,8,105.152,108.512,3.3599999999999994,220,227,7,ki_chroma_acts
91,9,108.512,154.286,45.774,227,321,94,ki_chroma_acts
91,1,0.0,16.832,16.832,0,36,36,ki_chroma_acts_smoothed
91,2,16.832,25.472,8.64,36,54,18,ki_chroma_acts_smoothed
91,3,25.472,32.192,6.719999999999999,54,68,14,ki_chroma_acts_smoothed
91,4,32.192,60.51199999999999,28.319999999999993,68,127,59,ki_chroma_acts_smoothed
91,5,60.51199999999999,93.63199999999999,33.12,127,196,69,ki_chroma_acts_smoothed
91,6,93.63199999999999,101.792,8.16000000000001,196,213,17,ki_chroma_acts_smoothed
91,7,101.792,108.512,6.719999999999999,213,227,14,ki_chroma_acts_smoothed
91,8,108.512,154.286,45.774,227,321,94,ki_chroma_acts_smoothed
92,1,0.0,22.538666666666664,22.538666666666664,0,50,50,chromagram
92,2,22.538666666666664,37.215999999999994,14.67733333333333,50,82,32,chromagram
92,3,37.215999999999994,99.59466666666665,62.37866666666666,82,218,136,chromagram
92,4,99.59466666666665,113.81333333333332,14.218666666666664,218,249,31,chromagram
92,5,113.81333333333332,150.048,36.23466666666668,249,328,79,chromagram
92,6,150.048,164.72533333333334,14.677333333333337,328,360,32,chromagram
92,7,164.72533333333334,178.02666666666667,13.301333333333332,360,389,29,chromagram
92,8,178.02666666666667,241.838,63.81133333333332,389,527,138,chromagram
92,1,0.0,37.215999999999994,37.215999999999994,0,82,82,chroma_acts
92,2,37.215999999999994,99.59466666666665,62.37866666666666,82,218,136,chroma_acts
92,3,99.59466666666665,113.81333333333332,14.218666666666664,218,249,31,chroma_acts
92,4,113.81333333333332,117.48266666666665,3.669333333333327,249,257,8,chroma_acts
92,5,117.48266666666665,150.048,32.565333333333356,257,328,71,chroma_acts
92,6,150.048,164.72533333333334,14.677333333333337,328,360,32,chroma_acts
92,7,164.72533333333334,178.02666666666667,13.301333333333332,360,389,29,chroma_acts
92,8,178.02666666666667,189.03466666666665,11.007999999999981,389,413,24,chroma_acts
92,9,189.03466666666665,241.838,52.80333333333334,413,527,114,chroma_acts
92,1,0.0,22.538666666666664,22.538666666666664,0,50,50,chroma_acts_smoothed
92,2,22.538666666666664,37.67466666666666,15.135999999999996,50,83,33,chroma_acts_smoothed
92,3,37.67466666666666,99.59466666666665,61.919999999999995,83,218,135,chroma_acts_smoothed
92,4,99.59466666666665,113.35466666666665,13.759999999999991,218,248,30,chroma_acts_smoothed
92,5,113.35466666666665,149.58933333333334,36.2346666666667,248,327,79,chroma_acts_smoothed
92,6,149.58933333333334,164.72533333333334,15.135999999999996,327,360,33,chroma_acts_smoothed
92,7,164.72533333333334,178.02666666666667,13.301333333333332,360,389,29,chroma_acts_smoothed
92,8,178.02666666666667,189.4933333333333,11.46666666666664,389,414,25,chroma_acts_smoothed
92,9,189.4933333333333,241.838,52.34466666666668,414,527,113,chroma_acts_smoothed
92,1,0.0,22.538666666666664,22.538666666666664,0,50,50,ki_chroma
92,2,22.538666666666664,37.215999999999994,14.67733333333333,50,82,32,ki_chroma
92,3,37.215999999999994,99.59466666666665,62.37866666666666,82,218,136,ki_chroma
92,4,99.59466666666665,113.81333333333332,14.218666666666664,218,249,31,ki_chroma
92,5,113.81333333333332,150.048,36.23466666666668,249,328,79,ki_chroma
92,6,150.048,164.72533333333334,14.677333333333337,328,360,32,ki_chroma
92,7,164.72533333333334,178.02666666666667,13.301333333333332,360,389,29,ki_chroma
92,8,178.02666666666667,241.838,63.81133333333332,389,527,138,ki_chroma
92,1,0.0,37.215999999999994,37.215999999999994,0,82,82,ki_chroma_acts
92,2,37.215999999999994,99.59466666666665,62.37866666666666,82,218,136,ki_chroma_acts
92,3,99.59466666666665,113.81333333333332,14.218666666666664,218,249,31,ki_chroma_acts
92,4,113.81333333333332,117.48266666666665,3.669333333333327,249,257,8,ki_chroma_acts
92,5,117.48266666666665,150.048,32.565333333333356,257,328,71,ki_chroma_acts
92,6,150.048,164.72533333333334,14.677333333333337,328,360,32,ki_chroma_acts
92,7,164.72533333333334,178.02666666666667,13.301333333333332,360,389,29,ki_chroma_acts
92,8,178.02666666666667,189.03466666666665,11.007999999999981,389,413,24,ki_chroma_acts
92,9,189.03466666666665,241.838,52.80333333333334,413,527,114,ki_chroma_acts
92,1,0.0,22.538666666666664,22.538666666666664,0,50,50,ki_chroma_acts_smoothed
92,2,22.538666666666664,37.67466666666666,15.135999999999996,50,83,33,ki_chroma_acts_smoothed
92,3,37.67466666666666,99.59466666666665,61.919999999999995,83,218,135,ki_chroma_acts_smoothed
92,4,99.59466666666665,113.35466666666665,13.759999999999991,218,248,30,ki_chroma_acts_smoothed
92,5,113.35466666666665,149.58933333333334,36.2346666666667,248,327,79,ki_chroma_acts_smoothed
92,6,149.58933333333334,164.72533333333334,15.135999999999996,327,360,33,ki_chroma_acts_smoothed
92,7,164.72533333333334,178.02666666666667,13.301333333333332,360,389,29,ki_chroma_acts_smoothed
92,8,178.02666666666667,189.4933333333333,11.46666666666664,389,414,25,ki_chroma_acts_smoothed
92,9,189.4933333333333,241.838,52.34466666666668,414,527,113,ki_chroma_acts_smoothed
93,1,0.0,17.493333333333332,17.493333333333332,0,38,38,chromagram
93,2,17.493333333333332,28.288,10.794666666666668,38,61,23,chromagram
93,3,28.288,33.92,5.6320000000000014,61,73,12,chromagram
93,4,33.92,64.896,30.976,73,139,66,chromagram
93,5,64.896,71.46666666666667,6.570666666666668,139,153,14,chromagram
93,6,71.46666666666667,85.07733333333333,13.61066666666666,153,182,29,chromagram
93,7,85.07733333333333,105.25866666666667,20.181333333333342,182,225,43,chromagram
93,8,105.25866666666667,151.875,46.61633333333333,225,323,98,chromagram
93,1,0.0,17.493333333333332,17.493333333333332,0,38,38,chroma_acts
93,2,17.493333333333332,33.92,16.42666666666667,38,73,35,chroma_acts
93,3,33.92,64.896,30.976,73,139,66,chroma_acts
93,4,64.896,85.07733333333333,20.181333333333328,139,182,43,chroma_acts
93,5,85.07733333333333,105.25866666666667,20.181333333333342,182,225,43,chroma_acts
93,6,105.25866666666667,135.296,30.037333333333322,225,289,64,chroma_acts
93,7,135.296,151.875,16.579000000000008,289,323,34,chroma_acts
93,1,0.0,19.370666666666665,19.370666666666665,0,42,42,chroma_acts_smoothed
93,2,19.370666666666665,33.92,14.549333333333337,42,73,31,chroma_acts_smoothed
93,3,33.92,64.896,30.976,73,139,66,chroma_acts_smoothed
93,4,64.896,75.22133333333333,10.325333333333333,139,161,22,chroma_acts_smoothed
93,5,75.22133333333333,86.48533333333333,11.263999999999996,161,185,24,chroma_acts_smoothed
93,6,86.48533333333333,104.78933333333333,18.304000000000002,185,224,39,chroma_acts_smoothed
93,7,104.78933333333333,151.875,47.08566666666667,224,323,99,chroma_acts_smoothed
93,1,0.0,17.493333333333332,17.493333333333332,0,38,38,ki_chroma
93,2,17.493333333333332,28.288,10.794666666666668,38,61,23,ki_chroma
93,3,28.288,33.92,5.6320000000000014,61,73,12,ki_chroma
93,4,33.92,64.896,30.976,73,139,66,ki_chroma
93,5,64.896,71.46666666666667,6.570666666666668,139,153,14,ki_chroma
93,6,71.46666666666667,85.07733333333333,13.61066666666666,153,182,29,ki_chroma
93,7,85.07733333333333,105.25866666666667,20.181333333333342,182,225,43,ki_chroma
93,8,105.25866666666667,151.875,46.61633333333333,225,323,98,ki_chroma
93,1,0.0,17.493333333333332,17.493333333333332,0,38,38,ki_chroma_acts
93,2,17.493333333333332,33.92,16.42666666666667,38,73,35,ki_chroma_acts
93,3,33.92,64.896,30.976,73,139,66,ki_chroma_acts
93,4,64.896,85.07733333333333,20.181333333333328,139,182,43,ki_chroma_acts
93,5,85.07733333333333,105.25866666666667,20.181333333333342,182,225,43,ki_chroma_acts
93,6,105.25866666666667,135.296,30.037333333333322,225,289,64,ki_chroma_acts
93,7,135.296,151.875,16.579000000000008,289,323,34,ki_chroma_acts
93,1,0.0,19.370666666666665,19.370666666666665,0,42,42,ki_chroma_acts_smoothed
93,2,19.370666666666665,33.92,14.549333333333337,42,73,31,ki_chroma_acts_smoothed
93,3,33.92,64.896,30.976,73,139,66,ki_chroma_acts_smoothed
93,4,64.896,75.22133333333333,10.325333333333333,139,161,22,ki_chroma_acts_smoothed
93,5,75.22133333333333,86.48533333333333,11.263999999999996,161,185,24,ki_chroma_acts_smoothed
93,6,86.48533333333333,104.78933333333333,18.304000000000002,185,224,39,ki_chroma_acts_smoothed
93,7,104.78933333333333,151.875,47.08566666666667,224,323,99,ki_chroma_acts_smoothed
95,1,0.0,6.1226666666666665,6.1226666666666665,0,14,14,chromagram
95,2,6.1226666666666665,9.877333333333333,3.754666666666666,14,22,8,chromagram
95,3,9.877333333333333,13.632,3.754666666666667,22,30,8,chromagram
95,4,13.632,17.386666666666667,3.754666666666667,30,38,8,chromagram
95,5,17.386666666666667,47.424,30.037333333333333,38,102,64,chromagram
95,6,47.424,76.99199999999999,29.56799999999999,102,165,63,chromagram
95,7,76.99199999999999,120.17066666666666,43.17866666666667,165,257,92,chromagram
95,8,120.17066666666666,137.06666666666666,16.896,257,293,36,chromagram
95,9,137.06666666666666,184.291,47.224333333333334,293,392,99,chromagram
95,1,0.0,6.1226666666666665,6.1226666666666665,0,14,14,chroma_acts
95,2,6.1226666666666665,9.877333333333333,3.754666666666666,14,22,8,chroma_acts
95,3,9.877333333333333,13.632,3.754666666666667,22,30,8,chroma_acts
95,4,13.632,17.386666666666667,3.754666666666667,30,38,8,chroma_acts
95,5,17.386666666666667,47.424,30.037333333333333,38,102,64,chroma_acts
95,6,47.424,76.99199999999999,29.56799999999999,102,165,63,chroma_acts
95,7,76.99199999999999,120.17066666666666,43.17866666666667,165,257,92,chroma_acts
95,8,120.17066666666666,137.06666666666666,16.896,257,293,36,chroma_acts
95,9,137.06666666666666,184.291,47.224333333333334,293,392,99,chroma_acts
95,1,0.0,6.1226666666666665,6.1226666666666665,0,14,14,chroma_acts_smoothed
95,2,6.1226666666666665,9.877333333333333,3.754666666666666,14,22,8,chroma_acts_smoothed
95,3,9.877333333333333,13.632,3.754666666666667,22,30,8,chroma_acts_smoothed
95,4,13.632,17.386666666666667,3.754666666666667,30,38,8,chroma_acts_smoothed
95,5,17.386666666666667,47.424,30.037333333333333,38,102,64,chroma_acts_smoothed
95,6,47.424,76.99199999999999,29.56799999999999,102,165,63,chroma_acts_smoothed
95,7,76.99199999999999,120.17066666666666,43.17866666666667,165,257,92,chroma_acts_smoothed
95,8,120.17066666666666,137.06666666666666,16.896,257,293,36,chroma_acts_smoothed
95,9,137.06666666666666,184.291,47.224333333333334,293,392,99,chroma_acts_smoothed
95,1,0.0,6.1226666666666665,6.1226666666666665,0,14,14,ki_chroma
95,2,6.1226666666666665,9.877333333333333,3.754666666666666,14,22,8,ki_chroma
95,3,9.877333333333333,13.632,3.754666666666667,22,30,8,ki_chroma
95,4,13.632,17.386666666666667,3.754666666666667,30,38,8,ki_chroma
95,5,17.386666666666667,47.424,30.037333333333333,38,102,64,ki_chroma
95,6,47.424,76.99199999999999,29.56799999999999,102,165,63,ki_chroma
95,7,76.99199999999999,120.17066666666666,43.17866666666667,165,257,92,ki_chroma
95,8,120.17066666666666,137.06666666666666,16.896,257,293,36,ki_chroma
95,9,137.06666666666666,184.291,47.224333333333334,293,392,99,ki_chroma
95,1,0.0,6.1226666666666665,6.1226666666666665,0,14,14,ki_chroma_acts
95,2,6.1226666666666665,9.877333333333333,3.754666666666666,14,22,8,ki_chroma_acts
95,3,9.877333333333333,13.632,3.754666666666667,22,30,8,ki_chroma_acts
95,4,13.632,17.386666666666667,3.754666666666667,30,38,8,ki_chroma_acts
95,5,17.386666666666667,47.424,30.037333333333333,38,102,64,ki_chroma_acts
95,6,47.424,76.99199999999999,29.56799999999999,102,165,63,ki_chroma_acts
95,7,76.99199999999999,120.17066666666666,43.17866666666667,165,257,92,ki_chroma_acts
95,8,120.17066666666666,137.06666666666666,16.896,257,293,36,ki_chroma_acts
95,9,137.06666666666666,184.291,47.224333333333334,293,392,99,ki_chroma_acts
95,1,0.0,6.1226666666666665,6.1226666666666665,0,14,14,ki_chroma_acts_smoothed
95,2,6.1226666666666665,9.877333333333333,3.754666666666666,14,22,8,ki_chroma_acts_smoothed
95,3,9.877333333333333,13.632,3.754666666666667,22,30,8,ki_chroma_acts_smoothed
95,4,13.632,17.386666666666667,3.754666666666667,30,38,8,ki_chroma_acts_smoothed
95,5,17.386666666666667,47.424,30.037333333333333,38,102,64,ki_chroma_acts_smoothed
95,6,47.424,76.99199999999999,29.56799999999999,102,165,63,ki_chroma_acts_smoothed
95,7,76.99199999999999,120.17066666666666,43.17866666666667,165,257,92,ki_chroma_acts_smoothed
95,8,120.17066666666666,137.06666666666666,16.896,257,293,36,ki_chroma_acts_smoothed
95,9,137.06666666666666,184.291,47.224333333333334,293,392,99,ki_chroma_acts_smoothed
98,1,0.0,25.162666666666667,25.162666666666667,0,54,54,chromagram
98,2,25.162666666666667,40.650666666666666,15.488,54,87,33,chromagram
98,3,40.650666666666666,70.688,30.037333333333336,87,151,64,chromagram
98,4,70.688,100.72533333333332,30.037333333333322,151,215,64,chromagram
98,5,100.72533333333332,130.7626666666667,30.037333333333365,215,279,64,chromagram
98,6,130.7626666666667,144.37333333333333,13.610666666666646,279,308,29,chromagram
98,7,144.37333333333333,160.33066666666667,15.957333333333338,308,342,34,chromagram
98,8,160.33066666666667,206.745,46.41433333333333,342,439,97,chromagram
98,1,0.0,9.674666666666667,9.674666666666667,0,21,21,chroma_acts
98,2,9.674666666666667,25.162666666666667,15.488,21,54,33,chroma_acts
98,3,25.162666666666667,40.18133333333333,15.018666666666661,54,86,32,chroma_acts
98,4,40.18133333333333,67.872,27.690666666666672,86,145,59,chroma_acts
98,5,67.872,100.72533333333332,32.853333333333325,145,215,70,chroma_acts
98,6,100.72533333333332,131.232,30.506666666666675,215,280,65,chroma_acts
98,7,131.232,144.37333333333333,13.141333333333336,280,308,28,chroma_acts
98,8,144.37333333333333,161.26933333333335,16.896000000000015,308,344,36,chroma_acts
98,9,161.26933333333335,206.745,45.475666666666655,344,439,95,chroma_acts
98,1,0.0,26.101333333333333,26.101333333333333,0,56,56,chroma_acts_smoothed
98,2,26.101333333333333,41.12,15.018666666666665,56,88,32,chroma_acts_smoothed
98,3,41.12,67.872,26.752000000000002,88,145,57,chroma_acts_smoothed
98,4,67.872,101.19466666666666,33.32266666666666,145,216,71,chroma_acts_smoothed
98,5,101.19466666666666,130.7626666666667,29.568000000000026,216,279,63,chroma_acts_smoothed
98,6,130.7626666666667,144.37333333333333,13.610666666666646,279,308,29,chroma_acts_smoothed
98,7,144.37333333333333,161.26933333333335,16.896000000000015,308,344,36,chroma_acts_smoothed
98,8,161.26933333333335,206.745,45.475666666666655,344,439,95,chroma_acts_smoothed
98,1,0.0,25.162666666666667,25.162666666666667,0,54,54,ki_chroma
98,2,25.162666666666667,40.650666666666666,15.488,54,87,33,ki_chroma
98,3,40.650666666666666,70.688,30.037333333333336,87,151,64,ki_chroma
98,4,70.688,100.72533333333332,30.037333333333322,151,215,64,ki_chroma
98,5,100.72533333333332,130.7626666666667,30.037333333333365,215,279,64,ki_chroma
98,6,130.7626666666667,144.37333333333333,13.610666666666646,279,308,29,ki_chroma
98,7,144.37333333333333,160.33066666666667,15.957333333333338,308,342,34,ki_chroma
98,8,160.33066666666667,206.745,46.41433333333333,342,439,97,ki_chroma
98,1,0.0,9.674666666666667,9.674666666666667,0,21,21,ki_chroma_acts
98,2,9.674666666666667,25.162666666666667,15.488,21,54,33,ki_chroma_acts
98,3,25.162666666666667,40.18133333333333,15.018666666666661,54,86,32,ki_chroma_acts
98,4,40.18133333333333,67.872,27.690666666666672,86,145,59,ki_chroma_acts
98,5,67.872,100.72533333333332,32.853333333333325,145,215,70,ki_chroma_acts
98,6,100.72533333333332,131.232,30.506666666666675,215,280,65,ki_chroma_acts
98,7,131.232,144.37333333333333,13.141333333333336,280,308,28,ki_chroma_acts
98,8,144.37333333333333,161.26933333333335,16.896000000000015,308,344,36,ki_chroma_acts
98,9,161.26933333333335,206.745,45.475666666666655,344,439,95,ki_chroma_acts
98,1,0.0,26.101333333333333,26.101333333333333,0,56,56,ki_chroma_acts_smoothed
98,2,26.101333333333333,41.12,15.018666666666665,56,88,32,ki_chroma_acts_smoothed
98,3,41.12,67.872,26.752000000000002,88,145,57,ki_chroma_acts_smoothed
98,4,67.872,101.19466666666666,33.32266666666666,145,216,71,ki_chroma_acts_smoothed
98,5,101.19466666666666,130.7626666666667,29.568000000000026,216,279,63,ki_chroma_acts_smoothed
98,6,130.7626666666667,144.37333333333333,13.610666666666646,279,308,29,ki_chroma_acts_smoothed
98,7,144.37333333333333,161.26933333333335,16.896000000000015,308,344,36,ki_chroma_acts_smoothed
98,8,161.26933333333335,206.745,45.475666666666655,344,439,95,ki_chroma_acts_smoothed
99,1,0.0,14.431999999999999,14.431999999999999,0,31,31,chromagram
99,2,14.431999999999999,30.272,15.84,31,64,33,chromagram
99,3,30.272,59.071999999999996,28.799999999999997,64,124,60,chromagram
99,4,59.071999999999996,75.872,16.800000000000004,124,159,35,chromagram
99,5,75.872,104.672,28.799999999999997,159,219,60,chromagram
99,6,104.672,121.952,17.28,219,255,36,chromagram
99,7,121.952,136.35199999999998,14.399999999999977,255,285,30,chromagram
99,8,136.35199999999998,152.19199999999998,15.840000000000003,285,318,33,chromagram
99,9,152.19199999999998,184.762,32.57000000000002,318,384,66,chromagram
99,1,0.0,14.431999999999999,14.431999999999999,0,31,31,chroma_acts
99,2,14.431999999999999,30.272,15.84,31,64,33,chroma_acts
99,3,30.272,59.071999999999996,28.799999999999997,64,124,60,chroma_acts
99,4,59.071999999999996,75.872,16.800000000000004,124,159,35,chroma_acts
99,5,75.872,104.672,28.799999999999997,159,219,60,chroma_acts
99,6,104.672,121.952,17.28,219,255,36,chroma_acts
99,7,121.952,136.35199999999998,14.399999999999977,255,285,30,chroma_acts
99,8,136.35199999999998,152.19199999999998,15.840000000000003,285,318,33,chroma_acts
99,9,152.19199999999998,184.762,32.57000000000002,318,384,66,chroma_acts
99,1,0.0,14.431999999999999,14.431999999999999,0,31,31,chroma_acts_smoothed
99,2,14.431999999999999,30.272,15.84,31,64,33,chroma_acts_smoothed
99,3,30.272,59.071999999999996,28.799999999999997,64,124,60,chroma_acts_smoothed
99,4,59.071999999999996,75.872,16.800000000000004,124,159,35,chroma_acts_smoothed
99,5,75.872,104.672,28.799999999999997,159,219,60,chroma_acts_smoothed
99,6,104.672,123.392,18.72,219,258,39,chroma_acts_smoothed
99,7,123.392,136.35199999999998,12.95999999999998,258,285,27,chroma_acts_smoothed
99,8,136.35199999999998,152.19199999999998,15.840000000000003,285,318,33,chroma_acts_smoothed
99,9,152.19199999999998,184.762,32.57000000000002,318,384,66,chroma_acts_smoothed
99,1,0.0,14.431999999999999,14.431999999999999,0,31,31,ki_chroma
99,2,14.431999999999999,30.272,15.84,31,64,33,ki_chroma
99,3,30.272,59.071999999999996,28.799999999999997,64,124,60,ki_chroma
99,4,59.071999999999996,75.872,16.800000000000004,124,159,35,ki_chroma
99,5,75.872,104.672,28.799999999999997,159,219,60,ki_chroma
99,6,104.672,121.952,17.28,219,255,36,ki_chroma
99,7,121.952,136.35199999999998,14.399999999999977,255,285,30,ki_chroma
99,8,136.35199999999998,152.19199999999998,15.840000000000003,285,318,33,ki_chroma
99,9,152.19199999999998,184.762,32.57000000000002,318,384,66,ki_chroma
99,1,0.0,14.431999999999999,14.431999999999999,0,31,31,ki_chroma_acts
99,2,14.431999999999999,30.272,15.84,31,64,33,ki_chroma_acts
99,3,30.272,59.071999999999996,28.799999999999997,64,124,60,ki_chroma_acts
99,4,59.071999999999996,75.872,16.800000000000004,124,159,35,ki_chroma_acts
99,5,75.872,104.672,28.799999999999997,159,219,60,ki_chroma_acts
99,6,104.672,121.952,17.28,219,255,36,ki_chroma_acts
99,7,121.952,136.35199999999998,14.399999999999977,255,285,30,ki_chroma_acts
99,8,136.35199999999998,152.19199999999998,15.840000000000003,285,318,33,ki_chroma_acts
99,9,152.19199999999998,184.762,32.57000000000002,318,384,66,ki_chroma_acts
99,1,0.0,14.431999999999999,14.431999999999999,0,31,31,ki_chroma_acts_smoothed
99,2,14.431999999999999,30.272,15.84,31,64,33,ki_chroma_acts_smoothed
99,3,30.272,59.071999999999996,28.799999999999997,64,124,60,ki_chroma_acts_smoothed
99,4,59.071999999999996,75.872,16.800000000000004,124,159,35,ki_chroma_acts_smoothed
99,5,75.872,104.672,28.799999999999997,159,219,60,ki_chroma_acts_smoothed
99,6,104.672,123.392,18.72,219,258,39,ki_chroma_acts_smoothed
99,7,123.392,136.35199999999998,12.95999999999998,258,285,27,ki_chroma_acts_smoothed
99,8,136.35199999999998,152.19199999999998,15.840000000000003,285,318,33,ki_chroma_acts_smoothed
99,9,152.19199999999998,184.762,32.57000000000002,318,384,66,ki_chroma_acts_smoothed
101,1,0.0,12.661333333333332,12.661333333333332,0,25,25,chromagram
101,2,12.661333333333332,35.135999999999996,22.474666666666664,25,68,43,chromagram
101,3,35.135999999999996,49.77066666666666,14.634666666666668,68,96,28,chromagram
101,4,49.77066666666666,80.60799999999999,30.837333333333326,96,155,59,chromagram
101,5,80.60799999999999,114.05866666666665,33.45066666666666,155,219,64,chromagram
101,6,114.05866666666665,132.35199999999998,18.293333333333322,219,254,35,chromagram
101,7,132.35199999999998,182.0053333333333,49.653333333333336,254,349,95,chromagram
101,8,182.0053333333333,194.592,12.586666666666702,349,372,23,chromagram
101,1,0.0,10.570666666666666,10.570666666666666,0,21,21,chroma_acts
101,2,10.570666666666666,95.24266666666666,84.672,21,183,162,chroma_acts
101,3,95.24266666666666,97.33333333333333,2.090666666666664,183,187,4,chroma_acts
101,4,97.33333333333333,114.05866666666665,16.725333333333325,187,219,32,chroma_acts
101,5,114.05866666666665,132.35199999999998,18.293333333333322,219,254,35,chroma_acts
101,6,132.35199999999998,182.528,50.176000000000016,254,350,96,chroma_acts
101,7,182.528,187.23199999999997,4.703999999999979,350,359,9,chroma_acts
101,8,187.23199999999997,194.592,7.360000000000042,359,372,13,chroma_acts
101,1,0.0,14.751999999999997,14.751999999999997,0,29,29,chroma_acts_smoothed
101,2,14.751999999999997,35.135999999999996,20.384,29,68,39,chroma_acts_smoothed
101,3,35.135999999999996,45.58933333333333,10.453333333333333,68,88,20,chroma_acts_smoothed
101,4,45.58933333333333,97.33333333333333,51.744,88,187,99,chroma_acts_smoothed
101,5,97.33333333333333,114.05866666666665,16.725333333333325,187,219,32,chroma_acts_smoothed
101,6,114.05866666666665,132.35199999999998,18.293333333333322,219,254,35,chroma_acts_smoothed
101,7,132.35199999999998,182.0053333333333,49.653333333333336,254,349,95,chroma_acts_smoothed
101,8,182.0053333333333,194.592,12.586666666666702,349,372,23,chroma_acts_smoothed
101,1,0.0,12.661333333333332,12.661333333333332,0,25,25,ki_chroma
101,2,12.661333333333332,35.135999999999996,22.474666666666664,25,68,43,ki_chroma
101,3,35.135999999999996,49.77066666666666,14.634666666666668,68,96,28,ki_chroma
101,4,49.77066666666666,80.60799999999999,30.837333333333326,96,155,59,ki_chroma
101,5,80.60799999999999,114.05866666666665,33.45066666666666,155,219,64,ki_chroma
101,6,114.05866666666665,132.35199999999998,18.293333333333322,219,254,35,ki_chroma
101,7,132.35199999999998,182.0053333333333,49.653333333333336,254,349,95,ki_chroma
101,8,182.0053333333333,194.592,12.586666666666702,349,372,23,ki_chroma
101,1,0.0,10.570666666666666,10.570666666666666,0,21,21,ki_chroma_acts
101,2,10.570666666666666,95.24266666666666,84.672,21,183,162,ki_chroma_acts
101,3,95.24266666666666,97.33333333333333,2.090666666666664,183,187,4,ki_chroma_acts
101,4,97.33333333333333,114.05866666666665,16.725333333333325,187,219,32,ki_chroma_acts
101,5,114.05866666666665,132.35199999999998,18.293333333333322,219,254,35,ki_chroma_acts
101,6,132.35199999999998,182.528,50.176000000000016,254,350,96,ki_chroma_acts
101,7,182.528,187.23199999999997,4.703999999999979,350,359,9,ki_chroma_acts
101,8,187.23199999999997,194.592,7.360000000000042,359,372,13,ki_chroma_acts
101,1,0.0,14.751999999999997,14.751999999999997,0,29,29,ki_chroma_acts_smoothed
101,2,14.751999999999997,35.135999999999996,20.384,29,68,39,ki_chroma_acts_smoothed
101,3,35.135999999999996,45.58933333333333,10.453333333333333,68,88,20,ki_chroma_acts_smoothed
101,4,45.58933333333333,97.33333333333333,51.744,88,187,99,ki_chroma_acts_smoothed
101,5,97.33333333333333,114.05866666666665,16.725333333333325,187,219,32,ki_chroma_acts_smoothed
101,6,114.05866666666665,132.35199999999998,18.293333333333322,219,254,35,ki_chroma_acts_smoothed
101,7,132.35199999999998,182.0053333333333,49.653333333333336,254,349,95,ki_chroma_acts_smoothed
101,8,182.0053333333333,194.592,12.586666666666702,349,372,23,ki_chroma_acts_smoothed
102,1,0.0,46.35733333333333,46.35733333333333,0,97,97,chromagram
102,2,46.35733333333333,54.03733333333333,7.68,97,113,16,chromagram
102,3,54.03733333333333,69.39733333333334,15.360000000000007,113,145,32,chromagram
102,4,69.39733333333334,83.79733333333333,14.399999999999991,145,175,30,chromagram
102,5,83.79733333333333,107.79733333333333,24.0,175,225,50,chromagram
102,6,107.79733333333333,153.39733333333334,45.60000000000001,225,320,95,chromagram
102,7,153.39733333333334,184.59733333333332,31.19999999999999,320,385,65,chromagram
102,8,184.59733333333332,191.7973333333333,7.199999999999989,385,400,15,chromagram
102,9,191.7973333333333,238.584,46.78666666666669,400,496,96,chromagram
102,1,0.0,46.35733333333333,46.35733333333333,0,97,97,chroma_acts
102,2,46.35733333333333,54.03733333333333,7.68,97,113,16,chroma_acts
102,3,54.03733333333333,84.75733333333332,30.71999999999999,113,177,64,chroma_acts
102,4,84.75733333333332,107.79733333333333,23.040000000000006,177,225,48,chroma_acts
102,5,107.79733333333333,157.23733333333334,49.44000000000001,225,328,103,chroma_acts
102,6,157.23733333333334,176.43733333333333,19.19999999999999,328,368,40,chroma_acts
102,7,176.43733333333333,184.59733333333332,8.159999999999997,368,385,17,chroma_acts
102,8,184.59733333333332,192.27733333333333,7.680000000000007,385,401,16,chroma_acts
102,9,192.27733333333333,238.584,46.30666666666667,401,496,95,chroma_acts
102,1,0.0,46.837333333333326,46.837333333333326,0,98,98,chroma_acts_smoothed
102,2,46.837333333333326,54.03733333333333,7.200000000000003,98,113,15,chroma_acts_smoothed
102,3,54.03733333333333,84.75733333333332,30.71999999999999,113,177,64,chroma_acts_smoothed
102,4,84.75733333333332,108.27733333333333,23.52000000000001,177,226,49,chroma_acts_smoothed
102,5,108.27733333333333,157.23733333333334,48.96000000000001,226,328,102,chroma_acts_smoothed
102,6,157.23733333333334,176.91733333333332,19.67999999999998,328,369,41,chroma_acts_smoothed
102,7,176.91733333333332,185.0773333333333,8.159999999999997,369,386,17,chroma_acts_smoothed
102,8,185.0773333333333,192.27733333333333,7.200000000000017,386,401,15,chroma_acts_smoothed
102,9,192.27733333333333,238.584,46.30666666666667,401,496,95,chroma_acts_smoothed
102,1,0.0,46.35733333333333,46.35733333333333,0,97,97,ki_chroma
102,2,46.35733333333333,54.03733333333333,7.68,97,113,16,ki_chroma
102,3,54.03733333333333,69.39733333333334,15.360000000000007,113,145,32,ki_chroma
102,4,69.39733333333334,83.79733333333333,14.399999999999991,145,175,30,ki_chroma
102,5,83.79733333333333,107.79733333333333,24.0,175,225,50,ki_chroma
102,6,107.79733333333333,153.39733333333334,45.60000000000001,225,320,95,ki_chroma
102,7,153.39733333333334,184.59733333333332,31.19999999999999,320,385,65,ki_chroma
102,8,184.59733333333332,191.7973333333333,7.199999999999989,385,400,15,ki_chroma
102,9,191.7973333333333,238.584,46.78666666666669,400,496,96,ki_chroma
102,1,0.0,46.35733333333333,46.35733333333333,0,97,97,ki_chroma_acts
102,2,46.35733333333333,54.03733333333333,7.68,97,113,16,ki_chroma_acts
102,3,54.03733333333333,84.75733333333332,30.71999999999999,113,177,64,ki_chroma_acts
102,4,84.75733333333332,107.79733333333333,23.040000000000006,177,225,48,ki_chroma_acts
102,5,107.79733333333333,157.23733333333334,49.44000000000001,225,328,103,ki_chroma_acts
102,6,157.23733333333334,176.43733333333333,19.19999999999999,328,368,40,ki_chroma_acts
102,7,176.43733333333333,184.59733333333332,8.159999999999997,368,385,17,ki_chroma_acts
102,8,184.59733333333332,192.27733333333333,7.680000000000007,385,401,16,ki_chroma_acts
102,9,192.27733333333333,238.584,46.30666666666667,401,496,95,ki_chroma_acts
102,1,0.0,46.837333333333326,46.837333333333326,0,98,98,ki_chroma_acts_smoothed
102,2,46.837333333333326,54.03733333333333,7.200000000000003,98,113,15,ki_chroma_acts_smoothed
102,3,54.03733333333333,84.75733333333332,30.71999999999999,113,177,64,ki_chroma_acts_smoothed
102,4,84.75733333333332,108.27733333333333,23.52000000000001,177,226,49,ki_chroma_acts_smoothed
102,5,108.27733333333333,157.23733333333334,48.96000000000001,226,328,102,ki_chroma_acts_smoothed
102,6,157.23733333333334,176.91733333333332,19.67999999999998,328,369,41,ki_chroma_acts_smoothed
102,7,176.91733333333332,185.0773333333333,8.159999999999997,369,386,17,ki_chroma_acts_smoothed
102,8,185.0773333333333,192.27733333333333,7.200000000000017,386,401,15,ki_chroma_acts_smoothed
102,9,192.27733333333333,238.584,46.30666666666667,401,496,95,ki_chroma_acts_smoothed
103,1,0.0,18.293333333333333,18.293333333333333,0,39,39,chromagram
103,2,18.293333333333333,26.45333333333333,8.159999999999997,39,56,17,chromagram
103,3,26.45333333333333,31.73333333333333,5.280000000000001,56,67,11,chromagram
103,4,31.73333333333333,46.61333333333334,14.880000000000006,67,98,31,chromagram
103,5,46.61333333333334,109.49333333333333,62.87999999999999,98,229,131,chromagram
103,6,109.49333333333333,147.89333333333332,38.39999999999999,229,309,80,chromagram
103,7,147.89333333333332,230.334,82.44066666666669,309,479,170,chromagram
103,1,0.0,18.293333333333333,18.293333333333333,0,39,39,chroma_acts
103,2,18.293333333333333,24.05333333333333,5.759999999999998,39,51,12,chroma_acts
103,3,24.05333333333333,31.73333333333333,7.68,51,67,16,chroma_acts
103,4,31.73333333333333,46.61333333333334,14.880000000000006,67,98,31,chroma_acts
103,5,46.61333333333334,109.01333333333334,62.4,98,228,130,chroma_acts
103,6,109.01333333333334,147.89333333333332,38.87999999999998,228,309,81,chroma_acts
103,7,147.89333333333332,230.334,82.44066666666669,309,479,170,chroma_acts
103,1,0.0,18.293333333333333,18.293333333333333,0,39,39,chroma_acts_smoothed
103,2,18.293333333333333,26.45333333333333,8.159999999999997,39,56,17,chroma_acts_smoothed
103,3,26.45333333333333,31.73333333333333,5.280000000000001,56,67,11,chroma_acts_smoothed
103,4,31.73333333333333,47.093333333333334,15.360000000000003,67,99,32,chroma_acts_smoothed
103,5,47.093333333333334,109.49333333333333,62.39999999999999,99,229,130,chroma_acts_smoothed
103,6,109.49333333333333,147.89333333333332,38.39999999999999,229,309,80,chroma_acts_smoothed
103,7,147.89333333333332,230.334,82.44066666666669,309,479,170,chroma_acts_smoothed
103,1,0.0,18.293333333333333,18.293333333333333,0,39,39,ki_chroma
103,2,18.293333333333333,26.45333333333333,8.159999999999997,39,56,17,ki_chroma
103,3,26.45333333333333,31.73333333333333,5.280000000000001,56,67,11,ki_chroma
103,4,31.73333333333333,46.61333333333334,14.880000000000006,67,98,31,ki_chroma
103,5,46.61333333333334,109.49333333333333,62.87999999999999,98,229,131,ki_chroma
103,6,109.49333333333333,147.89333333333332,38.39999999999999,229,309,80,ki_chroma
103,7,147.89333333333332,230.334,82.44066666666669,309,479,170,ki_chroma
103,1,0.0,18.293333333333333,18.293333333333333,0,39,39,ki_chroma_acts
103,2,18.293333333333333,24.05333333333333,5.759999999999998,39,51,12,ki_chroma_acts
103,3,24.05333333333333,31.73333333333333,7.68,51,67,16,ki_chroma_acts
103,4,31.73333333333333,46.61333333333334,14.880000000000006,67,98,31,ki_chroma_acts
103,5,46.61333333333334,109.01333333333334,62.4,98,228,130,ki_chroma_acts
103,6,109.01333333333334,147.89333333333332,38.87999999999998,228,309,81,ki_chroma_acts
103,7,147.89333333333332,230.334,82.44066666666669,309,479,170,ki_chroma_acts
103,1,0.0,18.293333333333333,18.293333333333333,0,39,39,ki_chroma_acts_smoothed
103,2,18.293333333333333,26.45333333333333,8.159999999999997,39,56,17,ki_chroma_acts_smoothed
103,3,26.45333333333333,31.73333333333333,5.280000000000001,56,67,11,ki_chroma_acts_smoothed
103,4,31.73333333333333,47.093333333333334,15.360000000000003,67,99,32,ki_chroma_acts_smoothed
103,5,47.093333333333334,109.49333333333333,62.39999999999999,99,229,130,ki_chroma_acts_smoothed
103,6,109.49333333333333,147.89333333333332,38.39999999999999,229,309,80,ki_chroma_acts_smoothed
103,7,147.89333333333332,230.334,82.44066666666669,309,479,170,ki_chroma_acts_smoothed
104,1,0.0,19.765333333333334,19.765333333333334,0,42,42,chromagram
104,2,19.765333333333334,72.56533333333333,52.8,42,152,110,chromagram
104,3,72.56533333333333,91.76533333333333,19.200000000000003,152,192,40,chromagram
104,4,91.76533333333333,95.60533333333332,3.839999999999989,192,200,8,chromagram
104,5,95.60533333333332,164.72533333333334,69.12000000000002,200,344,144,chromagram
104,6,164.72533333333334,183.92533333333333,19.19999999999999,344,384,40,chromagram
104,7,183.92533333333333,187.76533333333333,3.8400000000000034,384,392,8,chromagram
104,8,187.76533333333333,198.32533333333333,10.560000000000002,392,414,22,chromagram
104,9,198.32533333333333,206.999,8.673666666666662,414,431,17,chromagram
104,1,0.0,72.56533333333333,72.56533333333333,0,152,152,chroma_acts
104,2,72.56533333333333,91.76533333333333,19.200000000000003,152,192,40,chroma_acts
104,3,91.76533333333333,95.60533333333332,3.839999999999989,192,200,8,chroma_acts
104,4,95.60533333333332,109.04533333333332,13.439999999999998,200,228,28,chroma_acts
104,5,109.04533333333332,164.72533333333334,55.68000000000002,228,344,116,chroma_acts
104,6,164.72533333333334,182.96533333333335,18.24000000000001,344,382,38,chroma_acts
104,7,182.96533333333335,187.76533333333333,4.799999999999983,382,392,10,chroma_acts
104,8,187.76533333333333,198.32533333333333,10.560000000000002,392,414,22,chroma_acts
104,9,198.32533333333333,206.999,8.673666666666662,414,431,17,chroma_acts
104,1,0.0,72.56533333333333,72.56533333333333,0,152,152,chroma_acts_smoothed
104,2,72.56533333333333,90.80533333333332,18.239999999999995,152,190,38,chroma_acts_smoothed
104,3,90.80533333333332,109.04533333333332,18.239999999999995,190,228,38,chroma_acts_smoothed
104,4,109.04533333333332,130.16533333333334,21.12000000000002,228,272,44,chroma_acts_smoothed
104,5,130.16533333333334,164.72533333333334,34.56,272,344,72,chroma_acts_smoothed
104,6,164.72533333333334,182.96533333333335,18.24000000000001,344,382,38,chroma_acts_smoothed
104,7,182.96533333333335,187.76533333333333,4.799999999999983,382,392,10,chroma_acts_smoothed
104,8,187.76533333333333,198.32533333333333,10.560000000000002,392,414,22,chroma_acts_smoothed
104,9,198.32533333333333,206.999,8.673666666666662,414,431,17,chroma_acts_smoothed
104,1,0.0,19.765333333333334,19.765333333333334,0,42,42,ki_chroma
104,2,19.765333333333334,72.56533333333333,52.8,42,152,110,ki_chroma
104,3,72.56533333333333,91.76533333333333,19.200000000000003,152,192,40,ki_chroma
104,4,91.76533333333333,95.60533333333332,3.839999999999989,192,200,8,ki_chroma
104,5,95.60533333333332,164.72533333333334,69.12000000000002,200,344,144,ki_chroma
104,6,164.72533333333334,183.92533333333333,19.19999999999999,344,384,40,ki_chroma
104,7,183.92533333333333,187.76533333333333,3.8400000000000034,384,392,8,ki_chroma
104,8,187.76533333333333,198.32533333333333,10.560000000000002,392,414,22,ki_chroma
104,9,198.32533333333333,206.999,8.673666666666662,414,431,17,ki_chroma
104,1,0.0,72.56533333333333,72.56533333333333,0,152,152,ki_chroma_acts
104,2,72.56533333333333,91.76533333333333,19.200000000000003,152,192,40,ki_chroma_acts
104,3,91.76533333333333,95.60533333333332,3.839999999999989,192,200,8,ki_chroma_acts
104,4,95.60533333333332,109.04533333333332,13.439999999999998,200,228,28,ki_chroma_acts
104,5,109.04533333333332,164.72533333333334,55.68000000000002,228,344,116,ki_chroma_acts
104,6,164.72533333333334,182.96533333333335,18.24000000000001,344,382,38,ki_chroma_acts
104,7,182.96533333333335,187.76533333333333,4.799999999999983,382,392,10,ki_chroma_acts
104,8,187.76533333333333,198.32533333333333,10.560000000000002,392,414,22,ki_chroma_acts
104,9,198.32533333333333,206.999,8.673666666666662,414,431,17,ki_chroma_acts
104,1,0.0,72.56533333333333,72.56533333333333,0,152,152,ki_chroma_acts_smoothed
104,2,72.56533333333333,90.80533333333332,18.239999999999995,152,190,38,ki_chroma_acts_smoothed
104,3,90.80533333333332,109.04533333333332,18.239999999999995,190,228,38,ki_chroma_acts_smoothed
104,4,109.04533333333332,130.16533333333334,21.12000000000002,228,272,44,ki_chroma_acts_smoothed
104,5,130.16533333333334,164.72533333333334,34.56,272,344,72,ki_chroma_acts_smoothed
104,6,164.72533333333334,182.96533333333335,18.24000000000001,344,382,38,ki_chroma_acts_smoothed
104,7,182.96533333333335,187.76533333333333,4.799999999999983,382,392,10,ki_chroma_acts_smoothed
104,8,187.76533333333333,198.32533333333333,10.560000000000002,392,414,22,ki_chroma_acts_smoothed
104,9,198.32533333333333,206.999,8.673666666666662,414,431,17,ki_chroma_acts_smoothed
105,1,0.0,15.008,15.008,0,29,29,chromagram
105,2,15.008,49.141333333333336,34.13333333333334,29,93,64,chromagram
105,3,49.141333333333336,68.34133333333332,19.19999999999999,93,129,36,chromagram
105,4,68.34133333333332,120.07466666666667,51.73333333333335,129,226,97,chromagram
105,5,120.07466666666667,135.00799999999998,14.933333333333309,226,254,28,chromagram
105,6,135.00799999999998,154.208,19.200000000000017,254,290,36,chromagram
105,7,154.208,188.34133333333332,34.133333333333326,290,354,64,chromagram
105,8,188.34133333333332,207.447,19.10566666666668,354,388,34,chromagram
105,1,0.0,49.141333333333336,49.141333333333336,0,93,93,chroma_acts
105,2,49.141333333333336,55.541333333333334,6.399999999999999,93,105,12,chroma_acts
105,3,55.541333333333334,68.34133333333332,12.79999999999999,105,129,24,chroma_acts
105,4,68.34133333333332,120.07466666666667,51.73333333333335,129,226,97,chroma_acts
105,5,120.07466666666667,135.00799999999998,14.933333333333309,226,254,28,chroma_acts
105,6,135.00799999999998,154.208,19.200000000000017,254,290,36,chroma_acts
105,7,154.208,188.34133333333332,34.133333333333326,290,354,64,chroma_acts
105,8,188.34133333333332,207.447,19.10566666666668,354,388,34,chroma_acts
105,1,0.0,49.141333333333336,49.141333333333336,0,93,93,chroma_acts_smoothed
105,2,49.141333333333336,56.608,7.4666666666666615,93,107,14,chroma_acts_smoothed
105,3,56.608,68.34133333333332,11.733333333333327,107,129,22,chroma_acts_smoothed
105,4,68.34133333333332,120.07466666666667,51.73333333333335,129,226,97,chroma_acts_smoothed
105,5,120.07466666666667,135.00799999999998,14.933333333333309,226,254,28,chroma_acts_smoothed
105,6,135.00799999999998,154.208,19.200000000000017,254,290,36,chroma_acts_smoothed
105,7,154.208,188.87466666666666,34.66666666666666,290,355,65,chroma_acts_smoothed
105,8,188.87466666666666,207.447,18.572333333333347,355,388,33,chroma_acts_smoothed
105,1,0.0,15.008,15.008,0,29,29,ki_chroma
105,2,15.008,49.141333333333336,34.13333333333334,29,93,64,ki_chroma
105,3,49.141333333333336,68.34133333333332,19.19999999999999,93,129,36,ki_chroma
105,4,68.34133333333332,120.07466666666667,51.73333333333335,129,226,97,ki_chroma
105,5,120.07466666666667,135.00799999999998,14.933333333333309,226,254,28,ki_chroma
105,6,135.00799999999998,154.208,19.200000000000017,254,290,36,ki_chroma
105,7,154.208,188.34133333333332,34.133333333333326,290,354,64,ki_chroma
105,8,188.34133333333332,207.447,19.10566666666668,354,388,34,ki_chroma
105,1,0.0,49.141333333333336,49.141333333333336,0,93,93,ki_chroma_acts
105,2,49.141333333333336,55.541333333333334,6.399999999999999,93,105,12,ki_chroma_acts
105,3,55.541333333333334,68.34133333333332,12.79999999999999,105,129,24,ki_chroma_acts
105,4,68.34133333333332,120.07466666666667,51.73333333333335,129,226,97,ki_chroma_acts
105,5,120.07466666666667,135.00799999999998,14.933333333333309,226,254,28,ki_chroma_acts
105,6,135.00799999999998,154.208,19.200000000000017,254,290,36,ki_chroma_acts
105,7,154.208,188.34133333333332,34.133333333333326,290,354,64,ki_chroma_acts
105,8,188.34133333333332,207.447,19.10566666666668,354,388,34,ki_chroma_acts
105,1,0.0,49.141333333333336,49.141333333333336,0,93,93,ki_chroma_acts_smoothed
105,2,49.141333333333336,56.608,7.4666666666666615,93,107,14,ki_chroma_acts_smoothed
105,3,56.608,68.34133333333332,11.733333333333327,107,129,22,ki_chroma_acts_smoothed
105,4,68.34133333333332,120.07466666666667,51.73333333333335,129,226,97,ki_chroma_acts_smoothed
105,5,120.07466666666667,135.00799999999998,14.933333333333309,226,254,28,ki_chroma_acts_smoothed
105,6,135.00799999999998,154.208,19.200000000000017,254,290,36,ki_chroma_acts_smoothed
105,7,154.208,188.87466666666666,34.66666666666666,290,355,65,ki_chroma_acts_smoothed
105,8,188.87466666666666,207.447,18.572333333333347,355,388,33,ki_chroma_acts_smoothed
106,1,0.0,9.397333333333334,9.397333333333334,0,20,20,chromagram
106,2,9.397333333333334,19.47733333333333,10.079999999999997,20,41,21,chromagram
106,3,19.47733333333333,32.437333333333335,12.960000000000004,41,68,27,chromagram
106,4,32.437333333333335,78.51733333333333,46.07999999999999,68,164,96,chromagram
106,5,78.51733333333333,86.67733333333334,8.16000000000001,164,181,17,chromagram
106,6,86.67733333333334,90.51733333333333,3.839999999999989,181,189,8,chromagram
106,7,90.51733333333333,109.23733333333332,18.72,189,228,39,chromagram
106,8,109.23733333333332,141.675,32.437666666666686,228,294,66,chromagram
106,1,0.0,9.397333333333334,9.397333333333334,0,20,20,chroma_acts
106,2,9.397333333333334,13.237333333333334,3.84,20,28,8,chroma_acts
106,3,13.237333333333334,32.437333333333335,19.200000000000003,28,68,40,chroma_acts
106,4,32.437333333333335,78.51733333333333,46.07999999999999,68,164,96,chroma_acts
106,5,78.51733333333333,86.67733333333334,8.16000000000001,164,181,17,chroma_acts
106,6,86.67733333333334,90.51733333333333,3.839999999999989,181,189,8,chroma_acts
106,7,90.51733333333333,109.23733333333332,18.72,189,228,39,chroma_acts
106,8,109.23733333333332,141.675,32.437666666666686,228,294,66,chroma_acts
106,1,0.0,9.397333333333334,9.397333333333334,0,20,20,chroma_acts_smoothed
106,2,9.397333333333334,13.237333333333334,3.84,20,28,8,chroma_acts_smoothed
106,3,13.237333333333334,32.437333333333335,19.200000000000003,28,68,40,chroma_acts_smoothed
106,4,32.437333333333335,78.51733333333333,46.07999999999999,68,164,96,chroma_acts_smoothed
106,5,78.51733333333333,86.19733333333333,7.680000000000007,164,180,16,chroma_acts_smoothed
106,6,86.19733333333333,90.51733333333333,4.319999999999993,180,189,9,chroma_acts_smoothed
106,7,90.51733333333333,109.23733333333332,18.72,189,228,39,chroma_acts_smoothed
106,8,109.23733333333332,141.675,32.437666666666686,228,294,66,chroma_acts_smoothed
106,1,0.0,9.397333333333334,9.397333333333334,0,20,20,ki_chroma
106,2,9.397333333333334,19.47733333333333,10.079999999999997,20,41,21,ki_chroma
106,3,19.47733333333333,32.437333333333335,12.960000000000004,41,68,27,ki_chroma
106,4,32.437333333333335,78.51733333333333,46.07999999999999,68,164,96,ki_chroma
106,5,78.51733333333333,86.67733333333334,8.16000000000001,164,181,17,ki_chroma
106,6,86.67733333333334,90.51733333333333,3.839999999999989,181,189,8,ki_chroma
106,7,90.51733333333333,109.23733333333332,18.72,189,228,39,ki_chroma
106,8,109.23733333333332,141.675,32.437666666666686,228,294,66,ki_chroma
106,1,0.0,9.397333333333334,9.397333333333334,0,20,20,ki_chroma_acts
106,2,9.397333333333334,13.237333333333334,3.84,20,28,8,ki_chroma_acts
106,3,13.237333333333334,32.437333333333335,19.200000000000003,28,68,40,ki_chroma_acts
106,4,32.437333333333335,78.51733333333333,46.07999999999999,68,164,96,ki_chroma_acts
106,5,78.51733333333333,86.67733333333334,8.16000000000001,164,181,17,ki_chroma_acts
106,6,86.67733333333334,90.51733333333333,3.839999999999989,181,189,8,ki_chroma_acts
106,7,90.51733333333333,109.23733333333332,18.72,189,228,39,ki_chroma_acts
106,8,109.23733333333332,141.675,32.437666666666686,228,294,66,ki_chroma_acts
106,1,0.0,9.397333333333334,9.397333333333334,0,20,20,ki_chroma_acts_smoothed
106,2,9.397333333333334,13.237333333333334,3.84,20,28,8,ki_chroma_acts_smoothed
106,3,13.237333333333334,32.437333333333335,19.200000000000003,28,68,40,ki_chroma_acts_smoothed
106,4,32.437333333333335,78.51733333333333,46.07999999999999,68,164,96,ki_chroma_acts_smoothed
106,5,78.51733333333333,86.19733333333333,7.680000000000007,164,180,16,ki_chroma_acts_smoothed
106,6,86.19733333333333,90.51733333333333,4.319999999999993,180,189,9,ki_chroma_acts_smoothed
106,7,90.51733333333333,109.23733333333332,18.72,189,228,39,ki_chroma_acts_smoothed
106,8,109.23733333333332,141.675,32.437666666666686,228,294,66,ki_chroma_acts_smoothed
107,1,0.0,27.712,27.712,0,60,60,chromagram
107,2,27.712,59.626666666666665,31.914666666666665,60,128,68,chromagram
107,3,59.626666666666665,75.11466666666666,15.488,128,161,33,chromagram
107,4,75.11466666666666,104.68266666666666,29.567999999999998,161,224,63,chromagram
107,5,104.68266666666666,140.82133333333334,36.13866666666668,224,301,77,chromagram
107,6,140.82133333333334,145.04533333333333,4.2239999999999895,301,310,9,chromagram
107,7,145.04533333333333,152.08533333333332,7.039999999999992,310,325,15,chromagram
107,8,152.08533333333332,160.064,7.978666666666669,325,342,17,chromagram
107,9,160.064,212.086,52.02200000000002,342,451,109,chromagram
107,1,0.0,27.712,27.712,0,60,60,chroma_acts
107,2,27.712,75.11466666666666,47.40266666666666,60,161,101,chroma_acts
107,3,75.11466666666666,122.98666666666666,47.872,161,263,102,chroma_acts
107,4,122.98666666666666,125.80266666666667,2.8160000000000025,263,269,6,chroma_acts
107,5,125.80266666666667,132.84266666666667,7.040000000000006,269,284,15,chroma_acts
107,6,132.84266666666667,144.10666666666665,11.263999999999982,284,308,24,chroma_acts
107,7,144.10666666666665,152.55466666666666,8.448000000000008,308,326,18,chroma_acts
107,8,152.55466666666666,165.696,13.141333333333336,326,354,28,chroma_acts
107,9,165.696,212.086,46.390000000000015,354,451,97,chroma_acts
107,1,0.0,26.773333333333333,26.773333333333333,0,58,58,chroma_acts_smoothed
107,2,26.773333333333333,75.11466666666666,48.34133333333333,58,161,103,chroma_acts_smoothed
107,3,75.11466666666666,105.152,30.037333333333336,161,225,64,chroma_acts_smoothed
107,4,105.152,132.84266666666667,27.690666666666672,225,284,59,chroma_acts_smoothed
107,5,132.84266666666667,144.10666666666665,11.263999999999982,284,308,24,chroma_acts_smoothed
107,6,144.10666666666665,153.49333333333334,9.386666666666684,308,328,20,chroma_acts_smoothed
107,7,153.49333333333334,160.064,6.5706666666666536,328,342,14,chroma_acts_smoothed
107,8,160.064,167.57333333333332,7.5093333333333305,342,358,16,chroma_acts_smoothed
107,9,167.57333333333332,212.086,44.51266666666669,358,451,93,chroma_acts_smoothed
107,1,0.0,27.712,27.712,0,60,60,ki_chroma
107,2,27.712,59.626666666666665,31.914666666666665,60,128,68,ki_chroma
107,3,59.626666666666665,75.11466666666666,15.488,128,161,33,ki_chroma
107,4,75.11466666666666,104.68266666666666,29.567999999999998,161,224,63,ki_chroma
107,5,104.68266666666666,140.82133333333334,36.13866666666668,224,301,77,ki_chroma
107,6,140.82133333333334,145.04533333333333,4.2239999999999895,301,310,9,ki_chroma
107,7,145.04533333333333,152.08533333333332,7.039999999999992,310,325,15,ki_chroma
107,8,152.08533333333332,160.064,7.978666666666669,325,342,17,ki_chroma
107,9,160.064,212.086,52.02200000000002,342,451,109,ki_chroma
107,1,0.0,27.712,27.712,0,60,60,ki_chroma_acts
107,2,27.712,75.11466666666666,47.40266666666666,60,161,101,ki_chroma_acts
107,3,75.11466666666666,122.98666666666666,47.872,161,263,102,ki_chroma_acts
107,4,122.98666666666666,125.80266666666667,2.8160000000000025,263,269,6,ki_chroma_acts
107,5,125.80266666666667,132.84266666666667,7.040000000000006,269,284,15,ki_chroma_acts
107,6,132.84266666666667,144.10666666666665,11.263999999999982,284,308,24,ki_chroma_acts
107,7,144.10666666666665,152.55466666666666,8.448000000000008,308,326,18,ki_chroma_acts
107,8,152.55466666666666,165.696,13.141333333333336,326,354,28,ki_chroma_acts
107,9,165.696,212.086,46.390000000000015,354,451,97,ki_chroma_acts
107,1,0.0,26.773333333333333,26.773333333333333,0,58,58,ki_chroma_acts_smoothed
107,2,26.773333333333333,75.11466666666666,48.34133333333333,58,161,103,ki_chroma_acts_smoothed
107,3,75.11466666666666,105.152,30.037333333333336,161,225,64,ki_chroma_acts_smoothed
107,4,105.152,132.84266666666667,27.690666666666672,225,284,59,ki_chroma_acts_smoothed
107,5,132.84266666666667,144.10666666666665,11.263999999999982,284,308,24,ki_chroma_acts_smoothed
107,6,144.10666666666665,153.49333333333334,9.386666666666684,308,328,20,ki_chroma_acts_smoothed
107,7,153.49333333333334,160.064,6.5706666666666536,328,342,14,ki_chroma_acts_smoothed
107,8,160.064,167.57333333333332,7.5093333333333305,342,358,16,ki_chroma_acts_smoothed
107,9,167.57333333333332,212.086,44.51266666666669,358,451,93,ki_chroma_acts_smoothed
108,1,0.0,45.888,45.888,0,96,96,chromagram
108,2,45.888,91.488,45.6,96,191,95,chromagram
108,3,91.488,137.568,46.08000000000001,191,287,96,chromagram
108,4,137.568,152.448,14.879999999999995,287,318,31,chromagram
108,5,152.448,183.168,30.72,318,382,64,chromagram
108,6,183.168,213.888,30.72,382,446,64,chromagram
108,7,213.888,243.648,29.75999999999999,446,508,62,chromagram
108,8,243.648,305.088,61.440000000000026,508,636,128,chromagram
108,9,305.088,336.665,31.576999999999998,636,700,64,chromagram
108,1,0.0,45.888,45.888,0,96,96,chroma_acts
108,2,45.888,91.488,45.6,96,191,95,chroma_acts
108,3,91.488,137.568,46.08000000000001,191,287,96,chroma_acts
108,4,137.568,152.448,14.879999999999995,287,318,31,chroma_acts
108,5,152.448,183.168,30.72,318,382,64,chroma_acts
108,6,183.168,213.888,30.72,382,446,64,chroma_acts
108,7,213.888,243.648,29.75999999999999,446,508,62,chroma_acts
108,8,243.648,305.088,61.440000000000026,508,636,128,chroma_acts
108,9,305.088,336.665,31.576999999999998,636,700,64,chroma_acts
108,1,0.0,45.888,45.888,0,96,96,chroma_acts_smoothed
108,2,45.888,91.488,45.6,96,191,95,chroma_acts_smoothed
108,3,91.488,137.568,46.08000000000001,191,287,96,chroma_acts_smoothed
108,4,137.568,152.448,14.879999999999995,287,318,31,chroma_acts_smoothed
108,5,152.448,183.168,30.72,318,382,64,chroma_acts_smoothed
108,6,183.168,213.888,30.72,382,446,64,chroma_acts_smoothed
108,7,213.888,243.648,29.75999999999999,446,508,62,chroma_acts_smoothed
108,8,243.648,304.608,60.96000000000001,508,635,127,chroma_acts_smoothed
108,9,304.608,336.665,32.057000000000016,635,700,65,chroma_acts_smoothed
108,1,0.0,45.888,45.888,0,96,96,ki_chroma
108,2,45.888,91.488,45.6,96,191,95,ki_chroma
108,3,91.488,137.568,46.08000000000001,191,287,96,ki_chroma
108,4,137.568,152.448,14.879999999999995,287,318,31,ki_chroma
108,5,152.448,183.168,30.72,318,382,64,ki_chroma
108,6,183.168,213.888,30.72,382,446,64,ki_chroma
108,7,213.888,243.648,29.75999999999999,446,508,62,ki_chroma
108,8,243.648,305.088,61.440000000000026,508,636,128,ki_chroma
108,9,305.088,336.665,31.576999999999998,636,700,64,ki_chroma
108,1,0.0,45.888,45.888,0,96,96,ki_chroma_acts
108,2,45.888,91.488,45.6,96,191,95,ki_chroma_acts
108,3,91.488,137.568,46.08000000000001,191,287,96,ki_chroma_acts
108,4,137.568,152.448,14.879999999999995,287,318,31,ki_chroma_acts
108,5,152.448,183.168,30.72,318,382,64,ki_chroma_acts
108,6,183.168,213.888,30.72,382,446,64,ki_chroma_acts
108,7,213.888,243.648,29.75999999999999,446,508,62,ki_chroma_acts
108,8,243.648,305.088,61.440000000000026,508,636,128,ki_chroma_acts
108,9,305.088,336.665,31.576999999999998,636,700,64,ki_chroma_acts
108,1,0.0,45.888,45.888,0,96,96,ki_chroma_acts_smoothed
108,2,45.888,91.488,45.6,96,191,95,ki_chroma_acts_smoothed
108,3,91.488,137.568,46.08000000000001,191,287,96,ki_chroma_acts_smoothed
108,4,137.568,152.448,14.879999999999995,287,318,31,ki_chroma_acts_smoothed
108,5,152.448,183.168,30.72,318,382,64,ki_chroma_acts_smoothed
108,6,183.168,213.888,30.72,382,446,64,ki_chroma_acts_smoothed
108,7,213.888,243.648,29.75999999999999,446,508,62,ki_chroma_acts_smoothed
108,8,243.648,304.608,60.96000000000001,508,635,127,ki_chroma_acts_smoothed
108,9,304.608,336.665,32.057000000000016,635,700,65,ki_chroma_acts_smoothed
109,1,0.0,15.264,15.264,0,33,33,chromagram
109,2,15.264,30.282666666666668,15.018666666666668,33,65,32,chromagram
109,3,30.282666666666668,121.33333333333334,91.05066666666667,65,259,194,chromagram
109,4,121.33333333333334,135.88266666666667,14.549333333333323,259,290,31,chromagram
109,5,135.88266666666667,147.61599999999999,11.73333333333332,290,315,25,chromagram
109,6,147.61599999999999,152.77866666666665,5.1626666666666665,315,326,11,chromagram
109,7,152.77866666666665,180.46933333333334,27.690666666666687,326,385,59,chromagram
109,8,180.46933333333334,183.28533333333334,2.8160000000000025,385,391,6,chromagram
109,9,183.28533333333334,212.139,28.85366666666667,391,451,60,chromagram
109,1,0.0,15.264,15.264,0,33,33,chroma_acts
109,2,15.264,32.16,16.895999999999997,33,69,36,chroma_acts
109,3,32.16,59.38133333333333,27.221333333333334,69,127,58,chroma_acts
109,4,59.38133333333333,62.19733333333333,2.8160000000000025,127,133,6,chroma_acts
109,5,62.19733333333333,121.33333333333334,59.13600000000001,133,259,126,chroma_acts
109,6,121.33333333333334,135.88266666666667,14.549333333333323,259,290,31,chroma_acts
109,7,135.88266666666667,147.14666666666668,11.26400000000001,290,314,24,chroma_acts
109,8,147.14666666666668,152.77866666666665,5.631999999999977,314,326,12,chroma_acts
109,9,152.77866666666665,212.139,59.36033333333336,326,451,125,chroma_acts
109,1,0.0,15.264,15.264,0,33,33,chroma_acts_smoothed
109,2,15.264,32.16,16.895999999999997,33,69,36,chroma_acts_smoothed
109,3,32.16,121.33333333333334,89.17333333333335,69,259,190,chroma_acts_smoothed
109,4,121.33333333333334,135.88266666666667,14.549333333333323,259,290,31,chroma_acts_smoothed
109,5,135.88266666666667,146.67733333333334,10.794666666666672,290,313,23,chroma_acts_smoothed
109,6,146.67733333333334,152.77866666666665,6.101333333333315,313,326,13,chroma_acts_smoothed
109,7,152.77866666666665,180.46933333333334,27.690666666666687,326,385,59,chroma_acts_smoothed
109,8,180.46933333333334,183.28533333333334,2.8160000000000025,385,391,6,chroma_acts_smoothed
109,9,183.28533333333334,212.139,28.85366666666667,391,451,60,chroma_acts_smoothed
109,1,0.0,15.264,15.264,0,33,33,ki_chroma
109,2,15.264,30.282666666666668,15.018666666666668,33,65,32,ki_chroma
109,3,30.282666666666668,121.33333333333334,91.05066666666667,65,259,194,ki_chroma
109,4,121.33333333333334,135.88266666666667,14.549333333333323,259,290,31,ki_chroma
109,5,135.88266666666667,147.61599999999999,11.73333333333332,290,315,25,ki_chroma
109,6,147.61599999999999,152.77866666666665,5.1626666666666665,315,326,11,ki_chroma
109,7,152.77866666666665,180.46933333333334,27.690666666666687,326,385,59,ki_chroma
109,8,180.46933333333334,183.28533333333334,2.8160000000000025,385,391,6,ki_chroma
109,9,183.28533333333334,212.139,28.85366666666667,391,451,60,ki_chroma
109,1,0.0,15.264,15.264,0,33,33,ki_chroma_acts
109,2,15.264,32.16,16.895999999999997,33,69,36,ki_chroma_acts
109,3,32.16,59.38133333333333,27.221333333333334,69,127,58,ki_chroma_acts
109,4,59.38133333333333,62.19733333333333,2.8160000000000025,127,133,6,ki_chroma_acts
109,5,62.19733333333333,121.33333333333334,59.13600000000001,133,259,126,ki_chroma_acts
109,6,121.33333333333334,135.88266666666667,14.549333333333323,259,290,31,ki_chroma_acts
109,7,135.88266666666667,147.14666666666668,11.26400000000001,290,314,24,ki_chroma_acts
109,8,147.14666666666668,152.77866666666665,5.631999999999977,314,326,12,ki_chroma_acts
109,9,152.77866666666665,212.139,59.36033333333336,326,451,125,ki_chroma_acts
109,1,0.0,15.264,15.264,0,33,33,ki_chroma_acts_smoothed
109,2,15.264,32.16,16.895999999999997,33,69,36,ki_chroma_acts_smoothed
109,3,32.16,121.33333333333334,89.17333333333335,69,259,190,ki_chroma_acts_smoothed
109,4,121.33333333333334,135.88266666666667,14.549333333333323,259,290,31,ki_chroma_acts_smoothed
109,5,135.88266666666667,146.67733333333334,10.794666666666672,290,313,23,ki_chroma_acts_smoothed
109,6,146.67733333333334,152.77866666666665,6.101333333333315,313,326,13,ki_chroma_acts_smoothed
109,7,152.77866666666665,180.46933333333334,27.690666666666687,326,385,59,ki_chroma_acts_smoothed
109,8,180.46933333333334,183.28533333333334,2.8160000000000025,385,391,6,ki_chroma_acts_smoothed
109,9,183.28533333333334,212.139,28.85366666666667,391,451,60,ki_chroma_acts_smoothed
114,1,0.0,16.59733333333333,16.59733333333333,0,36,36,chromagram
114,2,16.59733333333333,61.653333333333336,45.056000000000004,36,132,96,chromagram
114,3,61.653333333333336,76.672,15.018666666666661,132,164,32,chromagram
114,4,76.672,91.69066666666667,15.018666666666675,164,196,32,chromagram
114,5,91.69066666666667,107.17866666666667,15.488,196,229,33,chromagram
114,6,107.17866666666667,135.33866666666665,28.159999999999982,229,289,60,chromagram
114,7,135.33866666666665,176.64,41.30133333333333,289,377,88,chromagram
114,8,176.64,186.02666666666664,9.386666666666656,377,397,20,chromagram
114,9,186.02666666666664,198.066,12.03933333333336,397,421,24,chromagram
114,1,0.0,16.59733333333333,16.59733333333333,0,36,36,chroma_acts
114,2,16.59733333333333,61.653333333333336,45.056000000000004,36,132,96,chroma_acts
114,3,61.653333333333336,75.73333333333333,14.079999999999998,132,162,30,chroma_acts
114,4,75.73333333333333,107.17866666666667,31.445333333333338,162,229,67,chroma_acts
114,5,107.17866666666667,135.33866666666665,28.159999999999982,229,289,60,chroma_acts
114,6,135.33866666666665,175.7013333333333,40.362666666666655,289,375,86,chroma_acts
114,7,175.7013333333333,186.02666666666664,10.325333333333333,375,397,22,chroma_acts
114,8,186.02666666666664,198.066,12.03933333333336,397,421,24,chroma_acts
114,1,0.0,16.59733333333333,16.59733333333333,0,36,36,chroma_acts_smoothed
114,2,16.59733333333333,62.12266666666667,45.525333333333336,36,133,97,chroma_acts_smoothed
114,3,62.12266666666667,75.73333333333333,13.610666666666667,133,162,29,chroma_acts_smoothed
114,4,75.73333333333333,106.70933333333333,30.976,162,228,66,chroma_acts_smoothed
114,5,106.70933333333333,134.39999999999998,27.690666666666644,228,287,59,chroma_acts_smoothed
114,6,134.39999999999998,176.64,42.24000000000001,287,377,90,chroma_acts_smoothed
114,7,176.64,185.5573333333333,8.917333333333318,377,396,19,chroma_acts_smoothed
114,8,185.5573333333333,198.066,12.508666666666699,396,421,25,chroma_acts_smoothed
114,1,0.0,16.59733333333333,16.59733333333333,0,36,36,ki_chroma
114,2,16.59733333333333,61.653333333333336,45.056000000000004,36,132,96,ki_chroma
114,3,61.653333333333336,76.672,15.018666666666661,132,164,32,ki_chroma
114,4,76.672,91.69066666666667,15.018666666666675,164,196,32,ki_chroma
114,5,91.69066666666667,107.17866666666667,15.488,196,229,33,ki_chroma
114,6,107.17866666666667,135.33866666666665,28.159999999999982,229,289,60,ki_chroma
114,7,135.33866666666665,176.64,41.30133333333333,289,377,88,ki_chroma
114,8,176.64,186.02666666666664,9.386666666666656,377,397,20,ki_chroma
114,9,186.02666666666664,198.066,12.03933333333336,397,421,24,ki_chroma
114,1,0.0,16.59733333333333,16.59733333333333,0,36,36,ki_chroma_acts
114,2,16.59733333333333,61.653333333333336,45.056000000000004,36,132,96,ki_chroma_acts
114,3,61.653333333333336,75.73333333333333,14.079999999999998,132,162,30,ki_chroma_acts
114,4,75.73333333333333,107.17866666666667,31.445333333333338,162,229,67,ki_chroma_acts
114,5,107.17866666666667,135.33866666666665,28.159999999999982,229,289,60,ki_chroma_acts
114,6,135.33866666666665,175.7013333333333,40.362666666666655,289,375,86,ki_chroma_acts
114,7,175.7013333333333,186.02666666666664,10.325333333333333,375,397,22,ki_chroma_acts
114,8,186.02666666666664,198.066,12.03933333333336,397,421,24,ki_chroma_acts
114,1,0.0,16.59733333333333,16.59733333333333,0,36,36,ki_chroma_acts_smoothed
114,2,16.59733333333333,62.12266666666667,45.525333333333336,36,133,97,ki_chroma_acts_smoothed
114,3,62.12266666666667,75.73333333333333,13.610666666666667,133,162,29,ki_chroma_acts_smoothed
114,4,75.73333333333333,106.70933333333333,30.976,162,228,66,ki_chroma_acts_smoothed
114,5,106.70933333333333,134.39999999999998,27.690666666666644,228,287,59,ki_chroma_acts_smoothed
114,6,134.39999999999998,176.64,42.24000000000001,287,377,90,ki_chroma_acts_smoothed
114,7,176.64,185.5573333333333,8.917333333333318,377,396,19,ki_chroma_acts_smoothed
114,8,185.5573333333333,198.066,12.508666666666699,396,421,25,ki_chroma_acts_smoothed
115,1,0.0,16.256,16.256,0,32,32,chromagram
115,2,16.256,34.688,18.432000000000002,32,68,36,chromagram
115,3,34.688,80.768,46.08,68,158,90,chromagram
115,4,80.768,116.096,35.328,158,227,69,chromagram
115,5,116.096,134.016,17.919999999999987,227,262,35,chromagram
115,6,134.016,180.60799999999998,46.591999999999985,262,353,91,chromagram
115,7,180.60799999999998,182.14399999999998,1.5360000000000014,353,356,3,chromagram
115,8,182.14399999999998,189.31199999999998,7.168000000000006,356,370,14,chromagram
115,9,189.31199999999998,215.301,25.989000000000004,370,419,49,chromagram
115,1,0.0,16.256,16.256,0,32,32,chroma_acts
115,2,16.256,34.688,18.432000000000002,32,68,36,chroma_acts
115,3,34.688,80.768,46.08,68,158,90,chroma_acts
115,4,80.768,99.712,18.944000000000003,158,195,37,chroma_acts
115,5,99.712,134.016,34.30399999999999,195,262,67,chroma_acts
115,6,134.016,180.60799999999998,46.591999999999985,262,353,91,chroma_acts
115,7,180.60799999999998,182.14399999999998,1.5360000000000014,353,356,3,chroma_acts
115,8,182.14399999999998,188.28799999999998,6.1440000000000055,356,368,12,chroma_acts
115,9,188.28799999999998,215.301,27.013000000000005,368,419,51,chroma_acts
115,1,0.0,16.256,16.256,0,32,32,chroma_acts_smoothed
115,2,16.256,34.688,18.432000000000002,32,68,36,chroma_acts_smoothed
115,3,34.688,80.768,46.08,68,158,90,chroma_acts_smoothed
115,4,80.768,119.168,38.400000000000006,158,233,75,chroma_acts_smoothed
115,5,119.168,134.016,14.847999999999985,233,262,29,chroma_acts_smoothed
115,6,134.016,182.14399999999998,48.127999999999986,262,356,94,chroma_acts_smoothed
115,7,182.14399999999998,188.28799999999998,6.1440000000000055,356,368,12,chroma_acts_smoothed
115,8,188.28799999999998,215.301,27.013000000000005,368,419,51,chroma_acts_smoothed
115,1,0.0,16.256,16.256,0,32,32,ki_chroma
115,2,16.256,34.688,18.432000000000002,32,68,36,ki_chroma
115,3,34.688,80.768,46.08,68,158,90,ki_chroma
115,4,80.768,116.096,35.328,158,227,69,ki_chroma
115,5,116.096,134.016,17.919999999999987,227,262,35,ki_chroma
115,6,134.016,180.60799999999998,46.591999999999985,262,353,91,ki_chroma
115,7,180.60799999999998,182.14399999999998,1.5360000000000014,353,356,3,ki_chroma
115,8,182.14399999999998,189.31199999999998,7.168000000000006,356,370,14,ki_chroma
115,9,189.31199999999998,215.301,25.989000000000004,370,419,49,ki_chroma
115,1,0.0,16.256,16.256,0,32,32,ki_chroma_acts
115,2,16.256,34.688,18.432000000000002,32,68,36,ki_chroma_acts
115,3,34.688,80.768,46.08,68,158,90,ki_chroma_acts
115,4,80.768,99.712,18.944000000000003,158,195,37,ki_chroma_acts
115,5,99.712,134.016,34.30399999999999,195,262,67,ki_chroma_acts
115,6,134.016,180.60799999999998,46.591999999999985,262,353,91,ki_chroma_acts
115,7,180.60799999999998,182.14399999999998,1.5360000000000014,353,356,3,ki_chroma_acts
115,8,182.14399999999998,188.28799999999998,6.1440000000000055,356,368,12,ki_chroma_acts
115,9,188.28799999999998,215.301,27.013000000000005,368,419,51,ki_chroma_acts
115,1,0.0,16.256,16.256,0,32,32,ki_chroma_acts_smoothed
115,2,16.256,34.688,18.432000000000002,32,68,36,ki_chroma_acts_smoothed
115,3,34.688,80.768,46.08,68,158,90,ki_chroma_acts_smoothed
115,4,80.768,119.168,38.400000000000006,158,233,75,ki_chroma_acts_smoothed
115,5,119.168,134.016,14.847999999999985,233,262,29,ki_chroma_acts_smoothed
115,6,134.016,182.14399999999998,48.127999999999986,262,356,94,ki_chroma_acts_smoothed
115,7,182.14399999999998,188.28799999999998,6.1440000000000055,356,368,12,ki_chroma_acts_smoothed
115,8,188.28799999999998,215.301,27.013000000000005,368,419,51,ki_chroma_acts_smoothed
116,1,0.0,30.826666666666664,30.826666666666664,0,61,61,chromagram
116,2,30.826666666666664,34.41066666666667,3.5840000000000067,61,68,7,chromagram
116,3,34.41066666666667,39.01866666666667,4.607999999999997,68,77,9,chromagram
116,4,39.01866666666667,42.09066666666667,3.0720000000000027,77,83,6,chromagram
116,5,42.09066666666667,66.66666666666667,24.576,83,131,48,chromagram
116,6,66.66666666666667,104.04266666666668,37.376000000000005,131,204,73,chromagram
116,7,104.04266666666668,144.49066666666667,40.44799999999999,204,283,79,chromagram
116,8,144.49066666666667,208.974,64.48333333333332,283,407,124,chromagram
116,1,0.0,39.01866666666667,39.01866666666667,0,77,77,chroma_acts
116,2,39.01866666666667,42.09066666666667,3.0720000000000027,77,83,6,chroma_acts
116,3,42.09066666666667,46.69866666666667,4.607999999999997,83,92,9,chroma_acts
116,4,46.69866666666667,50.28266666666667,3.584000000000003,92,99,7,chroma_acts
116,5,50.28266666666667,54.89066666666667,4.607999999999997,99,108,9,chroma_acts
116,6,54.89066666666667,58.47466666666667,3.584000000000003,108,115,7,chroma_acts
116,7,58.47466666666667,63.08266666666667,4.607999999999997,115,124,9,chroma_acts
116,8,63.08266666666667,144.49066666666667,81.408,124,283,159,chroma_acts
116,9,144.49066666666667,208.974,64.48333333333332,283,407,124,chroma_acts
116,1,0.0,39.01866666666667,39.01866666666667,0,77,77,chroma_acts_smoothed
116,2,39.01866666666667,42.09066666666667,3.0720000000000027,77,83,6,chroma_acts_smoothed
116,3,42.09066666666667,47.21066666666667,5.119999999999997,83,93,10,chroma_acts_smoothed
116,4,47.21066666666667,50.28266666666667,3.0720000000000027,93,99,6,chroma_acts_smoothed
116,5,50.28266666666667,54.89066666666667,4.607999999999997,99,108,9,chroma_acts_smoothed
116,6,54.89066666666667,63.08266666666667,8.192,108,124,16,chroma_acts_smoothed
116,7,63.08266666666667,116.33066666666667,53.248000000000005,124,228,104,chroma_acts_smoothed
116,8,116.33066666666667,144.49066666666667,28.159999999999997,228,283,55,chroma_acts_smoothed
116,9,144.49066666666667,208.974,64.48333333333332,283,407,124,chroma_acts_smoothed
116,1,0.0,30.826666666666664,30.826666666666664,0,61,61,ki_chroma
116,2,30.826666666666664,34.41066666666667,3.5840000000000067,61,68,7,ki_chroma
116,3,34.41066666666667,39.01866666666667,4.607999999999997,68,77,9,ki_chroma
116,4,39.01866666666667,42.09066666666667,3.0720000000000027,77,83,6,ki_chroma
116,5,42.09066666666667,66.66666666666667,24.576,83,131,48,ki_chroma
116,6,66.66666666666667,104.04266666666668,37.376000000000005,131,204,73,ki_chroma
116,7,104.04266666666668,144.49066666666667,40.44799999999999,204,283,79,ki_chroma
116,8,144.49066666666667,208.974,64.48333333333332,283,407,124,ki_chroma
116,1,0.0,39.01866666666667,39.01866666666667,0,77,77,ki_chroma_acts
116,2,39.01866666666667,42.09066666666667,3.0720000000000027,77,83,6,ki_chroma_acts
116,3,42.09066666666667,46.69866666666667,4.607999999999997,83,92,9,ki_chroma_acts
116,4,46.69866666666667,50.28266666666667,3.584000000000003,92,99,7,ki_chroma_acts
116,5,50.28266666666667,54.89066666666667,4.607999999999997,99,108,9,ki_chroma_acts
116,6,54.89066666666667,58.47466666666667,3.584000000000003,108,115,7,ki_chroma_acts
116,7,58.47466666666667,63.08266666666667,4.607999999999997,115,124,9,ki_chroma_acts
116,8,63.08266666666667,144.49066666666667,81.408,124,283,159,ki_chroma_acts
116,9,144.49066666666667,208.974,64.48333333333332,283,407,124,ki_chroma_acts
116,1,0.0,39.01866666666667,39.01866666666667,0,77,77,ki_chroma_acts_smoothed
116,2,39.01866666666667,42.09066666666667,3.0720000000000027,77,83,6,ki_chroma_acts_smoothed
116,3,42.09066666666667,47.21066666666667,5.119999999999997,83,93,10,ki_chroma_acts_smoothed
116,4,47.21066666666667,50.28266666666667,3.0720000000000027,93,99,6,ki_chroma_acts_smoothed
116,5,50.28266666666667,54.89066666666667,4.607999999999997,99,108,9,ki_chroma_acts_smoothed
116,6,54.89066666666667,63.08266666666667,8.192,108,124,16,ki_chroma_acts_smoothed
116,7,63.08266666666667,116.33066666666667,53.248000000000005,124,228,104,ki_chroma_acts_smoothed
116,8,116.33066666666667,144.49066666666667,28.159999999999997,228,283,55,ki_chroma_acts_smoothed
116,9,144.49066666666667,208.974,64.48333333333332,283,407,124,ki_chroma_acts_smoothed
118,1,0.0,41.55733333333334,41.55733333333334,0,93,93,chromagram
118,2,41.55733333333334,59.47733333333334,17.92,93,133,40,chromagram
118,3,59.47733333333334,88.14933333333335,28.672000000000004,133,197,64,chromagram
118,4,88.14933333333335,103.38133333333336,15.232000000000014,197,231,34,chromagram
118,5,103.38133333333336,117.26933333333335,13.887999999999991,231,262,31,chromagram
118,6,117.26933333333335,128.02133333333336,10.75200000000001,262,286,24,chromagram
118,7,128.02133333333336,145.94133333333335,17.919999999999987,286,326,40,chromagram
118,8,145.94133333333335,189.994,44.05266666666665,326,423,97,chromagram
118,1,0.0,37.973333333333336,37.973333333333336,0,85,85,chroma_acts
118,2,37.973333333333336,41.55733333333334,3.584000000000003,85,93,8,chroma_acts
118,3,41.55733333333334,88.14933333333335,46.592000000000006,93,197,104,chroma_acts
118,4,88.14933333333335,103.38133333333336,15.232000000000014,197,231,34,chroma_acts
118,5,103.38133333333336,117.26933333333335,13.887999999999991,231,262,31,chroma_acts
118,6,117.26933333333335,120.85333333333335,3.584000000000003,262,270,8,chroma_acts
118,7,120.85333333333335,124.43733333333336,3.584000000000003,270,278,8,chroma_acts
118,8,124.43733333333336,128.02133333333336,3.584000000000003,278,286,8,chroma_acts
118,9,128.02133333333336,189.994,61.97266666666664,286,423,137,chroma_acts
118,1,0.0,41.55733333333334,41.55733333333334,0,93,93,chroma_acts_smoothed
118,2,41.55733333333334,87.70133333333335,46.14400000000001,93,196,103,chroma_acts_smoothed
118,3,87.70133333333335,103.82933333333335,16.128,196,232,36,chroma_acts_smoothed
118,4,103.82933333333335,117.26933333333335,13.439999999999998,232,262,30,chroma_acts_smoothed
118,5,117.26933333333335,120.85333333333335,3.584000000000003,262,270,8,chroma_acts_smoothed
118,6,120.85333333333335,124.43733333333336,3.584000000000003,270,278,8,chroma_acts_smoothed
118,7,124.43733333333336,128.02133333333336,3.584000000000003,278,286,8,chroma_acts_smoothed
118,8,128.02133333333336,189.994,61.97266666666664,286,423,137,chroma_acts_smoothed
118,1,0.0,41.55733333333334,41.55733333333334,0,93,93,ki_chroma
118,2,41.55733333333334,59.47733333333334,17.92,93,133,40,ki_chroma
118,3,59.47733333333334,88.14933333333335,28.672000000000004,133,197,64,ki_chroma
118,4,88.14933333333335,103.38133333333336,15.232000000000014,197,231,34,ki_chroma
118,5,103.38133333333336,117.26933333333335,13.887999999999991,231,262,31,ki_chroma
118,6,117.26933333333335,128.02133333333336,10.75200000000001,262,286,24,ki_chroma
118,7,128.02133333333336,145.94133333333335,17.919999999999987,286,326,40,ki_chroma
118,8,145.94133333333335,189.994,44.05266666666665,326,423,97,ki_chroma
118,1,0.0,37.973333333333336,37.973333333333336,0,85,85,ki_chroma_acts
118,2,37.973333333333336,41.55733333333334,3.584000000000003,85,93,8,ki_chroma_acts
118,3,41.55733333333334,88.14933333333335,46.592000000000006,93,197,104,ki_chroma_acts
118,4,88.14933333333335,103.38133333333336,15.232000000000014,197,231,34,ki_chroma_acts
118,5,103.38133333333336,117.26933333333335,13.887999999999991,231,262,31,ki_chroma_acts
118,6,117.26933333333335,120.85333333333335,3.584000000000003,262,270,8,ki_chroma_acts
118,7,120.85333333333335,124.43733333333336,3.584000000000003,270,278,8,ki_chroma_acts
118,8,124.43733333333336,128.02133333333336,3.584000000000003,278,286,8,ki_chroma_acts
118,9,128.02133333333336,189.994,61.97266666666664,286,423,137,ki_chroma_acts
118,1,0.0,41.55733333333334,41.55733333333334,0,93,93,ki_chroma_acts_smoothed
118,2,41.55733333333334,87.70133333333335,46.14400000000001,93,196,103,ki_chroma_acts_smoothed
118,3,87.70133333333335,103.82933333333335,16.128,196,232,36,ki_chroma_acts_smoothed
118,4,103.82933333333335,117.26933333333335,13.439999999999998,232,262,30,ki_chroma_acts_smoothed
118,5,117.26933333333335,120.85333333333335,3.584000000000003,262,270,8,ki_chroma_acts_smoothed
118,6,120.85333333333335,124.43733333333336,3.584000000000003,270,278,8,ki_chroma_acts_smoothed
118,7,124.43733333333336,128.02133333333336,3.584000000000003,278,286,8,ki_chroma_acts_smoothed
118,8,128.02133333333336,189.994,61.97266666666664,286,423,137,ki_chroma_acts_smoothed
127,1,0.0,3.669333333333334,3.669333333333334,0,8,8,chromagram
127,2,3.669333333333334,31.989333333333335,28.32,8,67,59,chromagram
127,3,31.989333333333335,60.78933333333333,28.799999999999997,67,127,60,chromagram
127,4,60.78933333333333,110.22933333333333,49.44,127,230,103,chromagram
127,5,110.22933333333333,118.38933333333333,8.159999999999997,230,247,17,chromagram
127,6,118.38933333333333,125.58933333333333,7.200000000000003,247,262,15,chromagram
127,7,125.58933333333333,133.26933333333335,7.680000000000021,262,278,16,chromagram
127,8,133.26933333333335,175.02933333333334,41.75999999999999,278,365,87,chromagram
127,9,175.02933333333334,217.39,42.360666666666646,365,452,87,chromagram
127,1,0.0,31.989333333333335,31.989333333333335,0,67,67,chroma_acts
127,2,31.989333333333335,64.62933333333334,32.64,67,135,68,chroma_acts
127,3,64.62933333333334,110.22933333333333,45.599999999999994,135,230,95,chroma_acts
127,4,110.22933333333333,118.38933333333333,8.159999999999997,230,247,17,chroma_acts
127,5,118.38933333333333,126.06933333333333,7.680000000000007,247,263,16,chroma_acts
127,6,126.06933333333333,133.26933333333335,7.200000000000017,263,278,15,chroma_acts
127,7,133.26933333333335,140.94933333333333,7.679999999999978,278,294,16,chroma_acts
127,8,140.94933333333333,175.02933333333334,34.08000000000001,294,365,71,chroma_acts
127,9,175.02933333333334,217.39,42.360666666666646,365,452,87,chroma_acts
127,1,0.0,31.509333333333334,31.509333333333334,0,66,66,chroma_acts_smoothed
127,2,31.509333333333334,65.58933333333333,34.08,66,137,71,chroma_acts_smoothed
127,3,65.58933333333333,110.22933333333333,44.64,137,230,93,chroma_acts_smoothed
127,4,110.22933333333333,118.38933333333333,8.159999999999997,230,247,17,chroma_acts_smoothed
127,5,118.38933333333333,126.06933333333333,7.680000000000007,247,263,16,chroma_acts_smoothed
127,6,126.06933333333333,133.26933333333335,7.200000000000017,263,278,15,chroma_acts_smoothed
127,7,133.26933333333335,140.94933333333333,7.679999999999978,278,294,16,chroma_acts_smoothed
127,8,140.94933333333333,175.50933333333333,34.56,294,366,72,chroma_acts_smoothed
127,9,175.50933333333333,217.39,41.880666666666656,366,452,86,chroma_acts_smoothed
127,1,0.0,3.669333333333334,3.669333333333334,0,8,8,ki_chroma
127,2,3.669333333333334,31.989333333333335,28.32,8,67,59,ki_chroma
127,3,31.989333333333335,60.78933333333333,28.799999999999997,67,127,60,ki_chroma
127,4,60.78933333333333,110.22933333333333,49.44,127,230,103,ki_chroma
127,5,110.22933333333333,118.38933333333333,8.159999999999997,230,247,17,ki_chroma
127,6,118.38933333333333,125.58933333333333,7.200000000000003,247,262,15,ki_chroma
127,7,125.58933333333333,133.26933333333335,7.680000000000021,262,278,16,ki_chroma
127,8,133.26933333333335,175.02933333333334,41.75999999999999,278,365,87,ki_chroma
127,9,175.02933333333334,217.39,42.360666666666646,365,452,87,ki_chroma
127,1,0.0,31.989333333333335,31.989333333333335,0,67,67,ki_chroma_acts
127,2,31.989333333333335,64.62933333333334,32.64,67,135,68,ki_chroma_acts
127,3,64.62933333333334,110.22933333333333,45.599999999999994,135,230,95,ki_chroma_acts
127,4,110.22933333333333,118.38933333333333,8.159999999999997,230,247,17,ki_chroma_acts
127,5,118.38933333333333,126.06933333333333,7.680000000000007,247,263,16,ki_chroma_acts
127,6,126.06933333333333,133.26933333333335,7.200000000000017,263,278,15,ki_chroma_acts
127,7,133.26933333333335,140.94933333333333,7.679999999999978,278,294,16,ki_chroma_acts
127,8,140.94933333333333,175.02933333333334,34.08000000000001,294,365,71,ki_chroma_acts
127,9,175.02933333333334,217.39,42.360666666666646,365,452,87,ki_chroma_acts
127,1,0.0,31.509333333333334,31.509333333333334,0,66,66,ki_chroma_acts_smoothed
127,2,31.509333333333334,65.58933333333333,34.08,66,137,71,ki_chroma_acts_smoothed
127,3,65.58933333333333,110.22933333333333,44.64,137,230,93,ki_chroma_acts_smoothed
127,4,110.22933333333333,118.38933333333333,8.159999999999997,230,247,17,ki_chroma_acts_smoothed
127,5,118.38933333333333,126.06933333333333,7.680000000000007,247,263,16,ki_chroma_acts_smoothed
127,6,126.06933333333333,133.26933333333335,7.200000000000017,263,278,15,ki_chroma_acts_smoothed
127,7,133.26933333333335,140.94933333333333,7.679999999999978,278,294,16,ki_chroma_acts_smoothed
127,8,140.94933333333333,175.50933333333333,34.56,294,366,72,ki_chroma_acts_smoothed
127,9,175.50933333333333,217.39,41.880666666666656,366,452,86,ki_chroma_acts_smoothed
129,1,0.0,44.29866666666666,44.29866666666666,0,97,97,chromagram
129,2,44.29866666666666,74.57066666666665,30.27199999999999,97,163,66,chromagram
129,3,74.57066666666665,88.78933333333332,14.218666666666664,163,194,31,chromagram
129,4,88.78933333333332,103.92533333333331,15.135999999999996,194,227,33,chromagram
129,5,103.92533333333331,118.14399999999999,14.218666666666678,227,258,31,chromagram
129,6,118.14399999999999,127.77599999999998,9.63199999999999,258,279,21,chromagram
129,7,127.77599999999998,132.36266666666666,4.586666666666673,279,289,10,chromagram
129,8,132.36266666666666,186.273,53.91033333333334,289,405,116,chromagram
129,1,0.0,10.815999999999999,10.815999999999999,0,24,24,chroma_acts
129,2,10.815999999999999,44.29866666666666,33.48266666666666,24,97,73,chroma_acts
129,3,44.29866666666666,74.57066666666665,30.27199999999999,97,163,66,chroma_acts
129,4,74.57066666666665,103.46666666666665,28.896,163,226,63,chroma_acts
129,5,103.46666666666665,118.14399999999999,14.677333333333337,226,258,32,chroma_acts
129,6,118.14399999999999,127.77599999999998,9.63199999999999,258,279,21,chroma_acts
129,7,127.77599999999998,132.82133333333334,5.04533333333336,279,290,11,chroma_acts
129,8,132.82133333333334,186.273,53.451666666666654,290,405,115,chroma_acts
129,1,0.0,10.815999999999999,10.815999999999999,0,24,24,chroma_acts_smoothed
129,2,10.815999999999999,44.29866666666666,33.48266666666666,24,97,73,chroma_acts_smoothed
129,3,44.29866666666666,74.57066666666665,30.27199999999999,97,163,66,chroma_acts_smoothed
129,4,74.57066666666665,103.00799999999998,28.437333333333328,163,225,62,chroma_acts_smoothed
129,5,103.00799999999998,117.68533333333332,14.677333333333337,225,257,32,chroma_acts_smoothed
129,6,117.68533333333332,128.69333333333333,11.00800000000001,257,281,24,chroma_acts_smoothed
129,7,128.69333333333333,133.28,4.586666666666673,281,291,10,chroma_acts_smoothed
129,8,133.28,186.273,52.992999999999995,291,405,114,chroma_acts_smoothed
129,1,0.0,44.29866666666666,44.29866666666666,0,97,97,ki_chroma
129,2,44.29866666666666,74.57066666666665,30.27199999999999,97,163,66,ki_chroma
129,3,74.57066666666665,88.78933333333332,14.218666666666664,163,194,31,ki_chroma
129,4,88.78933333333332,103.92533333333331,15.135999999999996,194,227,33,ki_chroma
129,5,103.92533333333331,118.14399999999999,14.218666666666678,227,258,31,ki_chroma
129,6,118.14399999999999,127.77599999999998,9.63199999999999,258,279,21,ki_chroma
129,7,127.77599999999998,132.36266666666666,4.586666666666673,279,289,10,ki_chroma
129,8,132.36266666666666,186.273,53.91033333333334,289,405,116,ki_chroma
129,1,0.0,10.815999999999999,10.815999999999999,0,24,24,ki_chroma_acts
129,2,10.815999999999999,44.29866666666666,33.48266666666666,24,97,73,ki_chroma_acts
129,3,44.29866666666666,74.57066666666665,30.27199999999999,97,163,66,ki_chroma_acts
129,4,74.57066666666665,103.46666666666665,28.896,163,226,63,ki_chroma_acts
129,5,103.46666666666665,118.14399999999999,14.677333333333337,226,258,32,ki_chroma_acts
129,6,118.14399999999999,127.77599999999998,9.63199999999999,258,279,21,ki_chroma_acts
129,7,127.77599999999998,132.82133333333334,5.04533333333336,279,290,11,ki_chroma_acts
129,8,132.82133333333334,186.273,53.451666666666654,290,405,115,ki_chroma_acts
129,1,0.0,10.815999999999999,10.815999999999999,0,24,24,ki_chroma_acts_smoothed
129,2,10.815999999999999,44.29866666666666,33.48266666666666,24,97,73,ki_chroma_acts_smoothed
129,3,44.29866666666666,74.57066666666665,30.27199999999999,97,163,66,ki_chroma_acts_smoothed
129,4,74.57066666666665,103.00799999999998,28.437333333333328,163,225,62,ki_chroma_acts_smoothed
129,5,103.00799999999998,117.68533333333332,14.677333333333337,225,257,32,ki_chroma_acts_smoothed
129,6,117.68533333333332,128.69333333333333,11.00800000000001,257,281,24,ki_chroma_acts_smoothed
129,7,128.69333333333333,133.28,4.586666666666673,281,291,10,ki_chroma_acts_smoothed
129,8,133.28,186.273,52.992999999999995,291,405,114,ki_chroma_acts_smoothed
130,1,0.0,12.426666666666666,12.426666666666666,0,26,26,chromagram
130,2,12.426666666666666,30.666666666666664,18.24,26,64,38,chromagram
130,3,30.666666666666664,59.946666666666665,29.28,64,125,61,chromagram
130,4,59.946666666666665,107.46666666666665,47.51999999999999,125,224,99,chromagram
130,5,107.46666666666665,150.66666666666666,43.2,224,314,90,chromagram
130,6,150.66666666666666,153.54666666666668,2.880000000000024,314,320,6,chromagram
130,7,153.54666666666668,214.98666666666668,61.44,320,448,128,chromagram
130,8,214.98666666666668,234.211,19.224333333333334,448,487,39,chromagram
130,1,0.0,12.426666666666666,12.426666666666666,0,26,26,chroma_acts
130,2,12.426666666666666,30.666666666666664,18.24,26,64,38,chroma_acts
130,3,30.666666666666664,59.946666666666665,29.28,64,125,61,chroma_acts
130,4,59.946666666666665,109.38666666666666,49.43999999999999,125,228,103,chroma_acts
130,5,109.38666666666666,148.74666666666667,39.360000000000014,228,310,82,chroma_acts
130,6,148.74666666666667,153.54666666666668,4.800000000000011,310,320,10,chroma_acts
130,7,153.54666666666668,214.98666666666668,61.44,320,448,128,chroma_acts
130,8,214.98666666666668,234.211,19.224333333333334,448,487,39,chroma_acts
130,1,0.0,12.906666666666666,12.906666666666666,0,27,27,chroma_acts_smoothed
130,2,12.906666666666666,30.666666666666664,17.759999999999998,27,64,37,chroma_acts_smoothed
130,3,30.666666666666664,59.946666666666665,29.28,64,125,61,chroma_acts_smoothed
130,4,59.946666666666665,109.38666666666666,49.43999999999999,125,228,103,chroma_acts_smoothed
130,5,109.38666666666666,147.78666666666666,38.400000000000006,228,308,80,chroma_acts_smoothed
130,6,147.78666666666666,153.54666666666668,5.760000000000019,308,320,12,chroma_acts_smoothed
130,7,153.54666666666668,214.98666666666668,61.44,320,448,128,chroma_acts_smoothed
130,8,214.98666666666668,234.211,19.224333333333334,448,487,39,chroma_acts_smoothed
130,1,0.0,12.426666666666666,12.426666666666666,0,26,26,ki_chroma
130,2,12.426666666666666,30.666666666666664,18.24,26,64,38,ki_chroma
130,3,30.666666666666664,59.946666666666665,29.28,64,125,61,ki_chroma
130,4,59.946666666666665,107.46666666666665,47.51999999999999,125,224,99,ki_chroma
130,5,107.46666666666665,150.66666666666666,43.2,224,314,90,ki_chroma
130,6,150.66666666666666,153.54666666666668,2.880000000000024,314,320,6,ki_chroma
130,7,153.54666666666668,214.98666666666668,61.44,320,448,128,ki_chroma
130,8,214.98666666666668,234.211,19.224333333333334,448,487,39,ki_chroma
130,1,0.0,12.426666666666666,12.426666666666666,0,26,26,ki_chroma_acts
130,2,12.426666666666666,30.666666666666664,18.24,26,64,38,ki_chroma_acts
130,3,30.666666666666664,59.946666666666665,29.28,64,125,61,ki_chroma_acts
130,4,59.946666666666665,109.38666666666666,49.43999999999999,125,228,103,ki_chroma_acts
130,5,109.38666666666666,148.74666666666667,39.360000000000014,228,310,82,ki_chroma_acts
130,6,148.74666666666667,153.54666666666668,4.800000000000011,310,320,10,ki_chroma_acts
130,7,153.54666666666668,214.98666666666668,61.44,320,448,128,ki_chroma_acts
130,8,214.98666666666668,234.211,19.224333333333334,448,487,39,ki_chroma_acts
130,1,0.0,12.906666666666666,12.906666666666666,0,27,27,ki_chroma_acts_smoothed
130,2,12.906666666666666,30.666666666666664,17.759999999999998,27,64,37,ki_chroma_acts_smoothed
130,3,30.666666666666664,59.946666666666665,29.28,64,125,61,ki_chroma_acts_smoothed
130,4,59.946666666666665,109.38666666666666,49.43999999999999,125,228,103,ki_chroma_acts_smoothed
130,5,109.38666666666666,147.78666666666666,38.400000000000006,228,308,80,ki_chroma_acts_smoothed
130,6,147.78666666666666,153.54666666666668,5.760000000000019,308,320,12,ki_chroma_acts_smoothed
130,7,153.54666666666668,214.98666666666668,61.44,320,448,128,ki_chroma_acts_smoothed
130,8,214.98666666666668,234.211,19.224333333333334,448,487,39,ki_chroma_acts_smoothed
131,1,0.0,60.831999999999994,60.831999999999994,0,127,127,chromagram
131,2,60.831999999999994,93.472,32.64,127,195,68,chromagram
131,3,93.472,128.512,35.040000000000006,195,268,73,chromagram
131,4,128.512,132.352,3.8400000000000034,268,276,8,chromagram
131,5,132.352,138.112,5.759999999999991,276,288,12,chromagram
131,6,138.112,143.87199999999999,5.759999999999991,288,300,12,chromagram
131,7,143.87199999999999,147.712,3.8400000000000034,300,308,8,chromagram
131,8,147.712,155.392,7.680000000000007,308,324,16,chromagram
131,9,155.392,202.741,47.34900000000002,324,421,97,chromagram
131,1,0.0,60.831999999999994,60.831999999999994,0,127,127,chroma_acts
131,2,60.831999999999994,93.472,32.64,127,195,68,chroma_acts
131,3,93.472,128.512,35.040000000000006,195,268,73,chroma_acts
131,4,128.512,132.352,3.8400000000000034,268,276,8,chroma_acts
131,5,132.352,138.112,5.759999999999991,276,288,12,chroma_acts
131,6,138.112,143.87199999999999,5.759999999999991,288,300,12,chroma_acts
131,7,143.87199999999999,147.712,3.8400000000000034,300,308,8,chroma_acts
131,8,147.712,155.392,7.680000000000007,308,324,16,chroma_acts
131,9,155.392,202.741,47.34900000000002,324,421,97,chroma_acts
131,1,0.0,60.831999999999994,60.831999999999994,0,127,127,chroma_acts_smoothed
131,2,60.831999999999994,93.472,32.64,127,195,68,chroma_acts_smoothed
131,3,93.472,128.03199999999998,34.55999999999999,195,267,72,chroma_acts_smoothed
131,4,128.03199999999998,131.87199999999999,3.8400000000000034,267,275,8,chroma_acts_smoothed
131,5,131.87199999999999,138.112,6.240000000000009,275,288,13,chroma_acts_smoothed
131,6,138.112,144.352,6.240000000000009,288,301,13,chroma_acts_smoothed
131,7,144.352,147.712,3.359999999999985,301,308,7,chroma_acts_smoothed
131,8,147.712,155.392,7.680000000000007,308,324,16,chroma_acts_smoothed
131,9,155.392,202.741,47.34900000000002,324,421,97,chroma_acts_smoothed
131,1,0.0,60.831999999999994,60.831999999999994,0,127,127,ki_chroma
131,2,60.831999999999994,93.472,32.64,127,195,68,ki_chroma
131,3,93.472,128.512,35.040000000000006,195,268,73,ki_chroma
131,4,128.512,132.352,3.8400000000000034,268,276,8,ki_chroma
131,5,132.352,138.112,5.759999999999991,276,288,12,ki_chroma
131,6,138.112,143.87199999999999,5.759999999999991,288,300,12,ki_chroma
131,7,143.87199999999999,147.712,3.8400000000000034,300,308,8,ki_chroma
131,8,147.712,155.392,7.680000000000007,308,324,16,ki_chroma
131,9,155.392,202.741,47.34900000000002,324,421,97,ki_chroma
131,1,0.0,60.831999999999994,60.831999999999994,0,127,127,ki_chroma_acts
131,2,60.831999999999994,93.472,32.64,127,195,68,ki_chroma_acts
131,3,93.472,128.512,35.040000000000006,195,268,73,ki_chroma_acts
131,4,128.512,132.352,3.8400000000000034,268,276,8,ki_chroma_acts
131,5,132.352,138.112,5.759999999999991,276,288,12,ki_chroma_acts
131,6,138.112,143.87199999999999,5.759999999999991,288,300,12,ki_chroma_acts
131,7,143.87199999999999,147.712,3.8400000000000034,300,308,8,ki_chroma_acts
131,8,147.712,155.392,7.680000000000007,308,324,16,ki_chroma_acts
131,9,155.392,202.741,47.34900000000002,324,421,97,ki_chroma_acts
131,1,0.0,60.831999999999994,60.831999999999994,0,127,127,ki_chroma_acts_smoothed
131,2,60.831999999999994,93.472,32.64,127,195,68,ki_chroma_acts_smoothed
131,3,93.472,128.03199999999998,34.55999999999999,195,267,72,ki_chroma_acts_smoothed
131,4,128.03199999999998,131.87199999999999,3.8400000000000034,267,275,8,ki_chroma_acts_smoothed
131,5,131.87199999999999,138.112,6.240000000000009,275,288,13,ki_chroma_acts_smoothed
131,6,138.112,144.352,6.240000000000009,288,301,13,ki_chroma_acts_smoothed
131,7,144.352,147.712,3.359999999999985,301,308,7,ki_chroma_acts_smoothed
131,8,147.712,155.392,7.680000000000007,308,324,16,ki_chroma_acts_smoothed
131,9,155.392,202.741,47.34900000000002,324,421,97,ki_chroma_acts_smoothed
132,1,0.0,28.661333333333335,28.661333333333335,0,60,60,chromagram
132,2,28.661333333333335,45.94133333333333,17.279999999999998,60,96,36,chromagram
132,3,45.94133333333333,76.18133333333334,30.24000000000001,96,159,63,chromagram
132,4,76.18133333333334,120.82133333333333,44.639999999999986,159,252,93,chromagram
132,5,120.82133333333333,125.62133333333334,4.800000000000011,252,262,10,chromagram
132,6,125.62133333333334,129.46133333333333,3.839999999999989,262,270,8,chromagram
132,7,129.46133333333333,137.1413333333333,7.679999999999978,270,286,16,chromagram
132,8,137.1413333333333,145.78133333333332,8.640000000000015,286,304,18,chromagram
132,9,145.78133333333332,230.609,84.82766666666669,304,479,175,chromagram
132,1,0.0,28.661333333333335,28.661333333333335,0,60,60,chroma_acts
132,2,28.661333333333335,45.94133333333333,17.279999999999998,60,96,36,chroma_acts
132,3,45.94133333333333,76.18133333333334,30.24000000000001,96,159,63,chroma_acts
132,4,76.18133333333334,122.26133333333334,46.08,159,255,96,chroma_acts
132,5,122.26133333333334,125.62133333333334,3.3599999999999994,255,262,7,chroma_acts
132,6,125.62133333333334,129.94133333333332,4.319999999999979,262,271,9,chroma_acts
132,7,129.94133333333332,137.1413333333333,7.199999999999989,271,286,15,chroma_acts
132,8,137.1413333333333,146.74133333333333,9.600000000000023,286,306,20,chroma_acts
132,9,146.74133333333333,230.609,83.86766666666668,306,479,173,chroma_acts
132,1,0.0,28.181333333333335,28.181333333333335,0,59,59,chroma_acts_smoothed
132,2,28.181333333333335,45.94133333333333,17.759999999999998,59,96,37,chroma_acts_smoothed
132,3,45.94133333333333,75.70133333333334,29.760000000000005,96,158,62,chroma_acts_smoothed
132,4,75.70133333333334,120.82133333333333,45.11999999999999,158,252,94,chroma_acts_smoothed
132,5,120.82133333333333,126.10133333333333,5.280000000000001,252,263,11,chroma_acts_smoothed
132,6,126.10133333333333,129.94133333333332,3.839999999999989,263,271,8,chroma_acts_smoothed
132,7,129.94133333333332,137.62133333333333,7.680000000000007,271,287,16,chroma_acts_smoothed
132,8,137.62133333333333,155.38133333333332,17.75999999999999,287,324,37,chroma_acts_smoothed
132,9,155.38133333333332,230.609,75.22766666666669,324,479,155,chroma_acts_smoothed
132,1,0.0,28.661333333333335,28.661333333333335,0,60,60,ki_chroma
132,2,28.661333333333335,45.94133333333333,17.279999999999998,60,96,36,ki_chroma
132,3,45.94133333333333,76.18133333333334,30.24000000000001,96,159,63,ki_chroma
132,4,76.18133333333334,120.82133333333333,44.639999999999986,159,252,93,ki_chroma
132,5,120.82133333333333,125.62133333333334,4.800000000000011,252,262,10,ki_chroma
132,6,125.62133333333334,129.46133333333333,3.839999999999989,262,270,8,ki_chroma
132,7,129.46133333333333,137.1413333333333,7.679999999999978,270,286,16,ki_chroma
132,8,137.1413333333333,145.78133333333332,8.640000000000015,286,304,18,ki_chroma
132,9,145.78133333333332,230.609,84.82766666666669,304,479,175,ki_chroma
132,1,0.0,28.661333333333335,28.661333333333335,0,60,60,ki_chroma_acts
132,2,28.661333333333335,45.94133333333333,17.279999999999998,60,96,36,ki_chroma_acts
132,3,45.94133333333333,76.18133333333334,30.24000000000001,96,159,63,ki_chroma_acts
132,4,76.18133333333334,122.26133333333334,46.08,159,255,96,ki_chroma_acts
132,5,122.26133333333334,125.62133333333334,3.3599999999999994,255,262,7,ki_chroma_acts
132,6,125.62133333333334,129.94133333333332,4.319999999999979,262,271,9,ki_chroma_acts
132,7,129.94133333333332,137.1413333333333,7.199999999999989,271,286,15,ki_chroma_acts
132,8,137.1413333333333,146.74133333333333,9.600000000000023,286,306,20,ki_chroma_acts
132,9,146.74133333333333,230.609,83.86766666666668,306,479,173,ki_chroma_acts
132,1,0.0,28.181333333333335,28.181333333333335,0,59,59,ki_chroma_acts_smoothed
132,2,28.181333333333335,45.94133333333333,17.759999999999998,59,96,37,ki_chroma_acts_smoothed
132,3,45.94133333333333,75.70133333333334,29.760000000000005,96,158,62,ki_chroma_acts_smoothed
132,4,75.70133333333334,120.82133333333333,45.11999999999999,158,252,94,ki_chroma_acts_smoothed
132,5,120.82133333333333,126.10133333333333,5.280000000000001,252,263,11,ki_chroma_acts_smoothed
132,6,126.10133333333333,129.94133333333332,3.839999999999989,263,271,8,ki_chroma_acts_smoothed
132,7,129.94133333333332,137.62133333333333,7.680000000000007,271,287,16,ki_chroma_acts_smoothed
132,8,137.62133333333333,155.38133333333332,17.75999999999999,287,324,37,ki_chroma_acts_smoothed
132,9,155.38133333333332,230.609,75.22766666666669,324,479,155,ki_chroma_acts_smoothed
135,1,0.0,17.322666666666663,17.322666666666663,0,38,38,chromagram
135,2,17.322666666666663,37.504,20.181333333333335,38,82,44,chromagram
135,3,37.504,46.67733333333333,9.173333333333332,82,102,20,chromagram
135,4,46.67733333333333,78.32533333333333,31.648000000000003,102,171,69,chromagram
135,5,78.32533333333333,91.16799999999999,12.84266666666666,171,199,28,chromagram
135,6,91.16799999999999,126.48533333333332,35.31733333333332,199,276,77,chromagram
135,7,126.48533333333332,135.19999999999996,8.714666666666645,276,295,19,chromagram
135,8,135.19999999999996,168.633,33.43300000000005,295,366,71,chromagram
135,1,0.0,15.946666666666665,15.946666666666665,0,35,35,chroma_acts
135,2,15.946666666666665,37.504,21.557333333333332,35,82,47,chroma_acts
135,3,37.504,46.67733333333333,9.173333333333332,82,102,20,chroma_acts
135,4,46.67733333333333,78.32533333333333,31.648000000000003,102,171,69,chroma_acts
135,5,78.32533333333333,91.16799999999999,12.84266666666666,171,199,28,chroma_acts
135,6,91.16799999999999,126.48533333333332,35.31733333333332,199,276,77,chroma_acts
135,7,126.48533333333332,135.19999999999996,8.714666666666645,276,295,19,chroma_acts
135,8,135.19999999999996,168.633,33.43300000000005,295,366,71,chroma_acts
135,1,0.0,15.946666666666665,15.946666666666665,0,35,35,chroma_acts_smoothed
135,2,15.946666666666665,37.504,21.557333333333332,35,82,47,chroma_acts_smoothed
135,3,37.504,46.67733333333333,9.173333333333332,82,102,20,chroma_acts_smoothed
135,4,46.67733333333333,78.32533333333333,31.648000000000003,102,171,69,chroma_acts_smoothed
135,5,78.32533333333333,91.16799999999999,12.84266666666666,171,199,28,chroma_acts_smoothed
135,6,91.16799999999999,126.48533333333332,35.31733333333332,199,276,77,chroma_acts_smoothed
135,7,126.48533333333332,133.82399999999998,7.3386666666666684,276,292,16,chroma_acts_smoothed
135,8,133.82399999999998,168.633,34.809000000000026,292,366,74,chroma_acts_smoothed
135,1,0.0,17.322666666666663,17.322666666666663,0,38,38,ki_chroma
135,2,17.322666666666663,37.504,20.181333333333335,38,82,44,ki_chroma
135,3,37.504,46.67733333333333,9.173333333333332,82,102,20,ki_chroma
135,4,46.67733333333333,78.32533333333333,31.648000000000003,102,171,69,ki_chroma
135,5,78.32533333333333,91.16799999999999,12.84266666666666,171,199,28,ki_chroma
135,6,91.16799999999999,126.48533333333332,35.31733333333332,199,276,77,ki_chroma
135,7,126.48533333333332,135.19999999999996,8.714666666666645,276,295,19,ki_chroma
135,8,135.19999999999996,168.633,33.43300000000005,295,366,71,ki_chroma
135,1,0.0,15.946666666666665,15.946666666666665,0,35,35,ki_chroma_acts
135,2,15.946666666666665,37.504,21.557333333333332,35,82,47,ki_chroma_acts
135,3,37.504,46.67733333333333,9.173333333333332,82,102,20,ki_chroma_acts
135,4,46.67733333333333,78.32533333333333,31.648000000000003,102,171,69,ki_chroma_acts
135,5,78.32533333333333,91.16799999999999,12.84266666666666,171,199,28,ki_chroma_acts
135,6,91.16799999999999,126.48533333333332,35.31733333333332,199,276,77,ki_chroma_acts
135,7,126.48533333333332,135.19999999999996,8.714666666666645,276,295,19,ki_chroma_acts
135,8,135.19999999999996,168.633,33.43300000000005,295,366,71,ki_chroma_acts
135,1,0.0,15.946666666666665,15.946666666666665,0,35,35,ki_chroma_acts_smoothed
135,2,15.946666666666665,37.504,21.557333333333332,35,82,47,ki_chroma_acts_smoothed
135,3,37.504,46.67733333333333,9.173333333333332,82,102,20,ki_chroma_acts_smoothed
135,4,46.67733333333333,78.32533333333333,31.648000000000003,102,171,69,ki_chroma_acts_smoothed
135,5,78.32533333333333,91.16799999999999,12.84266666666666,171,199,28,ki_chroma_acts_smoothed
135,6,91.16799999999999,126.48533333333332,35.31733333333332,199,276,77,ki_chroma_acts_smoothed
135,7,126.48533333333332,133.82399999999998,7.3386666666666684,276,292,16,ki_chroma_acts_smoothed
135,8,133.82399999999998,168.633,34.809000000000026,292,366,74,ki_chroma_acts_smoothed
138,1,0.0,9.194666666666667,9.194666666666667,0,20,20,chromagram
138,2,9.194666666666667,25.152,15.957333333333334,20,54,34,chromagram
138,3,25.152,29.845333333333333,4.693333333333332,54,64,10,chromagram
138,4,29.845333333333333,73.024,43.17866666666667,64,156,92,chromagram
138,5,73.024,81.472,8.447999999999993,156,174,18,chromagram
138,6,81.472,88.98133333333332,7.5093333333333305,174,190,16,chromagram
138,7,88.98133333333332,142.016,53.034666666666666,190,303,113,chromagram
138,8,142.016,157.475,15.459000000000003,303,334,31,chromagram
138,1,0.0,8.725333333333333,8.725333333333333,0,19,19,chroma_acts
138,2,8.725333333333333,14.826666666666666,6.101333333333333,19,32,13,chroma_acts
138,3,14.826666666666666,25.152,10.325333333333335,32,54,22,chroma_acts
138,4,25.152,29.845333333333333,4.693333333333332,54,64,10,chroma_acts
138,5,29.845333333333333,73.024,43.17866666666667,64,156,92,chroma_acts
138,6,73.024,81.472,8.447999999999993,156,174,18,chroma_acts
138,7,81.472,88.98133333333332,7.5093333333333305,174,190,16,chroma_acts
138,8,88.98133333333332,141.54666666666665,52.56533333333333,190,302,112,chroma_acts
138,9,141.54666666666665,157.475,15.928333333333342,302,334,32,chroma_acts
138,1,0.0,8.725333333333333,8.725333333333333,0,19,19,chroma_acts_smoothed
138,2,8.725333333333333,15.296,6.570666666666666,19,33,14,chroma_acts_smoothed
138,3,15.296,24.213333333333335,8.917333333333335,33,52,19,chroma_acts_smoothed
138,4,24.213333333333335,29.845333333333333,5.631999999999998,52,64,12,chroma_acts_smoothed
138,5,29.845333333333333,73.024,43.17866666666667,64,156,92,chroma_acts_smoothed
138,6,73.024,81.94133333333333,8.917333333333332,156,175,19,chroma_acts_smoothed
138,7,81.94133333333333,88.98133333333332,7.039999999999992,175,190,15,chroma_acts_smoothed
138,8,88.98133333333332,141.54666666666665,52.56533333333333,190,302,112,chroma_acts_smoothed
138,9,141.54666666666665,157.475,15.928333333333342,302,334,32,chroma_acts_smoothed
138,1,0.0,9.194666666666667,9.194666666666667,0,20,20,ki_chroma
138,2,9.194666666666667,25.152,15.957333333333334,20,54,34,ki_chroma
138,3,25.152,29.845333333333333,4.693333333333332,54,64,10,ki_chroma
138,4,29.845333333333333,73.024,43.17866666666667,64,156,92,ki_chroma
138,5,73.024,81.472,8.447999999999993,156,174,18,ki_chroma
138,6,81.472,88.98133333333332,7.5093333333333305,174,190,16,ki_chroma
138,7,88.98133333333332,142.016,53.034666666666666,190,303,113,ki_chroma
138,8,142.016,157.475,15.459000000000003,303,334,31,ki_chroma
138,1,0.0,8.725333333333333,8.725333333333333,0,19,19,ki_chroma_acts
138,2,8.725333333333333,14.826666666666666,6.101333333333333,19,32,13,ki_chroma_acts
138,3,14.826666666666666,25.152,10.325333333333335,32,54,22,ki_chroma_acts
138,4,25.152,29.845333333333333,4.693333333333332,54,64,10,ki_chroma_acts
138,5,29.845333333333333,73.024,43.17866666666667,64,156,92,ki_chroma_acts
138,6,73.024,81.472,8.447999999999993,156,174,18,ki_chroma_acts
138,7,81.472,88.98133333333332,7.5093333333333305,174,190,16,ki_chroma_acts
138,8,88.98133333333332,141.54666666666665,52.56533333333333,190,302,112,ki_chroma_acts
138,9,141.54666666666665,157.475,15.928333333333342,302,334,32,ki_chroma_acts
138,1,0.0,8.725333333333333,8.725333333333333,0,19,19,ki_chroma_acts_smoothed
138,2,8.725333333333333,15.296,6.570666666666666,19,33,14,ki_chroma_acts_smoothed
138,3,15.296,24.213333333333335,8.917333333333335,33,52,19,ki_chroma_acts_smoothed
138,4,24.213333333333335,29.845333333333333,5.631999999999998,52,64,12,ki_chroma_acts_smoothed
138,5,29.845333333333333,73.024,43.17866666666667,64,156,92,ki_chroma_acts_smoothed
138,6,73.024,81.94133333333333,8.917333333333332,156,175,19,ki_chroma_acts_smoothed
138,7,81.94133333333333,88.98133333333332,7.039999999999992,175,190,15,ki_chroma_acts_smoothed
138,8,88.98133333333332,141.54666666666665,52.56533333333333,190,302,112,ki_chroma_acts_smoothed
138,9,141.54666666666665,157.475,15.928333333333342,302,334,32,ki_chroma_acts_smoothed
139,1,0.0,7.029333333333333,7.029333333333333,0,15,15,chromagram
139,2,7.029333333333333,21.429333333333332,14.399999999999999,15,45,30,chromagram
139,3,21.429333333333332,27.669333333333334,6.240000000000002,45,58,13,chromagram
139,4,27.669333333333334,36.78933333333333,9.119999999999997,58,77,19,chromagram
139,5,36.78933333333333,84.78933333333332,47.999999999999986,77,177,100,chromagram
139,6,84.78933333333332,92.94933333333333,8.16000000000001,177,194,17,chromagram
139,7,92.94933333333333,121.74933333333333,28.799999999999997,194,254,60,chromagram
139,8,121.74933333333333,165.391,43.641666666666666,254,343,89,chromagram
139,1,0.0,7.029333333333333,7.029333333333333,0,15,15,chroma_acts
139,2,7.029333333333333,21.429333333333332,14.399999999999999,15,45,30,chroma_acts
139,3,21.429333333333332,27.669333333333334,6.240000000000002,45,58,13,chroma_acts
139,4,27.669333333333334,38.70933333333333,11.04,58,81,23,chroma_acts
139,5,38.70933333333333,84.78933333333332,46.079999999999984,81,177,96,chroma_acts
139,6,84.78933333333332,92.94933333333333,8.16000000000001,177,194,17,chroma_acts
139,7,92.94933333333333,122.22933333333333,29.28,194,255,61,chroma_acts
139,8,122.22933333333333,165.391,43.16166666666666,255,343,88,chroma_acts
139,1,0.0,7.509333333333332,7.509333333333332,0,16,16,chroma_acts_smoothed
139,2,7.509333333333332,21.429333333333332,13.92,16,45,29,chroma_acts_smoothed
139,3,21.429333333333332,27.669333333333334,6.240000000000002,45,58,13,chroma_acts_smoothed
139,4,27.669333333333334,38.22933333333334,10.560000000000002,58,80,22,chroma_acts_smoothed
139,5,38.22933333333334,84.78933333333332,46.55999999999998,80,177,97,chroma_acts_smoothed
139,6,84.78933333333332,92.94933333333333,8.16000000000001,177,194,17,chroma_acts_smoothed
139,7,92.94933333333333,123.18933333333332,30.239999999999995,194,257,63,chroma_acts_smoothed
139,8,123.18933333333332,165.391,42.20166666666667,257,343,86,chroma_acts_smoothed
139,1,0.0,7.029333333333333,7.029333333333333,0,15,15,ki_chroma
139,2,7.029333333333333,21.429333333333332,14.399999999999999,15,45,30,ki_chroma
139,3,21.429333333333332,27.669333333333334,6.240000000000002,45,58,13,ki_chroma
139,4,27.669333333333334,36.78933333333333,9.119999999999997,58,77,19,ki_chroma
139,5,36.78933333333333,84.78933333333332,47.999999999999986,77,177,100,ki_chroma
139,6,84.78933333333332,92.94933333333333,8.16000000000001,177,194,17,ki_chroma
139,7,92.94933333333333,121.74933333333333,28.799999999999997,194,254,60,ki_chroma
139,8,121.74933333333333,165.391,43.641666666666666,254,343,89,ki_chroma
139,1,0.0,7.029333333333333,7.029333333333333,0,15,15,ki_chroma_acts
139,2,7.029333333333333,21.429333333333332,14.399999999999999,15,45,30,ki_chroma_acts
139,3,21.429333333333332,27.669333333333334,6.240000000000002,45,58,13,ki_chroma_acts
139,4,27.669333333333334,38.70933333333333,11.04,58,81,23,ki_chroma_acts
139,5,38.70933333333333,84.78933333333332,46.079999999999984,81,177,96,ki_chroma_acts
139,6,84.78933333333332,92.94933333333333,8.16000000000001,177,194,17,ki_chroma_acts
139,7,92.94933333333333,122.22933333333333,29.28,194,255,61,ki_chroma_acts
139,8,122.22933333333333,165.391,43.16166666666666,255,343,88,ki_chroma_acts
139,1,0.0,7.509333333333332,7.509333333333332,0,16,16,ki_chroma_acts_smoothed
139,2,7.509333333333332,21.429333333333332,13.92,16,45,29,ki_chroma_acts_smoothed
139,3,21.429333333333332,27.669333333333334,6.240000000000002,45,58,13,ki_chroma_acts_smoothed
139,4,27.669333333333334,38.22933333333334,10.560000000000002,58,80,22,ki_chroma_acts_smoothed
139,5,38.22933333333334,84.78933333333332,46.55999999999998,80,177,97,ki_chroma_acts_smoothed
139,6,84.78933333333332,92.94933333333333,8.16000000000001,177,194,17,ki_chroma_acts_smoothed
139,7,92.94933333333333,123.18933333333332,30.239999999999995,194,257,63,ki_chroma_acts_smoothed
139,8,123.18933333333332,165.391,42.20166666666667,257,343,86,ki_chroma_acts_smoothed
140,1,0.0,14.613333333333335,14.613333333333335,0,21,21,chromagram
140,2,14.613333333333335,16.789333333333335,2.176,21,24,3,chromagram
140,3,16.789333333333335,49.42933333333334,32.64,24,69,45,chromagram
140,4,49.42933333333334,76.992,27.562666666666665,69,107,38,chromagram
140,5,76.992,94.4,17.408,107,131,24,chromagram
140,6,94.4,119.06133333333334,24.66133333333333,131,165,34,chromagram
140,7,119.06133333333334,152.477,33.41566666666667,165,210,45,chromagram
140,1,0.0,14.613333333333335,14.613333333333335,0,21,21,chroma_acts
140,2,14.613333333333335,16.789333333333335,2.176,21,24,3,chroma_acts
140,3,16.789333333333335,49.42933333333334,32.64,24,69,45,chroma_acts
140,4,49.42933333333334,76.992,27.562666666666665,69,107,38,chroma_acts
140,5,76.992,94.4,17.408,107,131,24,chroma_acts
140,6,94.4,119.06133333333334,24.66133333333333,131,165,34,chroma_acts
140,7,119.06133333333334,152.477,33.41566666666667,165,210,45,chroma_acts
140,1,0.0,14.613333333333335,14.613333333333335,0,21,21,chroma_acts_smoothed
140,2,14.613333333333335,16.789333333333335,2.176,21,24,3,chroma_acts_smoothed
140,3,16.789333333333335,47.97866666666667,31.189333333333334,24,67,43,chroma_acts_smoothed
140,4,47.97866666666667,76.992,29.013333333333335,67,107,40,chroma_acts_smoothed
140,5,76.992,94.4,17.408,107,131,24,chroma_acts_smoothed
140,6,94.4,119.06133333333334,24.66133333333333,131,165,34,chroma_acts_smoothed
140,7,119.06133333333334,152.477,33.41566666666667,165,210,45,chroma_acts_smoothed
140,1,0.0,14.613333333333335,14.613333333333335,0,21,21,ki_chroma
140,2,14.613333333333335,16.789333333333335,2.176,21,24,3,ki_chroma
140,3,16.789333333333335,49.42933333333334,32.64,24,69,45,ki_chroma
140,4,49.42933333333334,76.992,27.562666666666665,69,107,38,ki_chroma
140,5,76.992,94.4,17.408,107,131,24,ki_chroma
140,6,94.4,119.06133333333334,24.66133333333333,131,165,34,ki_chroma
140,7,119.06133333333334,152.477,33.41566666666667,165,210,45,ki_chroma
140,1,0.0,14.613333333333335,14.613333333333335,0,21,21,ki_chroma_acts
140,2,14.613333333333335,16.789333333333335,2.176,21,24,3,ki_chroma_acts
140,3,16.789333333333335,49.42933333333334,32.64,24,69,45,ki_chroma_acts
140,4,49.42933333333334,76.992,27.562666666666665,69,107,38,ki_chroma_acts
140,5,76.992,94.4,17.408,107,131,24,ki_chroma_acts
140,6,94.4,119.06133333333334,24.66133333333333,131,165,34,ki_chroma_acts
140,7,119.06133333333334,152.477,33.41566666666667,165,210,45,ki_chroma_acts
140,1,0.0,14.613333333333335,14.613333333333335,0,21,21,ki_chroma_acts_smoothed
140,2,14.613333333333335,16.789333333333335,2.176,21,24,3,ki_chroma_acts_smoothed
140,3,16.789333333333335,47.97866666666667,31.189333333333334,24,67,43,ki_chroma_acts_smoothed
140,4,47.97866666666667,76.992,29.013333333333335,67,107,40,ki_chroma_acts_smoothed
140,5,76.992,94.4,17.408,107,131,24,ki_chroma_acts_smoothed
140,6,94.4,119.06133333333334,24.66133333333333,131,165,34,ki_chroma_acts_smoothed
140,7,119.06133333333334,152.477,33.41566666666667,165,210,45,ki_chroma_acts_smoothed
141,1,0.0,19.722666666666665,19.722666666666665,0,42,42,chromagram
141,2,19.722666666666665,85.00266666666666,65.27999999999999,42,178,136,chromagram
141,3,85.00266666666666,89.32266666666666,4.320000000000007,178,187,9,chromagram
141,4,89.32266666666666,92.20266666666666,2.8799999999999955,187,193,6,chromagram
141,5,92.20266666666666,99.88266666666667,7.680000000000007,193,209,16,chromagram
141,6,99.88266666666667,129.16266666666667,29.28,209,270,61,chromagram
141,7,129.16266666666667,130.60266666666666,1.4399999999999977,270,273,3,chromagram
141,8,130.60266666666666,148.5,17.897333333333336,273,309,36,chromagram
141,1,0.0,19.242666666666665,19.242666666666665,0,41,41,chroma_acts
141,2,19.242666666666665,67.24266666666666,48.0,41,141,100,chroma_acts
141,3,67.24266666666666,69.16266666666667,1.9200000000000017,141,145,4,chroma_acts
141,4,69.16266666666667,85.00266666666666,15.83999999999999,145,178,33,chroma_acts
141,5,85.00266666666666,99.88266666666667,14.88000000000001,178,209,31,chroma_acts
141,6,99.88266666666667,129.16266666666667,29.28,209,270,61,chroma_acts
141,7,129.16266666666667,130.60266666666666,1.4399999999999977,270,273,3,chroma_acts
141,8,130.60266666666666,148.5,17.897333333333336,273,309,36,chroma_acts
141,1,0.0,19.242666666666665,19.242666666666665,0,41,41,chroma_acts_smoothed
141,2,19.242666666666665,23.082666666666665,3.84,41,49,8,chroma_acts_smoothed
141,3,23.082666666666665,85.48266666666666,62.39999999999999,49,179,130,chroma_acts_smoothed
141,4,85.48266666666666,96.04266666666666,10.560000000000002,179,201,22,chroma_acts_smoothed
141,5,96.04266666666666,99.88266666666667,3.8400000000000034,201,209,8,chroma_acts_smoothed
141,6,99.88266666666667,128.68266666666668,28.80000000000001,209,269,60,chroma_acts_smoothed
141,7,128.68266666666668,130.60266666666666,1.9199999999999875,269,273,4,chroma_acts_smoothed
141,8,130.60266666666666,148.5,17.897333333333336,273,309,36,chroma_acts_smoothed
141,1,0.0,19.722666666666665,19.722666666666665,0,42,42,ki_chroma
141,2,19.722666666666665,85.00266666666666,65.27999999999999,42,178,136,ki_chroma
141,3,85.00266666666666,89.32266666666666,4.320000000000007,178,187,9,ki_chroma
141,4,89.32266666666666,92.20266666666666,2.8799999999999955,187,193,6,ki_chroma
141,5,92.20266666666666,99.88266666666667,7.680000000000007,193,209,16,ki_chroma
141,6,99.88266666666667,129.16266666666667,29.28,209,270,61,ki_chroma
141,7,129.16266666666667,130.60266666666666,1.4399999999999977,270,273,3,ki_chroma
141,8,130.60266666666666,148.5,17.897333333333336,273,309,36,ki_chroma
141,1,0.0,19.242666666666665,19.242666666666665,0,41,41,ki_chroma_acts
141,2,19.242666666666665,67.24266666666666,48.0,41,141,100,ki_chroma_acts
141,3,67.24266666666666,69.16266666666667,1.9200000000000017,141,145,4,ki_chroma_acts
141,4,69.16266666666667,85.00266666666666,15.83999999999999,145,178,33,ki_chroma_acts
141,5,85.00266666666666,99.88266666666667,14.88000000000001,178,209,31,ki_chroma_acts
141,6,99.88266666666667,129.16266666666667,29.28,209,270,61,ki_chroma_acts
141,7,129.16266666666667,130.60266666666666,1.4399999999999977,270,273,3,ki_chroma_acts
141,8,130.60266666666666,148.5,17.897333333333336,273,309,36,ki_chroma_acts
141,1,0.0,19.242666666666665,19.242666666666665,0,41,41,ki_chroma_acts_smoothed
141,2,19.242666666666665,23.082666666666665,3.84,41,49,8,ki_chroma_acts_smoothed
141,3,23.082666666666665,85.48266666666666,62.39999999999999,49,179,130,ki_chroma_acts_smoothed
141,4,85.48266666666666,96.04266666666666,10.560000000000002,179,201,22,ki_chroma_acts_smoothed
141,5,96.04266666666666,99.88266666666667,3.8400000000000034,201,209,8,ki_chroma_acts_smoothed
141,6,99.88266666666667,128.68266666666668,28.80000000000001,209,269,60,ki_chroma_acts_smoothed
141,7,128.68266666666668,130.60266666666666,1.9199999999999875,269,273,4,ki_chroma_acts_smoothed
141,8,130.60266666666666,148.5,17.897333333333336,273,309,36,ki_chroma_acts_smoothed
142,1,0.0,53.78133333333333,53.78133333333333,0,113,113,chromagram
142,2,53.78133333333333,97.46133333333333,43.68,113,204,91,chromagram
142,3,97.46133333333333,99.38133333333333,1.9200000000000017,204,208,4,chromagram
142,4,99.38133333333333,129.62133333333333,30.239999999999995,208,271,63,chromagram
142,5,129.62133333333333,145.46133333333333,15.840000000000003,271,304,33,chromagram
142,6,145.46133333333333,187.22133333333332,41.75999999999999,304,391,87,chromagram
142,7,187.22133333333332,193.018,5.796666666666681,391,402,11,chromagram
142,1,0.0,8.181333333333333,8.181333333333333,0,18,18,chroma_acts
142,2,8.181333333333333,12.021333333333333,3.84,18,26,8,chroma_acts
142,3,12.021333333333333,15.861333333333333,3.84,26,34,8,chroma_acts
142,4,15.861333333333333,53.78133333333333,37.919999999999995,34,113,79,chroma_acts
142,5,53.78133333333333,130.10133333333332,76.32,113,272,159,chroma_acts
142,6,130.10133333333332,145.46133333333333,15.360000000000014,272,304,32,chroma_acts
142,7,145.46133333333333,193.018,47.55666666666667,304,402,98,chroma_acts
142,1,0.0,53.78133333333333,53.78133333333333,0,113,113,chroma_acts_smoothed
142,2,53.78133333333333,95.54133333333333,41.76,113,200,87,chroma_acts_smoothed
142,3,95.54133333333333,99.38133333333333,3.8400000000000034,200,208,8,chroma_acts_smoothed
142,4,99.38133333333333,130.10133333333332,30.719999999999985,208,272,64,chroma_acts_smoothed
142,5,130.10133333333332,137.30133333333333,7.200000000000017,272,287,15,chroma_acts_smoothed
142,6,137.30133333333333,144.98133333333334,7.680000000000007,287,303,16,chroma_acts_smoothed
142,7,144.98133333333334,193.018,48.03666666666666,303,402,99,chroma_acts_smoothed
142,1,0.0,53.78133333333333,53.78133333333333,0,113,113,ki_chroma
142,2,53.78133333333333,97.46133333333333,43.68,113,204,91,ki_chroma
142,3,97.46133333333333,99.38133333333333,1.9200000000000017,204,208,4,ki_chroma
142,4,99.38133333333333,129.62133333333333,30.239999999999995,208,271,63,ki_chroma
142,5,129.62133333333333,145.46133333333333,15.840000000000003,271,304,33,ki_chroma
142,6,145.46133333333333,187.22133333333332,41.75999999999999,304,391,87,ki_chroma
142,7,187.22133333333332,193.018,5.796666666666681,391,402,11,ki_chroma
142,1,0.0,8.181333333333333,8.181333333333333,0,18,18,ki_chroma_acts
142,2,8.181333333333333,12.021333333333333,3.84,18,26,8,ki_chroma_acts
142,3,12.021333333333333,15.861333333333333,3.84,26,34,8,ki_chroma_acts
142,4,15.861333333333333,53.78133333333333,37.919999999999995,34,113,79,ki_chroma_acts
142,5,53.78133333333333,130.10133333333332,76.32,113,272,159,ki_chroma_acts
142,6,130.10133333333332,145.46133333333333,15.360000000000014,272,304,32,ki_chroma_acts
142,7,145.46133333333333,193.018,47.55666666666667,304,402,98,ki_chroma_acts
142,1,0.0,53.78133333333333,53.78133333333333,0,113,113,ki_chroma_acts_smoothed
142,2,53.78133333333333,95.54133333333333,41.76,113,200,87,ki_chroma_acts_smoothed
142,3,95.54133333333333,99.38133333333333,3.8400000000000034,200,208,8,ki_chroma_acts_smoothed
142,4,99.38133333333333,130.10133333333332,30.719999999999985,208,272,64,ki_chroma_acts_smoothed
142,5,130.10133333333332,137.30133333333333,7.200000000000017,272,287,15,ki_chroma_acts_smoothed
142,6,137.30133333333333,144.98133333333334,7.680000000000007,287,303,16,ki_chroma_acts_smoothed
142,7,144.98133333333334,193.018,48.03666666666666,303,402,99,ki_chroma_acts_smoothed
143,1,0.0,11.317333333333332,11.317333333333332,0,24,24,chromagram
143,2,11.317333333333332,15.637333333333332,4.32,24,33,9,chromagram
143,3,15.637333333333332,26.67733333333333,11.039999999999997,33,56,23,chromagram
143,4,26.67733333333333,30.99733333333333,4.32,56,65,9,chromagram
143,5,30.99733333333333,51.157333333333334,20.160000000000004,65,107,42,chromagram
143,6,51.157333333333334,107.79733333333333,56.63999999999999,107,225,118,chromagram
143,7,107.79733333333333,127.95733333333332,20.159999999999997,225,267,42,chromagram
143,8,127.95733333333332,156.75733333333332,28.799999999999997,267,327,60,chromagram
143,9,156.75733333333332,171.868,15.110666666666674,327,357,30,chromagram
143,1,0.0,11.317333333333332,11.317333333333332,0,24,24,chroma_acts
143,2,11.317333333333332,15.637333333333332,4.32,24,33,9,chroma_acts
143,3,15.637333333333332,26.67733333333333,11.039999999999997,33,56,23,chroma_acts
143,4,26.67733333333333,30.99733333333333,4.32,56,65,9,chroma_acts
143,5,30.99733333333333,51.157333333333334,20.160000000000004,65,107,42,chroma_acts
143,6,51.157333333333334,107.79733333333333,56.63999999999999,107,225,118,chroma_acts
143,7,107.79733333333333,123.63733333333333,15.840000000000003,225,258,33,chroma_acts
143,8,123.63733333333333,171.868,48.230666666666664,258,357,99,chroma_acts
143,1,0.0,10.837333333333333,10.837333333333333,0,23,23,chroma_acts_smoothed
143,2,10.837333333333333,17.077333333333332,6.239999999999998,23,36,13,chroma_acts_smoothed
143,3,17.077333333333332,26.67733333333333,9.599999999999998,36,56,20,chroma_acts_smoothed
143,4,26.67733333333333,30.99733333333333,4.32,56,65,9,chroma_acts_smoothed
143,5,30.99733333333333,51.157333333333334,20.160000000000004,65,107,42,chroma_acts_smoothed
143,6,51.157333333333334,107.79733333333333,56.63999999999999,107,225,118,chroma_acts_smoothed
143,7,107.79733333333333,126.03733333333334,18.24000000000001,225,263,38,chroma_acts_smoothed
143,8,126.03733333333334,171.868,45.83066666666666,263,357,94,chroma_acts_smoothed
143,1,0.0,11.317333333333332,11.317333333333332,0,24,24,ki_chroma
143,2,11.317333333333332,15.637333333333332,4.32,24,33,9,ki_chroma
143,3,15.637333333333332,26.67733333333333,11.039999999999997,33,56,23,ki_chroma
143,4,26.67733333333333,30.99733333333333,4.32,56,65,9,ki_chroma
143,5,30.99733333333333,51.157333333333334,20.160000000000004,65,107,42,ki_chroma
143,6,51.157333333333334,107.79733333333333,56.63999999999999,107,225,118,ki_chroma
143,7,107.79733333333333,127.95733333333332,20.159999999999997,225,267,42,ki_chroma
143,8,127.95733333333332,156.75733333333332,28.799999999999997,267,327,60,ki_chroma
143,9,156.75733333333332,171.868,15.110666666666674,327,357,30,ki_chroma
143,1,0.0,11.317333333333332,11.317333333333332,0,24,24,ki_chroma_acts
143,2,11.317333333333332,15.637333333333332,4.32,24,33,9,ki_chroma_acts
143,3,15.637333333333332,26.67733333333333,11.039999999999997,33,56,23,ki_chroma_acts
143,4,26.67733333333333,30.99733333333333,4.32,56,65,9,ki_chroma_acts
143,5,30.99733333333333,51.157333333333334,20.160000000000004,65,107,42,ki_chroma_acts
143,6,51.157333333333334,107.79733333333333,56.63999999999999,107,225,118,ki_chroma_acts
143,7,107.79733333333333,123.63733333333333,15.840000000000003,225,258,33,ki_chroma_acts
143,8,123.63733333333333,171.868,48.230666666666664,258,357,99,ki_chroma_acts
143,1,0.0,10.837333333333333,10.837333333333333,0,23,23,ki_chroma_acts_smoothed
143,2,10.837333333333333,17.077333333333332,6.239999999999998,23,36,13,ki_chroma_acts_smoothed
143,3,17.077333333333332,26.67733333333333,9.599999999999998,36,56,20,ki_chroma_acts_smoothed
143,4,26.67733333333333,30.99733333333333,4.32,56,65,9,ki_chroma_acts_smoothed
143,5,30.99733333333333,51.157333333333334,20.160000000000004,65,107,42,ki_chroma_acts_smoothed
143,6,51.157333333333334,107.79733333333333,56.63999999999999,107,225,118,ki_chroma_acts_smoothed
143,7,107.79733333333333,126.03733333333334,18.24000000000001,225,263,38,ki_chroma_acts_smoothed
143,8,126.03733333333334,171.868,45.83066666666666,263,357,94,ki_chroma_acts_smoothed
144,1,0.0,21.781333333333333,21.781333333333333,0,46,46,chromagram
144,2,21.781333333333333,23.701333333333334,1.9200000000000017,46,50,4,chromagram
144,3,23.701333333333334,69.30133333333333,45.599999999999994,50,145,95,chromagram
144,4,69.30133333333333,85.62133333333333,16.319999999999993,145,179,34,chromagram
144,5,85.62133333333333,96.66133333333332,11.039999999999992,179,202,23,chromagram
144,6,96.66133333333332,100.98133333333332,4.320000000000007,202,211,9,chromagram
144,7,100.98133333333332,102.90133333333333,1.9200000000000017,211,215,4,chromagram
144,8,102.90133333333333,132.18133333333333,29.28,215,276,61,chromagram
144,9,132.18133333333333,147.038,14.856666666666683,276,305,29,chromagram
144,1,0.0,23.701333333333334,23.701333333333334,0,50,50,chroma_acts
144,2,23.701333333333334,70.74133333333333,47.03999999999999,50,148,98,chroma_acts
144,3,70.74133333333333,85.62133333333333,14.879999999999995,148,179,31,chroma_acts
144,4,85.62133333333333,96.66133333333332,11.039999999999992,179,202,23,chroma_acts
144,5,96.66133333333332,100.98133333333332,4.320000000000007,202,211,9,chroma_acts
144,6,100.98133333333332,111.06133333333332,10.079999999999998,211,232,21,chroma_acts
144,7,111.06133333333332,132.18133333333333,21.120000000000005,232,276,44,chroma_acts
144,8,132.18133333333333,147.038,14.856666666666683,276,305,29,chroma_acts
144,1,0.0,25.621333333333332,25.621333333333332,0,54,54,chroma_acts_smoothed
144,2,25.621333333333332,70.26133333333333,44.63999999999999,54,147,93,chroma_acts_smoothed
144,3,70.26133333333333,87.06133333333332,16.799999999999997,147,182,35,chroma_acts_smoothed
144,4,87.06133333333332,96.66133333333332,9.599999999999994,182,202,20,chroma_acts_smoothed
144,5,96.66133333333332,100.50133333333332,3.8400000000000034,202,210,8,chroma_acts_smoothed
144,6,100.50133333333332,103.38133333333333,2.8800000000000097,210,216,6,chroma_acts_smoothed
144,7,103.38133333333333,132.18133333333333,28.799999999999997,216,276,60,chroma_acts_smoothed
144,8,132.18133333333333,147.038,14.856666666666683,276,305,29,chroma_acts_smoothed
144,1,0.0,21.781333333333333,21.781333333333333,0,46,46,ki_chroma
144,2,21.781333333333333,23.701333333333334,1.9200000000000017,46,50,4,ki_chroma
144,3,23.701333333333334,69.30133333333333,45.599999999999994,50,145,95,ki_chroma
144,4,69.30133333333333,85.62133333333333,16.319999999999993,145,179,34,ki_chroma
144,5,85.62133333333333,96.66133333333332,11.039999999999992,179,202,23,ki_chroma
144,6,96.66133333333332,100.98133333333332,4.320000000000007,202,211,9,ki_chroma
144,7,100.98133333333332,102.90133333333333,1.9200000000000017,211,215,4,ki_chroma
144,8,102.90133333333333,132.18133333333333,29.28,215,276,61,ki_chroma
144,9,132.18133333333333,147.038,14.856666666666683,276,305,29,ki_chroma
144,1,0.0,23.701333333333334,23.701333333333334,0,50,50,ki_chroma_acts
144,2,23.701333333333334,70.74133333333333,47.03999999999999,50,148,98,ki_chroma_acts
144,3,70.74133333333333,85.62133333333333,14.879999999999995,148,179,31,ki_chroma_acts
144,4,85.62133333333333,96.66133333333332,11.039999999999992,179,202,23,ki_chroma_acts
144,5,96.66133333333332,100.98133333333332,4.320000000000007,202,211,9,ki_chroma_acts
144,6,100.98133333333332,111.06133333333332,10.079999999999998,211,232,21,ki_chroma_acts
144,7,111.06133333333332,132.18133333333333,21.120000000000005,232,276,44,ki_chroma_acts
144,8,132.18133333333333,147.038,14.856666666666683,276,305,29,ki_chroma_acts
144,1,0.0,25.621333333333332,25.621333333333332,0,54,54,ki_chroma_acts_smoothed
144,2,25.621333333333332,70.26133333333333,44.63999999999999,54,147,93,ki_chroma_acts_smoothed
144,3,70.26133333333333,87.06133333333332,16.799999999999997,147,182,35,ki_chroma_acts_smoothed
144,4,87.06133333333332,96.66133333333332,9.599999999999994,182,202,20,ki_chroma_acts_smoothed
144,5,96.66133333333332,100.50133333333332,3.8400000000000034,202,210,8,ki_chroma_acts_smoothed
144,6,100.50133333333332,103.38133333333333,2.8800000000000097,210,216,6,ki_chroma_acts_smoothed
144,7,103.38133333333333,132.18133333333333,28.799999999999997,216,276,60,ki_chroma_acts_smoothed
144,8,132.18133333333333,147.038,14.856666666666683,276,305,29,ki_chroma_acts_smoothed
145,1,0.0,15.104,15.104,0,40,40,chromagram
145,2,15.104,29.695999999999998,14.591999999999999,40,78,38,chromagram
145,3,29.695999999999998,34.688,4.992000000000004,78,91,13,chromagram
145,4,34.688,39.296,4.607999999999997,91,103,12,chromagram
145,5,39.296,77.696,38.4,103,203,100,chromagram
145,6,77.696,84.60799999999999,6.911999999999992,203,221,18,chromagram
145,7,84.60799999999999,113.792,29.18400000000001,221,297,76,chromagram
145,8,113.792,120.704,6.911999999999992,297,315,18,chromagram
145,9,120.704,148.421,27.717,315,386,71,chromagram
145,1,0.0,29.695999999999998,29.695999999999998,0,78,78,chroma_acts
145,2,29.695999999999998,34.688,4.992000000000004,78,91,13,chroma_acts
145,3,34.688,39.296,4.607999999999997,91,103,12,chroma_acts
145,4,39.296,47.744,8.448,103,125,22,chroma_acts
145,5,47.744,77.696,29.951999999999998,125,203,78,chroma_acts
145,6,77.696,84.60799999999999,6.911999999999992,203,221,18,chroma_acts
145,7,84.60799999999999,113.792,29.18400000000001,221,297,76,chroma_acts
145,8,113.792,120.704,6.911999999999992,297,315,18,chroma_acts
145,9,120.704,148.421,27.717,315,386,71,chroma_acts
145,1,0.0,16.64,16.64,0,44,44,chroma_acts_smoothed
145,2,16.64,29.695999999999998,13.055999999999997,44,78,34,chroma_acts_smoothed
145,3,29.695999999999998,34.688,4.992000000000004,78,91,13,chroma_acts_smoothed
145,4,34.688,39.296,4.607999999999997,91,103,12,chroma_acts_smoothed
145,5,39.296,77.696,38.4,103,203,100,chroma_acts_smoothed
145,6,77.696,84.60799999999999,6.911999999999992,203,221,18,chroma_acts_smoothed
145,7,84.60799999999999,114.176,29.568000000000012,221,298,77,chroma_acts_smoothed
145,8,114.176,120.704,6.527999999999992,298,315,17,chroma_acts_smoothed
145,9,120.704,148.421,27.717,315,386,71,chroma_acts_smoothed
145,1,0.0,15.104,15.104,0,40,40,ki_chroma
145,2,15.104,29.695999999999998,14.591999999999999,40,78,38,ki_chroma
145,3,29.695999999999998,34.688,4.992000000000004,78,91,13,ki_chroma
145,4,34.688,39.296,4.607999999999997,91,103,12,ki_chroma
145,5,39.296,77.696,38.4,103,203,100,ki_chroma
145,6,77.696,84.60799999999999,6.911999999999992,203,221,18,ki_chroma
145,7,84.60799999999999,113.792,29.18400000000001,221,297,76,ki_chroma
145,8,113.792,120.704,6.911999999999992,297,315,18,ki_chroma
145,9,120.704,148.421,27.717,315,386,71,ki_chroma
145,1,0.0,29.695999999999998,29.695999999999998,0,78,78,ki_chroma_acts
145,2,29.695999999999998,34.688,4.992000000000004,78,91,13,ki_chroma_acts
145,3,34.688,39.296,4.607999999999997,91,103,12,ki_chroma_acts
145,4,39.296,47.744,8.448,103,125,22,ki_chroma_acts
145,5,47.744,77.696,29.951999999999998,125,203,78,ki_chroma_acts
145,6,77.696,84.60799999999999,6.911999999999992,203,221,18,ki_chroma_acts
145,7,84.60799999999999,113.792,29.18400000000001,221,297,76,ki_chroma_acts
145,8,113.792,120.704,6.911999999999992,297,315,18,ki_chroma_acts
145,9,120.704,148.421,27.717,315,386,71,ki_chroma_acts
145,1,0.0,16.64,16.64,0,44,44,ki_chroma_acts_smoothed
145,2,16.64,29.695999999999998,13.055999999999997,44,78,34,ki_chroma_acts_smoothed
145,3,29.695999999999998,34.688,4.992000000000004,78,91,13,ki_chroma_acts_smoothed
145,4,34.688,39.296,4.607999999999997,91,103,12,ki_chroma_acts_smoothed
145,5,39.296,77.696,38.4,103,203,100,ki_chroma_acts_smoothed
145,6,77.696,84.60799999999999,6.911999999999992,203,221,18,ki_chroma_acts_smoothed
145,7,84.60799999999999,114.176,29.568000000000012,221,298,77,ki_chroma_acts_smoothed
145,8,114.176,120.704,6.527999999999992,298,315,17,ki_chroma_acts_smoothed
145,9,120.704,148.421,27.717,315,386,71,ki_chroma_acts_smoothed
147,1,0.0,22.634666666666664,22.634666666666664,0,49,49,chromagram
147,2,22.634666666666664,32.02133333333333,9.386666666666667,49,69,20,chromagram
147,3,32.02133333333333,82.70933333333333,50.688,69,177,108,chromagram
147,4,82.70933333333333,92.096,9.38666666666667,177,197,20,chromagram
147,5,92.096,135.27466666666666,43.17866666666666,197,289,92,chromagram
147,6,135.27466666666666,139.0293333333333,3.754666666666651,289,297,8,chromagram
147,7,139.0293333333333,142.784,3.7546666666666795,297,305,8,chromagram
147,8,142.784,150.47,7.686000000000007,305,320,15,chromagram
147,1,0.0,22.634666666666664,22.634666666666664,0,49,49,chroma_acts
147,2,22.634666666666664,32.02133333333333,9.386666666666667,49,69,20,chroma_acts
147,3,32.02133333333333,82.70933333333333,50.688,69,177,108,chroma_acts
147,4,82.70933333333333,92.096,9.38666666666667,177,197,20,chroma_acts
147,5,92.096,134.80533333333332,42.70933333333332,197,288,91,chroma_acts
147,6,134.80533333333332,139.49866666666665,4.693333333333328,288,298,10,chroma_acts
147,7,139.49866666666665,142.784,3.285333333333341,298,305,7,chroma_acts
147,8,142.784,150.47,7.686000000000007,305,320,15,chroma_acts
147,1,0.0,23.104,23.104,0,50,50,chroma_acts_smoothed
147,2,23.104,32.02133333333333,8.917333333333332,50,69,19,chroma_acts_smoothed
147,3,32.02133333333333,83.17866666666667,51.15733333333334,69,178,109,chroma_acts_smoothed
147,4,83.17866666666667,92.096,8.917333333333332,178,197,19,chroma_acts_smoothed
147,5,92.096,134.80533333333332,42.70933333333332,197,288,91,chroma_acts_smoothed
147,6,134.80533333333332,139.49866666666665,4.693333333333328,288,298,10,chroma_acts_smoothed
147,7,139.49866666666665,142.784,3.285333333333341,298,305,7,chroma_acts_smoothed
147,8,142.784,150.47,7.686000000000007,305,320,15,chroma_acts_smoothed
147,1,0.0,22.634666666666664,22.634666666666664,0,49,49,ki_chroma
147,2,22.634666666666664,32.02133333333333,9.386666666666667,49,69,20,ki_chroma
147,3,32.02133333333333,82.70933333333333,50.688,69,177,108,ki_chroma
147,4,82.70933333333333,92.096,9.38666666666667,177,197,20,ki_chroma
147,5,92.096,135.27466666666666,43.17866666666666,197,289,92,ki_chroma
147,6,135.27466666666666,139.0293333333333,3.754666666666651,289,297,8,ki_chroma
147,7,139.0293333333333,142.784,3.7546666666666795,297,305,8,ki_chroma
147,8,142.784,150.47,7.686000000000007,305,320,15,ki_chroma
147,1,0.0,22.634666666666664,22.634666666666664,0,49,49,ki_chroma_acts
147,2,22.634666666666664,32.02133333333333,9.386666666666667,49,69,20,ki_chroma_acts
147,3,32.02133333333333,82.70933333333333,50.688,69,177,108,ki_chroma_acts
147,4,82.70933333333333,92.096,9.38666666666667,177,197,20,ki_chroma_acts
147,5,92.096,134.80533333333332,42.70933333333332,197,288,91,ki_chroma_acts
147,6,134.80533333333332,139.49866666666665,4.693333333333328,288,298,10,ki_chroma_acts
147,7,139.49866666666665,142.784,3.285333333333341,298,305,7,ki_chroma_acts
147,8,142.784,150.47,7.686000000000007,305,320,15,ki_chroma_acts
147,1,0.0,23.104,23.104,0,50,50,ki_chroma_acts_smoothed
147,2,23.104,32.02133333333333,8.917333333333332,50,69,19,ki_chroma_acts_smoothed
147,3,32.02133333333333,83.17866666666667,51.15733333333334,69,178,109,ki_chroma_acts_smoothed
147,4,83.17866666666667,92.096,8.917333333333332,178,197,19,ki_chroma_acts_smoothed
147,5,92.096,134.80533333333332,42.70933333333332,197,288,91,ki_chroma_acts_smoothed
147,6,134.80533333333332,139.49866666666665,4.693333333333328,288,298,10,ki_chroma_acts_smoothed
147,7,139.49866666666665,142.784,3.285333333333341,298,305,7,ki_chroma_acts_smoothed
147,8,142.784,150.47,7.686000000000007,305,320,15,ki_chroma_acts_smoothed
149,1,0.0,3.509333333333333,3.509333333333333,0,8,8,chromagram
149,2,3.509333333333333,14.517333333333333,11.008,8,32,24,chromagram
149,3,14.517333333333333,42.03733333333333,27.519999999999996,32,92,60,chromagram
149,4,42.03733333333333,57.63199999999999,15.594666666666662,92,126,34,chromagram
149,5,57.63199999999999,88.36266666666666,30.730666666666664,126,193,67,chromagram
149,6,88.36266666666666,94.78399999999999,6.421333333333337,193,207,14,chromagram
149,7,94.78399999999999,123.67999999999998,28.895999999999987,207,270,63,chromagram
149,8,123.67999999999998,138.35733333333334,14.677333333333365,270,302,32,chromagram
149,9,138.35733333333334,197.972,59.614666666666665,302,430,128,chromagram
149,1,0.0,3.509333333333333,3.509333333333333,0,8,8,chroma_acts
149,2,3.509333333333333,7.1786666666666665,3.6693333333333333,8,16,8,chroma_acts
149,3,7.1786666666666665,14.517333333333333,7.338666666666667,16,32,16,chroma_acts
149,4,14.517333333333333,42.03733333333333,27.519999999999996,32,92,60,chroma_acts
149,5,42.03733333333333,57.63199999999999,15.594666666666662,92,126,34,chroma_acts
149,6,57.63199999999999,87.90399999999998,30.27199999999999,126,192,66,chroma_acts
149,7,87.90399999999998,123.67999999999998,35.775999999999996,192,270,78,chroma_acts
149,8,123.67999999999998,138.35733333333334,14.677333333333365,270,302,32,chroma_acts
149,9,138.35733333333334,197.972,59.614666666666665,302,430,128,chroma_acts
149,1,0.0,14.058666666666666,14.058666666666666,0,31,31,chroma_acts_smoothed
149,2,14.058666666666666,41.57866666666666,27.519999999999996,31,91,60,chroma_acts_smoothed
149,3,41.57866666666666,57.63199999999999,16.053333333333327,91,126,35,chroma_acts_smoothed
149,4,57.63199999999999,87.90399999999998,30.27199999999999,126,192,66,chroma_acts_smoothed
149,5,87.90399999999998,91.57333333333332,3.6693333333333413,192,200,8,chroma_acts_smoothed
149,6,91.57333333333332,94.78399999999999,3.2106666666666683,200,207,7,chroma_acts_smoothed
149,7,94.78399999999999,123.22133333333332,28.437333333333328,207,269,62,chroma_acts_smoothed
149,8,123.22133333333332,138.35733333333334,15.136000000000024,269,302,33,chroma_acts_smoothed
149,9,138.35733333333334,197.972,59.614666666666665,302,430,128,chroma_acts_smoothed
149,1,0.0,3.509333333333333,3.509333333333333,0,8,8,ki_chroma
149,2,3.509333333333333,14.517333333333333,11.008,8,32,24,ki_chroma
149,3,14.517333333333333,42.03733333333333,27.519999999999996,32,92,60,ki_chroma
149,4,42.03733333333333,57.63199999999999,15.594666666666662,92,126,34,ki_chroma
149,5,57.63199999999999,88.36266666666666,30.730666666666664,126,193,67,ki_chroma
149,6,88.36266666666666,94.78399999999999,6.421333333333337,193,207,14,ki_chroma
149,7,94.78399999999999,123.67999999999998,28.895999999999987,207,270,63,ki_chroma
149,8,123.67999999999998,138.35733333333334,14.677333333333365,270,302,32,ki_chroma
149,9,138.35733333333334,197.972,59.614666666666665,302,430,128,ki_chroma
149,1,0.0,3.509333333333333,3.509333333333333,0,8,8,ki_chroma_acts
149,2,3.509333333333333,7.1786666666666665,3.6693333333333333,8,16,8,ki_chroma_acts
149,3,7.1786666666666665,14.517333333333333,7.338666666666667,16,32,16,ki_chroma_acts
149,4,14.517333333333333,42.03733333333333,27.519999999999996,32,92,60,ki_chroma_acts
149,5,42.03733333333333,57.63199999999999,15.594666666666662,92,126,34,ki_chroma_acts
149,6,57.63199999999999,87.90399999999998,30.27199999999999,126,192,66,ki_chroma_acts
149,7,87.90399999999998,123.67999999999998,35.775999999999996,192,270,78,ki_chroma_acts
149,8,123.67999999999998,138.35733333333334,14.677333333333365,270,302,32,ki_chroma_acts
149,9,138.35733333333334,197.972,59.614666666666665,302,430,128,ki_chroma_acts
149,1,0.0,14.058666666666666,14.058666666666666,0,31,31,ki_chroma_acts_smoothed
149,2,14.058666666666666,41.57866666666666,27.519999999999996,31,91,60,ki_chroma_acts_smoothed
149,3,41.57866666666666,57.63199999999999,16.053333333333327,91,126,35,ki_chroma_acts_smoothed
149,4,57.63199999999999,87.90399999999998,30.27199999999999,126,192,66,ki_chroma_acts_smoothed
149,5,87.90399999999998,91.57333333333332,3.6693333333333413,192,200,8,ki_chroma_acts_smoothed
149,6,91.57333333333332,94.78399999999999,3.2106666666666683,200,207,7,ki_chroma_acts_smoothed
149,7,94.78399999999999,123.22133333333332,28.437333333333328,207,269,62,ki_chroma_acts_smoothed
149,8,123.22133333333332,138.35733333333334,15.136000000000024,269,302,33,ki_chroma_acts_smoothed
149,9,138.35733333333334,197.972,59.614666666666665,302,430,128,ki_chroma_acts_smoothed
151,1,0.0,16.864,16.864,0,36,36,chromagram
151,2,16.864,33.663999999999994,16.799999999999994,36,71,35,chromagram
151,3,33.663999999999994,65.824,32.160000000000004,71,138,67,chromagram
151,4,65.824,90.78399999999999,24.959999999999994,138,190,52,chromagram
151,5,90.78399999999999,95.104,4.320000000000007,190,199,9,chromagram
151,6,95.104,109.984,14.879999999999995,199,230,31,chromagram
151,7,109.984,123.42399999999999,13.439999999999998,230,258,28,chromagram
151,8,123.42399999999999,154.815,31.391000000000005,258,322,64,chromagram
151,1,0.0,16.864,16.864,0,36,36,chroma_acts
151,2,16.864,33.663999999999994,16.799999999999994,36,71,35,chroma_acts
151,3,33.663999999999994,47.10399999999999,13.439999999999998,71,99,28,chroma_acts
151,4,47.10399999999999,49.023999999999994,1.9200000000000017,99,103,4,chroma_acts
151,5,49.023999999999994,62.46399999999999,13.439999999999998,103,131,28,chroma_acts
151,6,62.46399999999999,109.984,47.52,131,230,99,chroma_acts
151,7,109.984,123.42399999999999,13.439999999999998,230,258,28,chroma_acts
151,8,123.42399999999999,154.815,31.391000000000005,258,322,64,chroma_acts
151,1,0.0,16.384,16.384,0,35,35,chroma_acts_smoothed
151,2,16.384,34.144,17.759999999999998,35,72,37,chroma_acts_smoothed
151,3,34.144,47.10399999999999,12.959999999999994,72,99,27,chroma_acts_smoothed
151,4,47.10399999999999,61.983999999999995,14.880000000000003,99,130,31,chroma_acts_smoothed
151,5,61.983999999999995,95.104,33.120000000000005,130,199,69,chroma_acts_smoothed
151,6,95.104,109.984,14.879999999999995,199,230,31,chroma_acts_smoothed
151,7,109.984,123.42399999999999,13.439999999999998,230,258,28,chroma_acts_smoothed
151,8,123.42399999999999,154.815,31.391000000000005,258,322,64,chroma_acts_smoothed
151,1,0.0,16.864,16.864,0,36,36,ki_chroma
151,2,16.864,33.663999999999994,16.799999999999994,36,71,35,ki_chroma
151,3,33.663999999999994,65.824,32.160000000000004,71,138,67,ki_chroma
151,4,65.824,90.78399999999999,24.959999999999994,138,190,52,ki_chroma
151,5,90.78399999999999,95.104,4.320000000000007,190,199,9,ki_chroma
151,6,95.104,109.984,14.879999999999995,199,230,31,ki_chroma
151,7,109.984,123.42399999999999,13.439999999999998,230,258,28,ki_chroma
151,8,123.42399999999999,154.815,31.391000000000005,258,322,64,ki_chroma
151,1,0.0,16.864,16.864,0,36,36,ki_chroma_acts
151,2,16.864,33.663999999999994,16.799999999999994,36,71,35,ki_chroma_acts
151,3,33.663999999999994,47.10399999999999,13.439999999999998,71,99,28,ki_chroma_acts
151,4,47.10399999999999,49.023999999999994,1.9200000000000017,99,103,4,ki_chroma_acts
151,5,49.023999999999994,62.46399999999999,13.439999999999998,103,131,28,ki_chroma_acts
151,6,62.46399999999999,109.984,47.52,131,230,99,ki_chroma_acts
151,7,109.984,123.42399999999999,13.439999999999998,230,258,28,ki_chroma_acts
151,8,123.42399999999999,154.815,31.391000000000005,258,322,64,ki_chroma_acts
151,1,0.0,16.384,16.384,0,35,35,ki_chroma_acts_smoothed
151,2,16.384,34.144,17.759999999999998,35,72,37,ki_chroma_acts_smoothed
151,3,34.144,47.10399999999999,12.959999999999994,72,99,27,ki_chroma_acts_smoothed
151,4,47.10399999999999,61.983999999999995,14.880000000000003,99,130,31,ki_chroma_acts_smoothed
151,5,61.983999999999995,95.104,33.120000000000005,130,199,69,ki_chroma_acts_smoothed
151,6,95.104,109.984,14.879999999999995,199,230,31,ki_chroma_acts_smoothed
151,7,109.984,123.42399999999999,13.439999999999998,230,258,28,ki_chroma_acts_smoothed
151,8,123.42399999999999,154.815,31.391000000000005,258,322,64,ki_chroma_acts_smoothed
153,1,0.0,27.957333333333334,27.957333333333334,0,40,40,chromagram
153,2,27.957333333333334,60.34133333333333,32.384,40,86,46,chromagram
153,3,60.34133333333333,84.27733333333333,23.936,86,120,34,chromagram
153,4,84.27733333333333,120.18133333333333,35.903999999999996,120,171,51,chromagram
153,5,120.18133333333333,134.96533333333332,14.783999999999992,171,192,21,chromagram
153,6,134.96533333333332,180.0213333333333,45.05599999999998,192,256,64,chromagram
153,7,180.0213333333333,239.8613333333333,59.84,256,341,85,chromagram
153,8,239.8613333333333,256.05333333333334,16.192000000000036,341,364,23,chromagram
153,9,256.05333333333334,269.999,13.945666666666682,364,382,18,chromagram
153,1,0.0,30.069333333333333,30.069333333333333,0,43,43,chroma_acts
153,2,30.069333333333333,59.63733333333333,29.567999999999998,43,85,42,chroma_acts
153,3,59.63733333333333,89.90933333333334,30.272000000000006,85,128,43,chroma_acts
153,4,89.90933333333334,120.88533333333332,30.975999999999985,128,172,44,chroma_acts
153,5,120.88533333333332,149.7493333333333,28.86399999999999,172,213,41,chroma_acts
153,6,149.7493333333333,180.0213333333333,30.27199999999999,213,256,43,chroma_acts
153,7,180.0213333333333,239.8613333333333,59.84,256,341,85,chroma_acts
153,8,239.8613333333333,254.6453333333333,14.783999999999992,341,362,21,chroma_acts
153,9,254.6453333333333,269.999,15.353666666666726,362,382,20,chroma_acts
153,1,0.0,30.069333333333333,30.069333333333333,0,43,43,chroma_acts_smoothed
153,2,30.069333333333333,59.63733333333333,29.567999999999998,43,85,42,chroma_acts_smoothed
153,3,59.63733333333333,89.20533333333333,29.567999999999998,85,127,42,chroma_acts_smoothed
153,4,89.20533333333333,119.47733333333333,30.272000000000006,127,170,43,chroma_acts_smoothed
153,5,119.47733333333333,150.45333333333332,30.975999999999985,170,214,44,chroma_acts_smoothed
153,6,150.45333333333332,179.31733333333332,28.864000000000004,214,255,41,chroma_acts_smoothed
153,7,179.31733333333332,239.8613333333333,60.54399999999998,255,341,86,chroma_acts_smoothed
153,8,239.8613333333333,254.6453333333333,14.783999999999992,341,362,21,chroma_acts_smoothed
153,9,254.6453333333333,269.999,15.353666666666726,362,382,20,chroma_acts_smoothed
153,1,0.0,27.957333333333334,27.957333333333334,0,40,40,ki_chroma
153,2,27.957333333333334,60.34133333333333,32.384,40,86,46,ki_chroma
153,3,60.34133333333333,84.27733333333333,23.936,86,120,34,ki_chroma
153,4,84.27733333333333,120.18133333333333,35.903999999999996,120,171,51,ki_chroma
153,5,120.18133333333333,134.96533333333332,14.783999999999992,171,192,21,ki_chroma
153,6,134.96533333333332,180.0213333333333,45.05599999999998,192,256,64,ki_chroma
153,7,180.0213333333333,239.8613333333333,59.84,256,341,85,ki_chroma
153,8,239.8613333333333,256.05333333333334,16.192000000000036,341,364,23,ki_chroma
153,9,256.05333333333334,269.999,13.945666666666682,364,382,18,ki_chroma
153,1,0.0,30.069333333333333,30.069333333333333,0,43,43,ki_chroma_acts
153,2,30.069333333333333,59.63733333333333,29.567999999999998,43,85,42,ki_chroma_acts
153,3,59.63733333333333,89.90933333333334,30.272000000000006,85,128,43,ki_chroma_acts
153,4,89.90933333333334,120.88533333333332,30.975999999999985,128,172,44,ki_chroma_acts
153,5,120.88533333333332,149.7493333333333,28.86399999999999,172,213,41,ki_chroma_acts
153,6,149.7493333333333,180.0213333333333,30.27199999999999,213,256,43,ki_chroma_acts
153,7,180.0213333333333,239.8613333333333,59.84,256,341,85,ki_chroma_acts
153,8,239.8613333333333,254.6453333333333,14.783999999999992,341,362,21,ki_chroma_acts
153,9,254.6453333333333,269.999,15.353666666666726,362,382,20,ki_chroma_acts
153,1,0.0,30.069333333333333,30.069333333333333,0,43,43,ki_chroma_acts_smoothed
153,2,30.069333333333333,59.63733333333333,29.567999999999998,43,85,42,ki_chroma_acts_smoothed
153,3,59.63733333333333,89.20533333333333,29.567999999999998,85,127,42,ki_chroma_acts_smoothed
153,4,89.20533333333333,119.47733333333333,30.272000000000006,127,170,43,ki_chroma_acts_smoothed
153,5,119.47733333333333,150.45333333333332,30.975999999999985,170,214,44,ki_chroma_acts_smoothed
153,6,150.45333333333332,179.31733333333332,28.864000000000004,214,255,41,ki_chroma_acts_smoothed
153,7,179.31733333333332,239.8613333333333,60.54399999999998,255,341,86,ki_chroma_acts_smoothed
153,8,239.8613333333333,254.6453333333333,14.783999999999992,341,362,21,ki_chroma_acts_smoothed
153,9,254.6453333333333,269.999,15.353666666666726,362,382,20,ki_chroma_acts_smoothed
154,1,0.0,12.490666666666666,12.490666666666666,0,26,26,chromagram
154,2,12.490666666666666,43.40266666666667,30.912000000000003,26,89,63,chromagram
154,3,43.40266666666667,76.27733333333335,32.87466666666668,89,156,67,chromagram
154,4,76.27733333333335,88.05333333333334,11.775999999999996,156,180,24,chromagram
154,5,88.05333333333334,93.94133333333335,5.888000000000005,180,192,12,chromagram
154,6,93.94133333333335,99.82933333333335,5.888000000000005,192,204,12,chromagram
154,7,99.82933333333335,128.77866666666668,28.94933333333333,204,263,59,chromagram
154,8,128.77866666666668,167.298,38.51933333333332,263,340,77,chromagram
154,1,0.0,13.962666666666667,13.962666666666667,0,29,29,chroma_acts
154,2,13.962666666666667,49.29066666666667,35.328,29,101,72,chroma_acts
154,3,49.29066666666667,76.27733333333335,26.98666666666668,101,156,55,chroma_acts
154,4,76.27733333333335,88.05333333333334,11.775999999999996,156,180,24,chroma_acts
154,5,88.05333333333334,99.82933333333335,11.77600000000001,180,204,24,chroma_acts
154,6,99.82933333333335,134.66666666666666,34.837333333333305,204,275,71,chroma_acts
154,7,134.66666666666666,138.592,3.9253333333333558,275,283,8,chroma_acts
154,8,138.592,167.298,28.70599999999999,283,340,57,chroma_acts
154,1,0.0,13.962666666666667,13.962666666666667,0,29,29,chroma_acts_smoothed
154,2,13.962666666666667,43.40266666666667,29.44,29,89,60,chroma_acts_smoothed
154,3,43.40266666666667,48.800000000000004,5.397333333333336,89,100,11,chroma_acts_smoothed
154,4,48.800000000000004,76.27733333333335,27.47733333333334,100,156,56,chroma_acts_smoothed
154,5,76.27733333333335,88.05333333333334,11.775999999999996,156,180,24,chroma_acts_smoothed
154,6,88.05333333333334,99.82933333333335,11.77600000000001,180,204,24,chroma_acts_smoothed
154,7,99.82933333333335,134.66666666666666,34.837333333333305,204,275,71,chroma_acts_smoothed
154,8,134.66666666666666,167.298,32.631333333333345,275,340,65,chroma_acts_smoothed
154,1,0.0,12.490666666666666,12.490666666666666,0,26,26,ki_chroma
154,2,12.490666666666666,43.40266666666667,30.912000000000003,26,89,63,ki_chroma
154,3,43.40266666666667,76.27733333333335,32.87466666666668,89,156,67,ki_chroma
154,4,76.27733333333335,88.05333333333334,11.775999999999996,156,180,24,ki_chroma
154,5,88.05333333333334,93.94133333333335,5.888000000000005,180,192,12,ki_chroma
154,6,93.94133333333335,99.82933333333335,5.888000000000005,192,204,12,ki_chroma
154,7,99.82933333333335,128.77866666666668,28.94933333333333,204,263,59,ki_chroma
154,8,128.77866666666668,167.298,38.51933333333332,263,340,77,ki_chroma
154,1,0.0,13.962666666666667,13.962666666666667,0,29,29,ki_chroma_acts
154,2,13.962666666666667,49.29066666666667,35.328,29,101,72,ki_chroma_acts
154,3,49.29066666666667,76.27733333333335,26.98666666666668,101,156,55,ki_chroma_acts
154,4,76.27733333333335,88.05333333333334,11.775999999999996,156,180,24,ki_chroma_acts
154,5,88.05333333333334,99.82933333333335,11.77600000000001,180,204,24,ki_chroma_acts
154,6,99.82933333333335,134.66666666666666,34.837333333333305,204,275,71,ki_chroma_acts
154,7,134.66666666666666,138.592,3.9253333333333558,275,283,8,ki_chroma_acts
154,8,138.592,167.298,28.70599999999999,283,340,57,ki_chroma_acts
154,1,0.0,13.962666666666667,13.962666666666667,0,29,29,ki_chroma_acts_smoothed
154,2,13.962666666666667,43.40266666666667,29.44,29,89,60,ki_chroma_acts_smoothed
154,3,43.40266666666667,48.800000000000004,5.397333333333336,89,100,11,ki_chroma_acts_smoothed
154,4,48.800000000000004,76.27733333333335,27.47733333333334,100,156,56,ki_chroma_acts_smoothed
154,5,76.27733333333335,88.05333333333334,11.775999999999996,156,180,24,ki_chroma_acts_smoothed
154,6,88.05333333333334,99.82933333333335,11.77600000000001,180,204,24,ki_chroma_acts_smoothed
154,7,99.82933333333335,134.66666666666666,34.837333333333305,204,275,71,ki_chroma_acts_smoothed
154,8,134.66666666666666,167.298,32.631333333333345,275,340,65,ki_chroma_acts_smoothed
156,1,0.0,28.544,28.544,0,61,61,chromagram
156,2,28.544,38.400000000000006,9.856000000000005,61,82,21,chromagram
156,3,38.400000000000006,98.47466666666666,60.07466666666666,82,210,128,chromagram
156,4,98.47466666666666,109.26933333333332,10.794666666666657,210,233,23,chromagram
156,5,109.26933333333332,113.49333333333333,4.224000000000004,233,242,9,chromagram
156,6,113.49333333333333,151.50933333333333,38.016000000000005,242,323,81,chromagram
156,7,151.50933333333333,157.61066666666667,6.1013333333333435,323,336,13,chromagram
156,8,157.61066666666667,204.178,46.56733333333332,336,434,98,chromagram
156,1,0.0,7.8933333333333335,7.8933333333333335,0,17,17,chroma_acts
156,2,7.8933333333333335,28.544,20.650666666666666,17,61,44,chroma_acts
156,3,28.544,38.400000000000006,9.856000000000005,61,82,21,chroma_acts
156,4,38.400000000000006,98.47466666666666,60.07466666666666,82,210,128,chroma_acts
156,5,98.47466666666666,123.34933333333333,24.87466666666667,210,263,53,chroma_acts
156,6,123.34933333333333,149.632,26.28266666666667,263,319,56,chroma_acts
156,7,149.632,158.54933333333332,8.917333333333318,319,338,19,chroma_acts
156,8,158.54933333333332,204.178,45.628666666666675,338,434,96,chroma_acts
156,1,0.0,8.832,8.832,0,19,19,chroma_acts_smoothed
156,2,8.832,27.605333333333334,18.773333333333333,19,59,40,chroma_acts_smoothed
156,3,27.605333333333334,38.400000000000006,10.794666666666672,59,82,23,chroma_acts_smoothed
156,4,38.400000000000006,98.94399999999999,60.54399999999998,82,211,129,chroma_acts_smoothed
156,5,98.94399999999999,108.8,9.856000000000009,211,232,21,chroma_acts_smoothed
156,6,108.8,113.024,4.224000000000004,232,241,9,chroma_acts_smoothed
156,7,113.024,158.54933333333332,45.52533333333332,241,338,97,chroma_acts_smoothed
156,8,158.54933333333332,204.178,45.628666666666675,338,434,96,chroma_acts_smoothed
156,1,0.0,28.544,28.544,0,61,61,ki_chroma
156,2,28.544,38.400000000000006,9.856000000000005,61,82,21,ki_chroma
156,3,38.400000000000006,98.47466666666666,60.07466666666666,82,210,128,ki_chroma
156,4,98.47466666666666,109.26933333333332,10.794666666666657,210,233,23,ki_chroma
156,5,109.26933333333332,113.49333333333333,4.224000000000004,233,242,9,ki_chroma
156,6,113.49333333333333,151.50933333333333,38.016000000000005,242,323,81,ki_chroma
156,7,151.50933333333333,157.61066666666667,6.1013333333333435,323,336,13,ki_chroma
156,8,157.61066666666667,204.178,46.56733333333332,336,434,98,ki_chroma
156,1,0.0,7.8933333333333335,7.8933333333333335,0,17,17,ki_chroma_acts
156,2,7.8933333333333335,28.544,20.650666666666666,17,61,44,ki_chroma_acts
156,3,28.544,38.400000000000006,9.856000000000005,61,82,21,ki_chroma_acts
156,4,38.400000000000006,98.47466666666666,60.07466666666666,82,210,128,ki_chroma_acts
156,5,98.47466666666666,123.34933333333333,24.87466666666667,210,263,53,ki_chroma_acts
156,6,123.34933333333333,149.632,26.28266666666667,263,319,56,ki_chroma_acts
156,7,149.632,158.54933333333332,8.917333333333318,319,338,19,ki_chroma_acts
156,8,158.54933333333332,204.178,45.628666666666675,338,434,96,ki_chroma_acts
156,1,0.0,8.832,8.832,0,19,19,ki_chroma_acts_smoothed
156,2,8.832,27.605333333333334,18.773333333333333,19,59,40,ki_chroma_acts_smoothed
156,3,27.605333333333334,38.400000000000006,10.794666666666672,59,82,23,ki_chroma_acts_smoothed
156,4,38.400000000000006,98.94399999999999,60.54399999999998,82,211,129,ki_chroma_acts_smoothed
156,5,98.94399999999999,108.8,9.856000000000009,211,232,21,ki_chroma_acts_smoothed
156,6,108.8,113.024,4.224000000000004,232,241,9,ki_chroma_acts_smoothed
156,7,113.024,158.54933333333332,45.52533333333332,241,338,97,ki_chroma_acts_smoothed
156,8,158.54933333333332,204.178,45.628666666666675,338,434,96,ki_chroma_acts_smoothed
157,1,0.0,7.722666666666666,7.722666666666666,0,17,17,chromagram
157,2,7.722666666666666,16.842666666666666,9.120000000000001,17,36,19,chromagram
157,3,16.842666666666666,24.522666666666666,7.68,36,52,16,chromagram
157,4,24.522666666666666,78.76266666666666,54.239999999999995,52,165,113,chromagram
157,5,78.76266666666666,93.64266666666667,14.88000000000001,165,196,31,chromagram
157,6,93.64266666666667,107.56266666666667,13.920000000000002,196,225,29,chromagram
157,7,107.56266666666667,180.968,73.40533333333332,225,376,151,chromagram
157,1,0.0,7.722666666666666,7.722666666666666,0,17,17,chroma_acts
157,2,7.722666666666666,18.762666666666664,11.04,17,40,23,chroma_acts
157,3,18.762666666666664,24.042666666666666,5.280000000000001,40,51,11,chroma_acts
157,4,24.042666666666666,78.76266666666666,54.72,51,165,114,chroma_acts
157,5,78.76266666666666,93.64266666666667,14.88000000000001,165,196,31,chroma_acts
157,6,93.64266666666667,107.56266666666667,13.920000000000002,196,225,29,chroma_acts
157,7,107.56266666666667,169.48266666666666,61.91999999999999,225,354,129,chroma_acts
157,8,169.48266666666666,180.968,11.48533333333333,354,376,22,chroma_acts
157,1,0.0,7.722666666666666,7.722666666666666,0,17,17,chroma_acts_smoothed
157,2,7.722666666666666,17.322666666666667,9.600000000000001,17,37,20,chroma_acts_smoothed
157,3,17.322666666666667,24.042666666666666,6.719999999999999,37,51,14,chroma_acts_smoothed
157,4,24.042666666666666,78.28266666666667,54.24000000000001,51,164,113,chroma_acts_smoothed
157,5,78.28266666666667,94.12266666666666,15.83999999999999,164,197,33,chroma_acts_smoothed
157,6,94.12266666666666,107.56266666666667,13.440000000000012,197,225,28,chroma_acts_smoothed
157,7,107.56266666666667,180.968,73.40533333333332,225,376,151,chroma_acts_smoothed
157,1,0.0,7.722666666666666,7.722666666666666,0,17,17,ki_chroma
157,2,7.722666666666666,16.842666666666666,9.120000000000001,17,36,19,ki_chroma
157,3,16.842666666666666,24.522666666666666,7.68,36,52,16,ki_chroma
157,4,24.522666666666666,78.76266666666666,54.239999999999995,52,165,113,ki_chroma
157,5,78.76266666666666,93.64266666666667,14.88000000000001,165,196,31,ki_chroma
157,6,93.64266666666667,107.56266666666667,13.920000000000002,196,225,29,ki_chroma
157,7,107.56266666666667,180.968,73.40533333333332,225,376,151,ki_chroma
157,1,0.0,7.722666666666666,7.722666666666666,0,17,17,ki_chroma_acts
157,2,7.722666666666666,18.762666666666664,11.04,17,40,23,ki_chroma_acts
157,3,18.762666666666664,24.042666666666666,5.280000000000001,40,51,11,ki_chroma_acts
157,4,24.042666666666666,78.76266666666666,54.72,51,165,114,ki_chroma_acts
157,5,78.76266666666666,93.64266666666667,14.88000000000001,165,196,31,ki_chroma_acts
157,6,93.64266666666667,107.56266666666667,13.920000000000002,196,225,29,ki_chroma_acts
157,7,107.56266666666667,169.48266666666666,61.91999999999999,225,354,129,ki_chroma_acts
157,8,169.48266666666666,180.968,11.48533333333333,354,376,22,ki_chroma_acts
157,1,0.0,7.722666666666666,7.722666666666666,0,17,17,ki_chroma_acts_smoothed
157,2,7.722666666666666,17.322666666666667,9.600000000000001,17,37,20,ki_chroma_acts_smoothed
157,3,17.322666666666667,24.042666666666666,6.719999999999999,37,51,14,ki_chroma_acts_smoothed
157,4,24.042666666666666,78.28266666666667,54.24000000000001,51,164,113,ki_chroma_acts_smoothed
157,5,78.28266666666667,94.12266666666666,15.83999999999999,164,197,33,ki_chroma_acts_smoothed
157,6,94.12266666666666,107.56266666666667,13.440000000000012,197,225,28,ki_chroma_acts_smoothed
157,7,107.56266666666667,180.968,73.40533333333332,225,376,151,ki_chroma_acts_smoothed
158,1,0.0,15.306666666666667,15.306666666666667,0,33,33,chromagram
158,2,15.306666666666667,23.285333333333334,7.978666666666667,33,50,17,chromagram
158,3,23.285333333333334,41.58933333333333,18.303999999999995,50,89,39,chromagram
158,4,41.58933333333333,52.85333333333333,11.264000000000003,89,113,24,chromagram
158,5,52.85333333333333,113.86666666666666,61.01333333333333,113,243,130,chromagram
158,6,113.86666666666666,139.68,25.813333333333347,243,298,55,chromagram
158,7,139.68,150.94400000000002,11.26400000000001,298,322,24,chromagram
158,8,150.94400000000002,198.926,47.98199999999997,322,423,101,chromagram
158,1,0.0,15.306666666666667,15.306666666666667,0,33,33,chroma_acts
158,2,15.306666666666667,23.285333333333334,7.978666666666667,33,50,17,chroma_acts
158,3,23.285333333333334,41.58933333333333,18.303999999999995,50,89,39,chroma_acts
158,4,41.58933333333333,52.85333333333333,11.264000000000003,89,113,24,chroma_acts
158,5,52.85333333333333,113.86666666666666,61.01333333333333,113,243,130,chroma_acts
158,6,113.86666666666666,139.68,25.813333333333347,243,298,55,chroma_acts
158,7,139.68,150.94400000000002,11.26400000000001,298,322,24,chroma_acts
158,8,150.94400000000002,198.926,47.98199999999997,322,423,101,chroma_acts
158,1,0.0,15.306666666666667,15.306666666666667,0,33,33,chroma_acts_smoothed
158,2,15.306666666666667,23.285333333333334,7.978666666666667,33,50,17,chroma_acts_smoothed
158,3,23.285333333333334,41.58933333333333,18.303999999999995,50,89,39,chroma_acts_smoothed
158,4,41.58933333333333,52.85333333333333,11.264000000000003,89,113,24,chroma_acts_smoothed
158,5,52.85333333333333,113.39733333333332,60.54399999999999,113,242,129,chroma_acts_smoothed
158,6,113.39733333333332,139.68,26.282666666666685,242,298,56,chroma_acts_smoothed
158,7,139.68,150.94400000000002,11.26400000000001,298,322,24,chroma_acts_smoothed
158,8,150.94400000000002,198.926,47.98199999999997,322,423,101,chroma_acts_smoothed
158,1,0.0,15.306666666666667,15.306666666666667,0,33,33,ki_chroma
158,2,15.306666666666667,23.285333333333334,7.978666666666667,33,50,17,ki_chroma
158,3,23.285333333333334,41.58933333333333,18.303999999999995,50,89,39,ki_chroma
158,4,41.58933333333333,52.85333333333333,11.264000000000003,89,113,24,ki_chroma
158,5,52.85333333333333,113.86666666666666,61.01333333333333,113,243,130,ki_chroma
158,6,113.86666666666666,139.68,25.813333333333347,243,298,55,ki_chroma
158,7,139.68,150.94400000000002,11.26400000000001,298,322,24,ki_chroma
158,8,150.94400000000002,198.926,47.98199999999997,322,423,101,ki_chroma
158,1,0.0,15.306666666666667,15.306666666666667,0,33,33,ki_chroma_acts
158,2,15.306666666666667,23.285333333333334,7.978666666666667,33,50,17,ki_chroma_acts
158,3,23.285333333333334,41.58933333333333,18.303999999999995,50,89,39,ki_chroma_acts
158,4,41.58933333333333,52.85333333333333,11.264000000000003,89,113,24,ki_chroma_acts
158,5,52.85333333333333,113.86666666666666,61.01333333333333,113,243,130,ki_chroma_acts
158,6,113.86666666666666,139.68,25.813333333333347,243,298,55,ki_chroma_acts
158,7,139.68,150.94400000000002,11.26400000000001,298,322,24,ki_chroma_acts
158,8,150.94400000000002,198.926,47.98199999999997,322,423,101,ki_chroma_acts
158,1,0.0,15.306666666666667,15.306666666666667,0,33,33,ki_chroma_acts_smoothed
158,2,15.306666666666667,23.285333333333334,7.978666666666667,33,50,17,ki_chroma_acts_smoothed
158,3,23.285333333333334,41.58933333333333,18.303999999999995,50,89,39,ki_chroma_acts_smoothed
158,4,41.58933333333333,52.85333333333333,11.264000000000003,89,113,24,ki_chroma_acts_smoothed
158,5,52.85333333333333,113.39733333333332,60.54399999999999,113,242,129,ki_chroma_acts_smoothed
158,6,113.39733333333332,139.68,26.282666666666685,242,298,56,ki_chroma_acts_smoothed
158,7,139.68,150.94400000000002,11.26400000000001,298,322,24,ki_chroma_acts_smoothed
158,8,150.94400000000002,198.926,47.98199999999997,322,423,101,ki_chroma_acts_smoothed
159,1,0.0,12.234666666666666,12.234666666666666,0,27,27,chromagram
159,2,12.234666666666666,15.989333333333333,3.754666666666667,27,35,8,chromagram
159,3,15.989333333333333,27.253333333333334,11.264000000000001,35,59,24,chromagram
159,4,27.253333333333334,31.008,3.7546666666666653,59,67,8,chromagram
159,5,31.008,66.20800000000001,35.20000000000002,67,142,75,chromagram
159,6,66.20800000000001,110.32533333333333,44.11733333333332,142,236,94,chromagram
159,7,110.32533333333333,120.65066666666667,10.325333333333333,236,258,22,chromagram
159,8,120.65066666666667,151.673,31.022333333333336,258,323,65,chromagram
159,1,0.0,27.253333333333334,27.253333333333334,0,59,59,chroma_acts
159,2,27.253333333333334,68.55466666666668,41.301333333333346,59,147,88,chroma_acts
159,3,68.55466666666668,98.12266666666667,29.567999999999998,147,210,63,chroma_acts
159,4,98.12266666666667,102.34666666666668,4.224000000000004,210,219,9,chroma_acts
159,5,102.34666666666668,105.632,3.2853333333333268,219,226,7,chroma_acts
159,6,105.632,110.32533333333333,4.693333333333328,226,236,10,chroma_acts
159,7,110.32533333333333,118.77333333333334,8.448000000000008,236,254,18,chroma_acts
159,8,118.77333333333334,151.673,32.89966666666666,254,323,69,chroma_acts
159,1,0.0,27.722666666666665,27.722666666666665,0,60,60,chroma_acts_smoothed
159,2,27.722666666666665,68.55466666666668,40.83200000000001,60,147,87,chroma_acts_smoothed
159,3,68.55466666666668,98.12266666666667,29.567999999999998,147,210,63,chroma_acts_smoothed
159,4,98.12266666666667,102.816,4.693333333333328,210,220,10,chroma_acts_smoothed
159,5,102.816,105.632,2.8160000000000025,220,226,6,chroma_acts_smoothed
159,6,105.632,110.32533333333333,4.693333333333328,226,236,10,chroma_acts_smoothed
159,7,110.32533333333333,118.77333333333334,8.448000000000008,236,254,18,chroma_acts_smoothed
159,8,118.77333333333334,151.673,32.89966666666666,254,323,69,chroma_acts_smoothed
159,1,0.0,12.234666666666666,12.234666666666666,0,27,27,ki_chroma
159,2,12.234666666666666,15.989333333333333,3.754666666666667,27,35,8,ki_chroma
159,3,15.989333333333333,27.253333333333334,11.264000000000001,35,59,24,ki_chroma
159,4,27.253333333333334,31.008,3.7546666666666653,59,67,8,ki_chroma
159,5,31.008,66.20800000000001,35.20000000000002,67,142,75,ki_chroma
159,6,66.20800000000001,110.32533333333333,44.11733333333332,142,236,94,ki_chroma
159,7,110.32533333333333,120.65066666666667,10.325333333333333,236,258,22,ki_chroma
159,8,120.65066666666667,151.673,31.022333333333336,258,323,65,ki_chroma
159,1,0.0,27.253333333333334,27.253333333333334,0,59,59,ki_chroma_acts
159,2,27.253333333333334,68.55466666666668,41.301333333333346,59,147,88,ki_chroma_acts
159,3,68.55466666666668,98.12266666666667,29.567999999999998,147,210,63,ki_chroma_acts
159,4,98.12266666666667,102.34666666666668,4.224000000000004,210,219,9,ki_chroma_acts
159,5,102.34666666666668,105.632,3.2853333333333268,219,226,7,ki_chroma_acts
159,6,105.632,110.32533333333333,4.693333333333328,226,236,10,ki_chroma_acts
159,7,110.32533333333333,118.77333333333334,8.448000000000008,236,254,18,ki_chroma_acts
159,8,118.77333333333334,151.673,32.89966666666666,254,323,69,ki_chroma_acts
159,1,0.0,27.722666666666665,27.722666666666665,0,60,60,ki_chroma_acts_smoothed
159,2,27.722666666666665,68.55466666666668,40.83200000000001,60,147,87,ki_chroma_acts_smoothed
159,3,68.55466666666668,98.12266666666667,29.567999999999998,147,210,63,ki_chroma_acts_smoothed
159,4,98.12266666666667,102.816,4.693333333333328,210,220,10,ki_chroma_acts_smoothed
159,5,102.816,105.632,2.8160000000000025,220,226,6,ki_chroma_acts_smoothed
159,6,105.632,110.32533333333333,4.693333333333328,226,236,10,ki_chroma_acts_smoothed
159,7,110.32533333333333,118.77333333333334,8.448000000000008,236,254,18,ki_chroma_acts_smoothed
159,8,118.77333333333334,151.673,32.89966666666666,254,323,69,ki_chroma_acts_smoothed
160,1,0.0,11.050666666666665,11.050666666666665,0,25,25,chromagram
160,2,11.050666666666665,25.727999999999998,14.677333333333333,25,57,32,chromagram
160,3,25.727999999999998,55.08266666666666,29.354666666666663,57,121,64,chromagram
160,4,55.08266666666666,83.97866666666667,28.896000000000008,121,184,63,chromagram
160,5,83.97866666666667,124.8,40.82133333333333,184,273,89,chromagram
160,6,124.8,128.4693333333333,3.669333333333313,273,281,8,chromagram
160,7,128.4693333333333,133.9733333333333,5.503999999999991,281,293,12,chromagram
160,8,133.9733333333333,171.12533333333332,37.152000000000015,293,374,81,chromagram
160,9,171.12533333333332,217.895,46.769666666666694,374,474,100,chromagram
160,1,0.0,11.050666666666665,11.050666666666665,0,25,25,chroma_acts
160,2,11.050666666666665,25.727999999999998,14.677333333333333,25,57,32,chroma_acts
160,3,25.727999999999998,55.08266666666666,29.354666666666663,57,121,64,chroma_acts
160,4,55.08266666666666,83.06133333333332,27.978666666666662,121,182,61,chroma_acts
160,5,83.06133333333332,124.8,41.738666666666674,182,273,91,chroma_acts
160,6,124.8,128.4693333333333,3.669333333333313,273,281,8,chroma_acts
160,7,128.4693333333333,133.9733333333333,5.503999999999991,281,293,12,chroma_acts
160,8,133.9733333333333,171.12533333333332,37.152000000000015,293,374,81,chroma_acts
160,9,171.12533333333332,217.895,46.769666666666694,374,474,100,chroma_acts
160,1,0.0,10.591999999999999,10.591999999999999,0,24,24,chroma_acts_smoothed
160,2,10.591999999999999,40.40533333333333,29.813333333333333,24,89,65,chroma_acts_smoothed
160,3,40.40533333333333,55.08266666666666,14.67733333333333,89,121,32,chroma_acts_smoothed
160,4,55.08266666666666,83.06133333333332,27.978666666666662,121,182,61,chroma_acts_smoothed
160,5,83.06133333333332,124.34133333333332,41.28,182,272,90,chroma_acts_smoothed
160,6,124.34133333333332,128.4693333333333,4.127999999999986,272,281,9,chroma_acts_smoothed
160,7,128.4693333333333,133.51466666666664,5.045333333333332,281,292,11,chroma_acts_smoothed
160,8,133.51466666666664,171.58399999999997,38.06933333333333,292,375,83,chroma_acts_smoothed
160,9,171.58399999999997,217.895,46.311000000000035,375,474,99,chroma_acts_smoothed
160,1,0.0,11.050666666666665,11.050666666666665,0,25,25,ki_chroma
160,2,11.050666666666665,25.727999999999998,14.677333333333333,25,57,32,ki_chroma
160,3,25.727999999999998,55.08266666666666,29.354666666666663,57,121,64,ki_chroma
160,4,55.08266666666666,83.97866666666667,28.896000000000008,121,184,63,ki_chroma
160,5,83.97866666666667,124.8,40.82133333333333,184,273,89,ki_chroma
160,6,124.8,128.4693333333333,3.669333333333313,273,281,8,ki_chroma
160,7,128.4693333333333,133.9733333333333,5.503999999999991,281,293,12,ki_chroma
160,8,133.9733333333333,171.12533333333332,37.152000000000015,293,374,81,ki_chroma
160,9,171.12533333333332,217.895,46.769666666666694,374,474,100,ki_chroma
160,1,0.0,11.050666666666665,11.050666666666665,0,25,25,ki_chroma_acts
160,2,11.050666666666665,25.727999999999998,14.677333333333333,25,57,32,ki_chroma_acts
160,3,25.727999999999998,55.08266666666666,29.354666666666663,57,121,64,ki_chroma_acts
160,4,55.08266666666666,83.06133333333332,27.978666666666662,121,182,61,ki_chroma_acts
160,5,83.06133333333332,124.8,41.738666666666674,182,273,91,ki_chroma_acts
160,6,124.8,128.4693333333333,3.669333333333313,273,281,8,ki_chroma_acts
160,7,128.4693333333333,133.9733333333333,5.503999999999991,281,293,12,ki_chroma_acts
160,8,133.9733333333333,171.12533333333332,37.152000000000015,293,374,81,ki_chroma_acts
160,9,171.12533333333332,217.895,46.769666666666694,374,474,100,ki_chroma_acts
160,1,0.0,10.591999999999999,10.591999999999999,0,24,24,ki_chroma_acts_smoothed
160,2,10.591999999999999,40.40533333333333,29.813333333333333,24,89,65,ki_chroma_acts_smoothed
160,3,40.40533333333333,55.08266666666666,14.67733333333333,89,121,32,ki_chroma_acts_smoothed
160,4,55.08266666666666,83.06133333333332,27.978666666666662,121,182,61,ki_chroma_acts_smoothed
160,5,83.06133333333332,124.34133333333332,41.28,182,272,90,ki_chroma_acts_smoothed
160,6,124.34133333333332,128.4693333333333,4.127999999999986,272,281,9,ki_chroma_acts_smoothed
160,7,128.4693333333333,133.51466666666664,5.045333333333332,281,292,11,ki_chroma_acts_smoothed
160,8,133.51466666666664,171.58399999999997,38.06933333333333,292,375,83,ki_chroma_acts_smoothed
160,9,171.58399999999997,217.895,46.311000000000035,375,474,99,ki_chroma_acts_smoothed
161,1,0.0,13.888,13.888,0,30,30,chromagram
161,2,13.888,30.784000000000002,16.896,30,66,36,chromagram
161,3,30.784000000000002,60.352,29.567999999999994,66,129,63,chromagram
161,4,60.352,105.408,45.056000000000004,129,225,96,chromagram
161,5,105.408,124.18133333333333,18.773333333333326,225,265,40,chromagram
161,6,124.18133333333333,126.99733333333333,2.8160000000000025,265,271,6,chromagram
161,7,126.99733333333333,149.52533333333332,22.52799999999999,271,319,48,chromagram
161,8,149.52533333333332,170.64533333333333,21.120000000000005,319,364,45,chromagram
161,9,170.64533333333333,204.875,34.229666666666674,364,435,71,chromagram
161,1,0.0,13.418666666666667,13.418666666666667,0,29,29,chroma_acts
161,2,13.418666666666667,30.784000000000002,17.365333333333336,29,66,37,chroma_acts
161,3,30.784000000000002,60.352,29.567999999999994,66,129,63,chroma_acts
161,4,60.352,105.408,45.056000000000004,129,225,96,chroma_acts
161,5,105.408,124.18133333333333,18.773333333333326,225,265,40,chroma_acts
161,6,124.18133333333333,126.99733333333333,2.8160000000000025,265,271,6,chroma_acts
161,7,126.99733333333333,149.52533333333332,22.52799999999999,271,319,48,chroma_acts
161,8,149.52533333333332,170.64533333333333,21.120000000000005,319,364,45,chroma_acts
161,9,170.64533333333333,204.875,34.229666666666674,364,435,71,chroma_acts
161,1,0.0,13.418666666666667,13.418666666666667,0,29,29,chroma_acts_smoothed
161,2,13.418666666666667,30.784000000000002,17.365333333333336,29,66,37,chroma_acts_smoothed
161,3,30.784000000000002,60.352,29.567999999999994,66,129,63,chroma_acts_smoothed
161,4,60.352,105.408,45.056000000000004,129,225,96,chroma_acts_smoothed
161,5,105.408,124.18133333333333,18.773333333333326,225,265,40,chroma_acts_smoothed
161,6,124.18133333333333,126.99733333333333,2.8160000000000025,265,271,6,chroma_acts_smoothed
161,7,126.99733333333333,149.52533333333332,22.52799999999999,271,319,48,chroma_acts_smoothed
161,8,149.52533333333332,170.64533333333333,21.120000000000005,319,364,45,chroma_acts_smoothed
161,9,170.64533333333333,204.875,34.229666666666674,364,435,71,chroma_acts_smoothed
161,1,0.0,13.888,13.888,0,30,30,ki_chroma
161,2,13.888,30.784000000000002,16.896,30,66,36,ki_chroma
161,3,30.784000000000002,60.352,29.567999999999994,66,129,63,ki_chroma
161,4,60.352,105.408,45.056000000000004,129,225,96,ki_chroma
161,5,105.408,124.18133333333333,18.773333333333326,225,265,40,ki_chroma
161,6,124.18133333333333,126.99733333333333,2.8160000000000025,265,271,6,ki_chroma
161,7,126.99733333333333,149.52533333333332,22.52799999999999,271,319,48,ki_chroma
161,8,149.52533333333332,170.64533333333333,21.120000000000005,319,364,45,ki_chroma
161,9,170.64533333333333,204.875,34.229666666666674,364,435,71,ki_chroma
161,1,0.0,13.418666666666667,13.418666666666667,0,29,29,ki_chroma_acts
161,2,13.418666666666667,30.784000000000002,17.365333333333336,29,66,37,ki_chroma_acts
161,3,30.784000000000002,60.352,29.567999999999994,66,129,63,ki_chroma_acts
161,4,60.352,105.408,45.056000000000004,129,225,96,ki_chroma_acts
161,5,105.408,124.18133333333333,18.773333333333326,225,265,40,ki_chroma_acts
161,6,124.18133333333333,126.99733333333333,2.8160000000000025,265,271,6,ki_chroma_acts
161,7,126.99733333333333,149.52533333333332,22.52799999999999,271,319,48,ki_chroma_acts
161,8,149.52533333333332,170.64533333333333,21.120000000000005,319,364,45,ki_chroma_acts
161,9,170.64533333333333,204.875,34.229666666666674,364,435,71,ki_chroma_acts
161,1,0.0,13.418666666666667,13.418666666666667,0,29,29,ki_chroma_acts_smoothed
161,2,13.418666666666667,30.784000000000002,17.365333333333336,29,66,37,ki_chroma_acts_smoothed
161,3,30.784000000000002,60.352,29.567999999999994,66,129,63,ki_chroma_acts_smoothed
161,4,60.352,105.408,45.056000000000004,129,225,96,ki_chroma_acts_smoothed
161,5,105.408,124.18133333333333,18.773333333333326,225,265,40,ki_chroma_acts_smoothed
161,6,124.18133333333333,126.99733333333333,2.8160000000000025,265,271,6,ki_chroma_acts_smoothed
161,7,126.99733333333333,149.52533333333332,22.52799999999999,271,319,48,ki_chroma_acts_smoothed
161,8,149.52533333333332,170.64533333333333,21.120000000000005,319,364,45,ki_chroma_acts_smoothed
161,9,170.64533333333333,204.875,34.229666666666674,364,435,71,ki_chroma_acts_smoothed
162,1,0.0,31.552000000000003,31.552000000000003,0,65,65,chromagram
162,2,31.552000000000003,61.48266666666667,29.930666666666664,65,126,61,chromagram
162,3,61.48266666666667,63.44533333333334,1.9626666666666708,126,130,4,chromagram
162,4,63.44533333333334,94.848,31.40266666666666,130,194,64,chromagram
162,5,94.848,124.77866666666667,29.930666666666667,194,255,61,chromagram
162,6,124.77866666666667,157.65333333333336,32.8746666666667,255,322,67,chromagram
162,7,157.65333333333336,182.1866666666667,24.53333333333333,322,372,50,chromagram
162,8,182.1866666666667,189.056,6.869333333333316,372,386,14,chromagram
162,9,189.056,225.088,36.03199999999998,386,458,72,chromagram
162,1,0.0,31.552000000000003,31.552000000000003,0,65,65,chroma_acts
162,2,31.552000000000003,45.781333333333336,14.229333333333333,65,94,29,chroma_acts
162,3,45.781333333333336,61.48266666666667,15.70133333333333,94,126,32,chroma_acts
162,4,61.48266666666667,94.848,33.36533333333333,126,194,68,chroma_acts
162,5,94.848,124.77866666666667,29.930666666666667,194,255,61,chroma_acts
162,6,124.77866666666667,141.46133333333336,16.68266666666669,255,289,34,chroma_acts
162,7,141.46133333333336,182.1866666666667,40.72533333333334,289,372,83,chroma_acts
162,8,182.1866666666667,189.056,6.869333333333316,372,386,14,chroma_acts
162,9,189.056,225.088,36.03199999999998,386,458,72,chroma_acts
162,1,0.0,31.552000000000003,31.552000000000003,0,65,65,chroma_acts_smoothed
162,2,31.552000000000003,63.44533333333334,31.893333333333334,65,130,65,chroma_acts_smoothed
162,3,63.44533333333334,94.35733333333333,30.911999999999992,130,193,63,chroma_acts_smoothed
162,4,94.35733333333333,124.77866666666667,30.421333333333337,193,255,62,chroma_acts_smoothed
162,5,124.77866666666667,141.95200000000003,17.17333333333336,255,290,35,chroma_acts_smoothed
162,6,141.95200000000003,182.1866666666667,40.23466666666667,290,372,82,chroma_acts_smoothed
162,7,182.1866666666667,189.056,6.869333333333316,372,386,14,chroma_acts_smoothed
162,8,189.056,225.088,36.03199999999998,386,458,72,chroma_acts_smoothed
162,1,0.0,31.552000000000003,31.552000000000003,0,65,65,ki_chroma
162,2,31.552000000000003,61.48266666666667,29.930666666666664,65,126,61,ki_chroma
162,3,61.48266666666667,63.44533333333334,1.9626666666666708,126,130,4,ki_chroma
162,4,63.44533333333334,94.848,31.40266666666666,130,194,64,ki_chroma
162,5,94.848,124.77866666666667,29.930666666666667,194,255,61,ki_chroma
162,6,124.77866666666667,157.65333333333336,32.8746666666667,255,322,67,ki_chroma
162,7,157.65333333333336,182.1866666666667,24.53333333333333,322,372,50,ki_chroma
162,8,182.1866666666667,189.056,6.869333333333316,372,386,14,ki_chroma
162,9,189.056,225.088,36.03199999999998,386,458,72,ki_chroma
162,1,0.0,31.552000000000003,31.552000000000003,0,65,65,ki_chroma_acts
162,2,31.552000000000003,45.781333333333336,14.229333333333333,65,94,29,ki_chroma_acts
162,3,45.781333333333336,61.48266666666667,15.70133333333333,94,126,32,ki_chroma_acts
162,4,61.48266666666667,94.848,33.36533333333333,126,194,68,ki_chroma_acts
162,5,94.848,124.77866666666667,29.930666666666667,194,255,61,ki_chroma_acts
162,6,124.77866666666667,141.46133333333336,16.68266666666669,255,289,34,ki_chroma_acts
162,7,141.46133333333336,182.1866666666667,40.72533333333334,289,372,83,ki_chroma_acts
162,8,182.1866666666667,189.056,6.869333333333316,372,386,14,ki_chroma_acts
162,9,189.056,225.088,36.03199999999998,386,458,72,ki_chroma_acts
162,1,0.0,31.552000000000003,31.552000000000003,0,65,65,ki_chroma_acts_smoothed
162,2,31.552000000000003,63.44533333333334,31.893333333333334,65,130,65,ki_chroma_acts_smoothed
162,3,63.44533333333334,94.35733333333333,30.911999999999992,130,193,63,ki_chroma_acts_smoothed
162,4,94.35733333333333,124.77866666666667,30.421333333333337,193,255,62,ki_chroma_acts_smoothed
162,5,124.77866666666667,141.95200000000003,17.17333333333336,255,290,35,ki_chroma_acts_smoothed
162,6,141.95200000000003,182.1866666666667,40.23466666666667,290,372,82,ki_chroma_acts_smoothed
162,7,182.1866666666667,189.056,6.869333333333316,372,386,14,ki_chroma_acts_smoothed
162,8,189.056,225.088,36.03199999999998,386,458,72,ki_chroma_acts_smoothed
163,1,0.0,7.295999999999999,7.295999999999999,0,16,16,chromagram
163,2,7.295999999999999,30.336,23.04,16,64,48,chromagram
163,3,30.336,38.016,7.68,64,80,16,chromagram
163,4,38.016,53.855999999999995,15.839999999999996,80,113,33,chromagram
163,5,53.855999999999995,68.736,14.88000000000001,113,144,31,chromagram
163,6,68.736,103.296,34.56,144,216,72,chromagram
163,7,103.296,115.29599999999999,11.999999999999986,216,241,25,chromagram
163,8,115.29599999999999,130.176,14.879999999999995,241,272,31,chromagram
163,9,130.176,162.029,31.85300000000001,272,337,65,chromagram
163,1,0.0,7.295999999999999,7.295999999999999,0,16,16,chroma_acts
163,2,7.295999999999999,30.816,23.52,16,65,49,chroma_acts
163,3,30.816,38.016,7.199999999999999,65,80,15,chroma_acts
163,4,38.016,53.855999999999995,15.839999999999996,80,113,33,chroma_acts
163,5,53.855999999999995,68.736,14.88000000000001,113,144,31,chroma_acts
163,6,68.736,99.936,31.200000000000003,144,209,65,chroma_acts
163,7,99.936,115.29599999999999,15.359999999999985,209,241,32,chroma_acts
163,8,115.29599999999999,130.176,14.879999999999995,241,272,31,chroma_acts
163,9,130.176,162.029,31.85300000000001,272,337,65,chroma_acts
163,1,0.0,7.295999999999999,7.295999999999999,0,16,16,chroma_acts_smoothed
163,2,7.295999999999999,30.336,23.04,16,64,48,chroma_acts_smoothed
163,3,30.336,38.016,7.68,64,80,16,chroma_acts_smoothed
163,4,38.016,54.33599999999999,16.319999999999993,80,114,34,chroma_acts_smoothed
163,5,54.33599999999999,68.736,14.400000000000013,114,144,30,chroma_acts_smoothed
163,6,68.736,99.936,31.200000000000003,144,209,65,chroma_acts_smoothed
163,7,99.936,115.29599999999999,15.359999999999985,209,241,32,chroma_acts_smoothed
163,8,115.29599999999999,130.656,15.360000000000014,241,273,32,chroma_acts_smoothed
163,9,130.656,162.029,31.37299999999999,273,337,64,chroma_acts_smoothed
163,1,0.0,7.295999999999999,7.295999999999999,0,16,16,ki_chroma
163,2,7.295999999999999,30.336,23.04,16,64,48,ki_chroma
163,3,30.336,38.016,7.68,64,80,16,ki_chroma
163,4,38.016,53.855999999999995,15.839999999999996,80,113,33,ki_chroma
163,5,53.855999999999995,68.736,14.88000000000001,113,144,31,ki_chroma
163,6,68.736,103.296,34.56,144,216,72,ki_chroma
163,7,103.296,115.29599999999999,11.999999999999986,216,241,25,ki_chroma
163,8,115.29599999999999,130.176,14.879999999999995,241,272,31,ki_chroma
163,9,130.176,162.029,31.85300000000001,272,337,65,ki_chroma
163,1,0.0,7.295999999999999,7.295999999999999,0,16,16,ki_chroma_acts
163,2,7.295999999999999,30.816,23.52,16,65,49,ki_chroma_acts
163,3,30.816,38.016,7.199999999999999,65,80,15,ki_chroma_acts
163,4,38.016,53.855999999999995,15.839999999999996,80,113,33,ki_chroma_acts
163,5,53.855999999999995,68.736,14.88000000000001,113,144,31,ki_chroma_acts
163,6,68.736,99.936,31.200000000000003,144,209,65,ki_chroma_acts
163,7,99.936,115.29599999999999,15.359999999999985,209,241,32,ki_chroma_acts
163,8,115.29599999999999,130.176,14.879999999999995,241,272,31,ki_chroma_acts
163,9,130.176,162.029,31.85300000000001,272,337,65,ki_chroma_acts
163,1,0.0,7.295999999999999,7.295999999999999,0,16,16,ki_chroma_acts_smoothed
163,2,7.295999999999999,30.336,23.04,16,64,48,ki_chroma_acts_smoothed
163,3,30.336,38.016,7.68,64,80,16,ki_chroma_acts_smoothed
163,4,38.016,54.33599999999999,16.319999999999993,80,114,34,ki_chroma_acts_smoothed
163,5,54.33599999999999,68.736,14.400000000000013,114,144,30,ki_chroma_acts_smoothed
163,6,68.736,99.936,31.200000000000003,144,209,65,ki_chroma_acts_smoothed
163,7,99.936,115.29599999999999,15.359999999999985,209,241,32,ki_chroma_acts_smoothed
163,8,115.29599999999999,130.656,15.360000000000014,241,273,32,ki_chroma_acts_smoothed
163,9,130.656,162.029,31.37299999999999,273,337,64,ki_chroma_acts_smoothed
164,1,0.0,3.6586666666666665,3.6586666666666665,0,8,8,chromagram
164,2,3.6586666666666665,18.538666666666664,14.879999999999997,8,39,31,chromagram
164,3,18.538666666666664,34.37866666666667,15.840000000000003,39,72,33,chromagram
164,4,34.37866666666667,49.25866666666666,14.879999999999995,72,103,31,chromagram
164,5,49.25866666666666,80.45866666666667,31.20000000000001,103,168,65,chromagram
164,6,80.45866666666667,94.85866666666666,14.399999999999991,168,198,30,chromagram
164,7,94.85866666666666,123.65866666666666,28.799999999999997,198,258,60,chromagram
164,8,123.65866666666666,127.01866666666666,3.3599999999999994,258,265,7,chromagram
164,9,127.01866666666666,159.3,32.28133333333335,265,331,66,chromagram
164,1,0.0,4.1386666666666665,4.1386666666666665,0,9,9,chroma_acts
164,2,4.1386666666666665,19.018666666666668,14.880000000000003,9,40,31,chroma_acts
164,3,19.018666666666668,34.37866666666667,15.36,40,72,32,chroma_acts
164,4,34.37866666666667,49.25866666666666,14.879999999999995,72,103,31,chroma_acts
164,5,49.25866666666666,80.45866666666667,31.20000000000001,103,168,65,chroma_acts
164,6,80.45866666666667,94.85866666666666,14.399999999999991,168,198,30,chroma_acts
164,7,94.85866666666666,123.65866666666666,28.799999999999997,198,258,60,chroma_acts
164,8,123.65866666666666,127.01866666666666,3.3599999999999994,258,265,7,chroma_acts
164,9,127.01866666666666,159.3,32.28133333333335,265,331,66,chroma_acts
164,1,0.0,3.6586666666666665,3.6586666666666665,0,8,8,chroma_acts_smoothed
164,2,3.6586666666666665,19.498666666666665,15.839999999999998,8,41,33,chroma_acts_smoothed
164,3,19.498666666666665,34.37866666666667,14.880000000000003,41,72,31,chroma_acts_smoothed
164,4,34.37866666666667,51.178666666666665,16.799999999999997,72,107,35,chroma_acts_smoothed
164,5,51.178666666666665,80.45866666666667,29.28000000000001,107,168,61,chroma_acts_smoothed
164,6,80.45866666666667,94.85866666666666,14.399999999999991,168,198,30,chroma_acts_smoothed
164,7,94.85866666666666,123.65866666666666,28.799999999999997,198,258,60,chroma_acts_smoothed
164,8,123.65866666666666,127.01866666666666,3.3599999999999994,258,265,7,chroma_acts_smoothed
164,9,127.01866666666666,159.3,32.28133333333335,265,331,66,chroma_acts_smoothed
164,1,0.0,3.6586666666666665,3.6586666666666665,0,8,8,ki_chroma
164,2,3.6586666666666665,18.538666666666664,14.879999999999997,8,39,31,ki_chroma
164,3,18.538666666666664,34.37866666666667,15.840000000000003,39,72,33,ki_chroma
164,4,34.37866666666667,49.25866666666666,14.879999999999995,72,103,31,ki_chroma
164,5,49.25866666666666,80.45866666666667,31.20000000000001,103,168,65,ki_chroma
164,6,80.45866666666667,94.85866666666666,14.399999999999991,168,198,30,ki_chroma
164,7,94.85866666666666,123.65866666666666,28.799999999999997,198,258,60,ki_chroma
164,8,123.65866666666666,127.01866666666666,3.3599999999999994,258,265,7,ki_chroma
164,9,127.01866666666666,159.3,32.28133333333335,265,331,66,ki_chroma
164,1,0.0,4.1386666666666665,4.1386666666666665,0,9,9,ki_chroma_acts
164,2,4.1386666666666665,19.018666666666668,14.880000000000003,9,40,31,ki_chroma_acts
164,3,19.018666666666668,34.37866666666667,15.36,40,72,32,ki_chroma_acts
164,4,34.37866666666667,49.25866666666666,14.879999999999995,72,103,31,ki_chroma_acts
164,5,49.25866666666666,80.45866666666667,31.20000000000001,103,168,65,ki_chroma_acts
164,6,80.45866666666667,94.85866666666666,14.399999999999991,168,198,30,ki_chroma_acts
164,7,94.85866666666666,123.65866666666666,28.799999999999997,198,258,60,ki_chroma_acts
164,8,123.65866666666666,127.01866666666666,3.3599999999999994,258,265,7,ki_chroma_acts
164,9,127.01866666666666,159.3,32.28133333333335,265,331,66,ki_chroma_acts
164,1,0.0,3.6586666666666665,3.6586666666666665,0,8,8,ki_chroma_acts_smoothed
164,2,3.6586666666666665,19.498666666666665,15.839999999999998,8,41,33,ki_chroma_acts_smoothed
164,3,19.498666666666665,34.37866666666667,14.880000000000003,41,72,31,ki_chroma_acts_smoothed
164,4,34.37866666666667,51.178666666666665,16.799999999999997,72,107,35,ki_chroma_acts_smoothed
164,5,51.178666666666665,80.45866666666667,29.28000000000001,107,168,61,ki_chroma_acts_smoothed
164,6,80.45866666666667,94.85866666666666,14.399999999999991,168,198,30,ki_chroma_acts_smoothed
164,7,94.85866666666666,123.65866666666666,28.799999999999997,198,258,60,ki_chroma_acts_smoothed
164,8,123.65866666666666,127.01866666666666,3.3599999999999994,258,265,7,ki_chroma_acts_smoothed
164,9,127.01866666666666,159.3,32.28133333333335,265,331,66,ki_chroma_acts_smoothed
165,1,0.0,4.341333333333334,4.341333333333334,0,10,10,chromagram
165,2,4.341333333333334,42.82666666666667,38.48533333333334,10,92,82,chromagram
165,3,42.82666666666667,72.39466666666667,29.567999999999998,92,155,63,chromagram
165,4,72.39466666666667,119.79733333333333,47.40266666666666,155,256,101,chromagram
165,5,119.79733333333333,139.97866666666667,20.181333333333342,256,299,43,chromagram
165,6,139.97866666666667,147.95733333333334,7.978666666666669,299,316,17,chromagram
165,7,147.95733333333334,177.056,29.098666666666674,316,378,62,chromagram
165,8,177.056,178.93333333333334,1.8773333333333255,378,382,4,chromagram
165,9,178.93333333333334,194.604,15.670666666666676,382,414,32,chromagram
165,1,0.0,4.341333333333334,4.341333333333334,0,10,10,chroma_acts
165,2,4.341333333333334,42.82666666666667,38.48533333333334,10,92,82,chroma_acts
165,3,42.82666666666667,72.39466666666667,29.567999999999998,92,155,63,chroma_acts
165,4,72.39466666666667,122.144,49.74933333333334,155,261,106,chroma_acts
165,5,122.144,126.83733333333333,4.693333333333328,261,271,10,chroma_acts
165,6,126.83733333333333,137.16266666666667,10.325333333333333,271,293,22,chroma_acts
165,7,137.16266666666667,140.91733333333335,3.7546666666666795,293,301,8,chroma_acts
165,8,140.91733333333335,147.95733333333334,7.039999999999992,301,316,15,chroma_acts
165,9,147.95733333333334,194.604,46.646666666666675,316,414,98,chroma_acts
165,1,0.0,4.341333333333334,4.341333333333334,0,10,10,chroma_acts_smoothed
165,2,4.341333333333334,42.82666666666667,38.48533333333334,10,92,82,chroma_acts_smoothed
165,3,42.82666666666667,72.39466666666667,29.567999999999998,92,155,63,chroma_acts_smoothed
165,4,72.39466666666667,122.61333333333333,50.218666666666664,155,262,107,chroma_acts_smoothed
165,5,122.61333333333333,126.83733333333333,4.224000000000004,262,271,9,chroma_acts_smoothed
165,6,126.83733333333333,137.16266666666667,10.325333333333333,271,293,22,chroma_acts_smoothed
165,7,137.16266666666667,140.91733333333335,3.7546666666666795,293,301,8,chroma_acts_smoothed
165,8,140.91733333333335,149.83466666666666,8.917333333333318,301,320,19,chroma_acts_smoothed
165,9,149.83466666666666,194.604,44.76933333333335,320,414,94,chroma_acts_smoothed
165,1,0.0,4.341333333333334,4.341333333333334,0,10,10,ki_chroma
165,2,4.341333333333334,42.82666666666667,38.48533333333334,10,92,82,ki_chroma
165,3,42.82666666666667,72.39466666666667,29.567999999999998,92,155,63,ki_chroma
165,4,72.39466666666667,119.79733333333333,47.40266666666666,155,256,101,ki_chroma
165,5,119.79733333333333,139.97866666666667,20.181333333333342,256,299,43,ki_chroma
165,6,139.97866666666667,147.95733333333334,7.978666666666669,299,316,17,ki_chroma
165,7,147.95733333333334,177.056,29.098666666666674,316,378,62,ki_chroma
165,8,177.056,178.93333333333334,1.8773333333333255,378,382,4,ki_chroma
165,9,178.93333333333334,194.604,15.670666666666676,382,414,32,ki_chroma
165,1,0.0,4.341333333333334,4.341333333333334,0,10,10,ki_chroma_acts
165,2,4.341333333333334,42.82666666666667,38.48533333333334,10,92,82,ki_chroma_acts
165,3,42.82666666666667,72.39466666666667,29.567999999999998,92,155,63,ki_chroma_acts
165,4,72.39466666666667,122.144,49.74933333333334,155,261,106,ki_chroma_acts
165,5,122.144,126.83733333333333,4.693333333333328,261,271,10,ki_chroma_acts
165,6,126.83733333333333,137.16266666666667,10.325333333333333,271,293,22,ki_chroma_acts
165,7,137.16266666666667,140.91733333333335,3.7546666666666795,293,301,8,ki_chroma_acts
165,8,140.91733333333335,147.95733333333334,7.039999999999992,301,316,15,ki_chroma_acts
165,9,147.95733333333334,194.604,46.646666666666675,316,414,98,ki_chroma_acts
165,1,0.0,4.341333333333334,4.341333333333334,0,10,10,ki_chroma_acts_smoothed
165,2,4.341333333333334,42.82666666666667,38.48533333333334,10,92,82,ki_chroma_acts_smoothed
165,3,42.82666666666667,72.39466666666667,29.567999999999998,92,155,63,ki_chroma_acts_smoothed
165,4,72.39466666666667,122.61333333333333,50.218666666666664,155,262,107,ki_chroma_acts_smoothed
165,5,122.61333333333333,126.83733333333333,4.224000000000004,262,271,9,ki_chroma_acts_smoothed
165,6,126.83733333333333,137.16266666666667,10.325333333333333,271,293,22,ki_chroma_acts_smoothed
165,7,137.16266666666667,140.91733333333335,3.7546666666666795,293,301,8,ki_chroma_acts_smoothed
165,8,140.91733333333335,149.83466666666666,8.917333333333318,301,320,19,ki_chroma_acts_smoothed
165,9,149.83466666666666,194.604,44.76933333333335,320,414,94,ki_chroma_acts_smoothed
166,1,0.0,3.6693333333333333,3.6693333333333333,0,8,8,chromagram
166,2,3.6693333333333333,38.22933333333334,34.56,8,80,72,chromagram
166,3,38.22933333333334,64.62933333333332,26.399999999999984,80,135,55,chromagram
166,4,64.62933333333332,79.98933333333332,15.36,135,167,32,chromagram
166,5,79.98933333333332,102.54933333333332,22.560000000000002,167,214,47,chromagram
166,6,102.54933333333332,117.90933333333332,15.36,214,246,32,chromagram
166,7,117.90933333333332,148.62933333333334,30.720000000000013,246,310,64,chromagram
166,8,148.62933333333334,180.342,31.712666666666678,310,375,65,chromagram
166,1,0.0,3.6693333333333333,3.6693333333333333,0,8,8,chroma_acts
166,2,3.6693333333333333,38.70933333333333,35.04,8,81,73,chroma_acts
166,3,38.70933333333333,64.62933333333332,25.919999999999987,81,135,54,chroma_acts
166,4,64.62933333333332,76.62933333333332,12.0,135,160,25,chroma_acts
166,5,76.62933333333332,79.98933333333332,3.3599999999999994,160,167,7,chroma_acts
166,6,79.98933333333332,102.54933333333332,22.560000000000002,167,214,47,chroma_acts
166,7,102.54933333333332,117.90933333333332,15.36,214,246,32,chroma_acts
166,8,117.90933333333332,147.18933333333334,29.280000000000015,246,307,61,chroma_acts
166,9,147.18933333333334,180.342,33.152666666666676,307,375,68,chroma_acts
166,1,0.0,3.6693333333333333,3.6693333333333333,0,8,8,chroma_acts_smoothed
166,2,3.6693333333333333,38.70933333333333,35.04,8,81,73,chroma_acts_smoothed
166,3,38.70933333333333,64.62933333333332,25.919999999999987,81,135,54,chroma_acts_smoothed
166,4,64.62933333333332,76.62933333333332,12.0,135,160,25,chroma_acts_smoothed
166,5,76.62933333333332,79.98933333333332,3.3599999999999994,160,167,7,chroma_acts_smoothed
166,6,79.98933333333332,102.54933333333332,22.560000000000002,167,214,47,chroma_acts_smoothed
166,7,102.54933333333332,117.90933333333332,15.36,214,246,32,chroma_acts_smoothed
166,8,117.90933333333332,148.62933333333334,30.720000000000013,246,310,64,chroma_acts_smoothed
166,9,148.62933333333334,180.342,31.712666666666678,310,375,65,chroma_acts_smoothed
166,1,0.0,3.6693333333333333,3.6693333333333333,0,8,8,ki_chroma
166,2,3.6693333333333333,38.22933333333334,34.56,8,80,72,ki_chroma
166,3,38.22933333333334,64.62933333333332,26.399999999999984,80,135,55,ki_chroma
166,4,64.62933333333332,79.98933333333332,15.36,135,167,32,ki_chroma
166,5,79.98933333333332,102.54933333333332,22.560000000000002,167,214,47,ki_chroma
166,6,102.54933333333332,117.90933333333332,15.36,214,246,32,ki_chroma
166,7,117.90933333333332,148.62933333333334,30.720000000000013,246,310,64,ki_chroma
166,8,148.62933333333334,180.342,31.712666666666678,310,375,65,ki_chroma
166,1,0.0,3.6693333333333333,3.6693333333333333,0,8,8,ki_chroma_acts
166,2,3.6693333333333333,38.70933333333333,35.04,8,81,73,ki_chroma_acts
166,3,38.70933333333333,64.62933333333332,25.919999999999987,81,135,54,ki_chroma_acts
166,4,64.62933333333332,76.62933333333332,12.0,135,160,25,ki_chroma_acts
166,5,76.62933333333332,79.98933333333332,3.3599999999999994,160,167,7,ki_chroma_acts
166,6,79.98933333333332,102.54933333333332,22.560000000000002,167,214,47,ki_chroma_acts
166,7,102.54933333333332,117.90933333333332,15.36,214,246,32,ki_chroma_acts
166,8,117.90933333333332,147.18933333333334,29.280000000000015,246,307,61,ki_chroma_acts
166,9,147.18933333333334,180.342,33.152666666666676,307,375,68,ki_chroma_acts
166,1,0.0,3.6693333333333333,3.6693333333333333,0,8,8,ki_chroma_acts_smoothed
166,2,3.6693333333333333,38.70933333333333,35.04,8,81,73,ki_chroma_acts_smoothed
166,3,38.70933333333333,64.62933333333332,25.919999999999987,81,135,54,ki_chroma_acts_smoothed
166,4,64.62933333333332,76.62933333333332,12.0,135,160,25,ki_chroma_acts_smoothed
166,5,76.62933333333332,79.98933333333332,3.3599999999999994,160,167,7,ki_chroma_acts_smoothed
166,6,79.98933333333332,102.54933333333332,22.560000000000002,167,214,47,ki_chroma_acts_smoothed
166,7,102.54933333333332,117.90933333333332,15.36,214,246,32,ki_chroma_acts_smoothed
166,8,117.90933333333332,148.62933333333334,30.720000000000013,246,310,64,ki_chroma_acts_smoothed
166,9,148.62933333333334,180.342,31.712666666666678,310,375,65,ki_chroma_acts_smoothed
168,1,0.0,18.933333333333334,18.933333333333334,0,39,39,chromagram
168,2,18.933333333333334,35.12533333333333,16.191999999999997,39,72,33,chromagram
168,3,35.12533333333333,51.31733333333333,16.192,72,105,33,chromagram
168,4,51.31733333333333,66.03733333333334,14.720000000000006,105,135,30,chromagram
168,5,66.03733333333334,70.944,4.906666666666666,135,145,10,chromagram
168,6,70.944,84.68266666666666,13.73866666666666,145,173,28,chromagram
168,7,84.68266666666666,102.34666666666666,17.664,173,209,36,chromagram
168,8,102.34666666666666,156.884,54.53733333333332,209,319,110,chromagram
168,1,0.0,18.933333333333334,18.933333333333334,0,39,39,chroma_acts
168,2,18.933333333333334,51.31733333333333,32.384,39,105,66,chroma_acts
168,3,51.31733333333333,64.56533333333333,13.247999999999998,105,132,27,chroma_acts
168,4,64.56533333333333,70.45333333333333,5.888000000000005,132,144,12,chroma_acts
168,5,70.45333333333333,118.048,47.59466666666667,144,241,97,chroma_acts
168,6,118.048,131.7866666666667,13.738666666666688,241,269,28,chroma_acts
168,7,131.7866666666667,133.74933333333334,1.9626666666666495,269,273,4,chroma_acts
168,8,133.74933333333334,156.884,23.134666666666647,273,319,46,chroma_acts
168,1,0.0,19.424000000000003,19.424000000000003,0,40,40,chroma_acts_smoothed
168,2,19.424000000000003,35.616,16.191999999999997,40,73,33,chroma_acts_smoothed
168,3,35.616,51.31733333333333,15.70133333333333,73,105,32,chroma_acts_smoothed
168,4,51.31733333333333,67.01866666666666,15.70133333333333,105,137,32,chroma_acts_smoothed
168,5,67.01866666666666,70.45333333333333,3.434666666666672,137,144,7,chroma_acts_smoothed
168,6,70.45333333333333,83.70133333333334,13.248000000000005,144,171,27,chroma_acts_smoothed
168,7,83.70133333333334,118.048,34.346666666666664,171,241,70,chroma_acts_smoothed
168,8,118.048,156.884,38.835999999999984,241,319,78,chroma_acts_smoothed
168,1,0.0,18.933333333333334,18.933333333333334,0,39,39,ki_chroma
168,2,18.933333333333334,35.12533333333333,16.191999999999997,39,72,33,ki_chroma
168,3,35.12533333333333,51.31733333333333,16.192,72,105,33,ki_chroma
168,4,51.31733333333333,66.03733333333334,14.720000000000006,105,135,30,ki_chroma
168,5,66.03733333333334,70.944,4.906666666666666,135,145,10,ki_chroma
168,6,70.944,84.68266666666666,13.73866666666666,145,173,28,ki_chroma
168,7,84.68266666666666,102.34666666666666,17.664,173,209,36,ki_chroma
168,8,102.34666666666666,156.884,54.53733333333332,209,319,110,ki_chroma
168,1,0.0,18.933333333333334,18.933333333333334,0,39,39,ki_chroma_acts
168,2,18.933333333333334,51.31733333333333,32.384,39,105,66,ki_chroma_acts
168,3,51.31733333333333,64.56533333333333,13.247999999999998,105,132,27,ki_chroma_acts
168,4,64.56533333333333,70.45333333333333,5.888000000000005,132,144,12,ki_chroma_acts
168,5,70.45333333333333,118.048,47.59466666666667,144,241,97,ki_chroma_acts
168,6,118.048,131.7866666666667,13.738666666666688,241,269,28,ki_chroma_acts
168,7,131.7866666666667,133.74933333333334,1.9626666666666495,269,273,4,ki_chroma_acts
168,8,133.74933333333334,156.884,23.134666666666647,273,319,46,ki_chroma_acts
168,1,0.0,19.424000000000003,19.424000000000003,0,40,40,ki_chroma_acts_smoothed
168,2,19.424000000000003,35.616,16.191999999999997,40,73,33,ki_chroma_acts_smoothed
168,3,35.616,51.31733333333333,15.70133333333333,73,105,32,ki_chroma_acts_smoothed
168,4,51.31733333333333,67.01866666666666,15.70133333333333,105,137,32,ki_chroma_acts_smoothed
168,5,67.01866666666666,70.45333333333333,3.434666666666672,137,144,7,ki_chroma_acts_smoothed
168,6,70.45333333333333,83.70133333333334,13.248000000000005,144,171,27,ki_chroma_acts_smoothed
168,7,83.70133333333334,118.048,34.346666666666664,171,241,70,ki_chroma_acts_smoothed
168,8,118.048,156.884,38.835999999999984,241,319,78,ki_chroma_acts_smoothed
170,1,0.0,15.125333333333334,15.125333333333334,0,33,33,chromagram
170,2,15.125333333333334,45.632000000000005,30.50666666666667,33,98,65,chromagram
170,3,45.632000000000005,90.688,45.056,98,194,96,chromagram
170,4,90.688,106.176,15.488,194,227,33,chromagram
170,5,106.176,118.848,12.671999999999997,227,254,27,chromagram
170,6,118.848,172.8213333333333,53.973333333333315,254,369,115,chromagram
170,7,172.8213333333333,188.3093333333333,15.488,369,402,33,chromagram
170,8,188.3093333333333,203.32799999999997,15.018666666666661,402,434,32,chromagram
170,9,203.32799999999997,217.266,13.938000000000017,434,462,28,chromagram
170,1,0.0,15.125333333333334,15.125333333333334,0,33,33,chroma_acts
170,2,15.125333333333334,45.632000000000005,30.50666666666667,33,98,65,chroma_acts
170,3,45.632000000000005,90.688,45.056,98,194,96,chroma_acts
170,4,90.688,106.176,15.488,194,227,33,chroma_acts
170,5,106.176,118.37866666666666,12.202666666666659,227,253,26,chroma_acts
170,6,118.37866666666666,165.78133333333332,47.40266666666666,253,354,101,chroma_acts
170,7,165.78133333333332,172.8213333333333,7.039999999999992,354,369,15,chroma_acts
170,8,172.8213333333333,203.32799999999997,30.50666666666666,369,434,65,chroma_acts
170,9,203.32799999999997,217.266,13.938000000000017,434,462,28,chroma_acts
170,1,0.0,14.656,14.656,0,32,32,chroma_acts_smoothed
170,2,14.656,45.632000000000005,30.976000000000006,32,98,66,chroma_acts_smoothed
170,3,45.632000000000005,90.688,45.056,98,194,96,chroma_acts_smoothed
170,4,90.688,106.176,15.488,194,227,33,chroma_acts_smoothed
170,5,106.176,118.37866666666666,12.202666666666659,227,253,26,chroma_acts_smoothed
170,6,118.37866666666666,165.78133333333332,47.40266666666666,253,354,101,chroma_acts_smoothed
170,7,165.78133333333332,172.8213333333333,7.039999999999992,354,369,15,chroma_acts_smoothed
170,8,172.8213333333333,203.32799999999997,30.50666666666666,369,434,65,chroma_acts_smoothed
170,9,203.32799999999997,217.266,13.938000000000017,434,462,28,chroma_acts_smoothed
170,1,0.0,15.125333333333334,15.125333333333334,0,33,33,ki_chroma
170,2,15.125333333333334,45.632000000000005,30.50666666666667,33,98,65,ki_chroma
170,3,45.632000000000005,90.688,45.056,98,194,96,ki_chroma
170,4,90.688,106.176,15.488,194,227,33,ki_chroma
170,5,106.176,118.848,12.671999999999997,227,254,27,ki_chroma
170,6,118.848,172.8213333333333,53.973333333333315,254,369,115,ki_chroma
170,7,172.8213333333333,188.3093333333333,15.488,369,402,33,ki_chroma
170,8,188.3093333333333,203.32799999999997,15.018666666666661,402,434,32,ki_chroma
170,9,203.32799999999997,217.266,13.938000000000017,434,462,28,ki_chroma
170,1,0.0,15.125333333333334,15.125333333333334,0,33,33,ki_chroma_acts
170,2,15.125333333333334,45.632000000000005,30.50666666666667,33,98,65,ki_chroma_acts
170,3,45.632000000000005,90.688,45.056,98,194,96,ki_chroma_acts
170,4,90.688,106.176,15.488,194,227,33,ki_chroma_acts
170,5,106.176,118.37866666666666,12.202666666666659,227,253,26,ki_chroma_acts
170,6,118.37866666666666,165.78133333333332,47.40266666666666,253,354,101,ki_chroma_acts
170,7,165.78133333333332,172.8213333333333,7.039999999999992,354,369,15,ki_chroma_acts
170,8,172.8213333333333,203.32799999999997,30.50666666666666,369,434,65,ki_chroma_acts
170,9,203.32799999999997,217.266,13.938000000000017,434,462,28,ki_chroma_acts
170,1,0.0,14.656,14.656,0,32,32,ki_chroma_acts_smoothed
170,2,14.656,45.632000000000005,30.976000000000006,32,98,66,ki_chroma_acts_smoothed
170,3,45.632000000000005,90.688,45.056,98,194,96,ki_chroma_acts_smoothed
170,4,90.688,106.176,15.488,194,227,33,ki_chroma_acts_smoothed
170,5,106.176,118.37866666666666,12.202666666666659,227,253,26,ki_chroma_acts_smoothed
170,6,118.37866666666666,165.78133333333332,47.40266666666666,253,354,101,ki_chroma_acts_smoothed
170,7,165.78133333333332,172.8213333333333,7.039999999999992,354,369,15,ki_chroma_acts_smoothed
170,8,172.8213333333333,203.32799999999997,30.50666666666666,369,434,65,ki_chroma_acts_smoothed
170,9,203.32799999999997,217.266,13.938000000000017,434,462,28,ki_chroma_acts_smoothed
171,1,0.0,12.298666666666668,12.298666666666668,0,26,26,chromagram
171,2,12.298666666666668,52.138666666666666,39.839999999999996,26,109,83,chromagram
171,3,52.138666666666666,86.21866666666666,34.08,109,180,71,chromagram
171,4,86.21866666666666,100.61866666666666,14.399999999999991,180,210,30,chromagram
171,5,100.61866666666666,116.93866666666666,16.320000000000007,210,244,34,chromagram
171,6,116.93866666666666,154.37866666666665,37.43999999999998,244,322,78,chromagram
171,7,154.37866666666665,170.69866666666667,16.32000000000002,322,356,34,chromagram
171,8,170.69866666666667,202.85866666666666,32.16,356,423,67,chromagram
171,9,202.85866666666666,217.537,14.678333333333342,423,452,29,chromagram
171,1,0.0,17.578666666666667,17.578666666666667,0,37,37,chroma_acts
171,2,17.578666666666667,50.21866666666667,32.64,37,105,68,chroma_acts
171,3,50.21866666666667,86.21866666666666,35.99999999999999,105,180,75,chroma_acts
171,4,86.21866666666666,89.09866666666666,2.8799999999999955,180,186,6,chroma_acts
171,5,89.09866666666666,100.61866666666666,11.519999999999996,186,210,24,chroma_acts
171,6,100.61866666666666,158.69866666666667,58.08000000000001,210,331,121,chroma_acts
171,7,158.69866666666667,170.21866666666665,11.519999999999982,331,355,24,chroma_acts
171,8,170.21866666666665,202.37866666666665,32.16,355,422,67,chroma_acts
171,9,202.37866666666665,217.537,15.15833333333336,422,452,30,chroma_acts
171,1,0.0,17.578666666666667,17.578666666666667,0,37,37,chroma_acts_smoothed
171,2,17.578666666666667,50.21866666666667,32.64,37,105,68,chroma_acts_smoothed
171,3,50.21866666666667,86.21866666666666,35.99999999999999,105,180,75,chroma_acts_smoothed
171,4,86.21866666666666,100.61866666666666,14.399999999999991,180,210,30,chroma_acts_smoothed
171,5,100.61866666666666,116.93866666666666,16.320000000000007,210,244,34,chroma_acts_smoothed
171,6,116.93866666666666,154.85866666666666,37.92,244,323,79,chroma_acts_smoothed
171,7,154.85866666666666,170.69866666666667,15.840000000000003,323,356,33,chroma_acts_smoothed
171,8,170.69866666666667,201.89866666666666,31.19999999999999,356,421,65,chroma_acts_smoothed
171,9,201.89866666666666,217.537,15.63833333333335,421,452,31,chroma_acts_smoothed
171,1,0.0,12.298666666666668,12.298666666666668,0,26,26,ki_chroma
171,2,12.298666666666668,52.138666666666666,39.839999999999996,26,109,83,ki_chroma
171,3,52.138666666666666,86.21866666666666,34.08,109,180,71,ki_chroma
171,4,86.21866666666666,100.61866666666666,14.399999999999991,180,210,30,ki_chroma
171,5,100.61866666666666,116.93866666666666,16.320000000000007,210,244,34,ki_chroma
171,6,116.93866666666666,154.37866666666665,37.43999999999998,244,322,78,ki_chroma
171,7,154.37866666666665,170.69866666666667,16.32000000000002,322,356,34,ki_chroma
171,8,170.69866666666667,202.85866666666666,32.16,356,423,67,ki_chroma
171,9,202.85866666666666,217.537,14.678333333333342,423,452,29,ki_chroma
171,1,0.0,17.578666666666667,17.578666666666667,0,37,37,ki_chroma_acts
171,2,17.578666666666667,50.21866666666667,32.64,37,105,68,ki_chroma_acts
171,3,50.21866666666667,86.21866666666666,35.99999999999999,105,180,75,ki_chroma_acts
171,4,86.21866666666666,89.09866666666666,2.8799999999999955,180,186,6,ki_chroma_acts
171,5,89.09866666666666,100.61866666666666,11.519999999999996,186,210,24,ki_chroma_acts
171,6,100.61866666666666,158.69866666666667,58.08000000000001,210,331,121,ki_chroma_acts
171,7,158.69866666666667,170.21866666666665,11.519999999999982,331,355,24,ki_chroma_acts
171,8,170.21866666666665,202.37866666666665,32.16,355,422,67,ki_chroma_acts
171,9,202.37866666666665,217.537,15.15833333333336,422,452,30,ki_chroma_acts
171,1,0.0,17.578666666666667,17.578666666666667,0,37,37,ki_chroma_acts_smoothed
171,2,17.578666666666667,50.21866666666667,32.64,37,105,68,ki_chroma_acts_smoothed
171,3,50.21866666666667,86.21866666666666,35.99999999999999,105,180,75,ki_chroma_acts_smoothed
171,4,86.21866666666666,100.61866666666666,14.399999999999991,180,210,30,ki_chroma_acts_smoothed
171,5,100.61866666666666,116.93866666666666,16.320000000000007,210,244,34,ki_chroma_acts_smoothed
171,6,116.93866666666666,154.85866666666666,37.92,244,323,79,ki_chroma_acts_smoothed
171,7,154.85866666666666,170.69866666666667,15.840000000000003,323,356,33,ki_chroma_acts_smoothed
171,8,170.69866666666667,201.89866666666666,31.19999999999999,356,421,65,ki_chroma_acts_smoothed
171,9,201.89866666666666,217.537,15.63833333333335,421,452,31,ki_chroma_acts_smoothed
172,1,0.0,3.861333333333333,3.861333333333333,0,9,9,chromagram
172,2,3.861333333333333,55.488,51.626666666666665,9,119,110,chromagram
172,3,55.488,128.23466666666664,72.74666666666664,119,274,155,chromagram
172,4,128.23466666666664,141.37599999999998,13.141333333333336,274,302,28,chromagram
172,5,141.37599999999998,194.88,53.50400000000002,302,416,114,chromagram
172,6,194.88,239.93599999999998,45.05599999999998,416,512,96,chromagram
172,7,239.93599999999998,258.70933333333335,18.77333333333337,512,552,40,chromagram
172,8,258.70933333333335,287.33866666666665,28.629333333333307,552,613,61,chromagram
172,9,287.33866666666665,319.964,32.625333333333344,613,681,68,chromagram
172,1,0.0,3.861333333333333,3.861333333333333,0,9,9,chroma_acts
172,2,3.861333333333333,56.42666666666667,52.565333333333335,9,121,112,chroma_acts
172,3,56.42666666666667,128.23466666666664,71.80799999999996,121,274,153,chroma_acts
172,4,128.23466666666664,136.2133333333333,7.978666666666669,274,291,17,chroma_acts
172,5,136.2133333333333,141.37599999999998,5.1626666666666665,291,302,11,chroma_acts
172,6,141.37599999999998,194.88,53.50400000000002,302,416,114,chroma_acts
172,7,194.88,239.93599999999998,45.05599999999998,416,512,96,chroma_acts
172,8,239.93599999999998,258.70933333333335,18.77333333333337,512,552,40,chroma_acts
172,9,258.70933333333335,319.964,61.25466666666665,552,681,129,chroma_acts
172,1,0.0,3.392,3.392,0,8,8,chroma_acts_smoothed
172,2,3.392,55.488,52.096,8,119,111,chroma_acts_smoothed
172,3,55.488,128.23466666666664,72.74666666666664,119,274,155,chroma_acts_smoothed
172,4,128.23466666666664,141.37599999999998,13.141333333333336,274,302,28,chroma_acts_smoothed
172,5,141.37599999999998,194.88,53.50400000000002,302,416,114,chroma_acts_smoothed
172,6,194.88,240.40533333333332,45.52533333333332,416,513,97,chroma_acts_smoothed
172,7,240.40533333333332,258.70933333333335,18.30400000000003,513,552,39,chroma_acts_smoothed
172,8,258.70933333333335,266.688,7.978666666666641,552,569,17,chroma_acts_smoothed
172,9,266.688,319.964,53.27600000000001,569,681,112,chroma_acts_smoothed
172,1,0.0,3.861333333333333,3.861333333333333,0,9,9,ki_chroma
172,2,3.861333333333333,55.488,51.626666666666665,9,119,110,ki_chroma
172,3,55.488,128.23466666666664,72.74666666666664,119,274,155,ki_chroma
172,4,128.23466666666664,141.37599999999998,13.141333333333336,274,302,28,ki_chroma
172,5,141.37599999999998,194.88,53.50400000000002,302,416,114,ki_chroma
172,6,194.88,239.93599999999998,45.05599999999998,416,512,96,ki_chroma
172,7,239.93599999999998,258.70933333333335,18.77333333333337,512,552,40,ki_chroma
172,8,258.70933333333335,287.33866666666665,28.629333333333307,552,613,61,ki_chroma
172,9,287.33866666666665,319.964,32.625333333333344,613,681,68,ki_chroma
172,1,0.0,3.861333333333333,3.861333333333333,0,9,9,ki_chroma_acts
172,2,3.861333333333333,56.42666666666667,52.565333333333335,9,121,112,ki_chroma_acts
172,3,56.42666666666667,128.23466666666664,71.80799999999996,121,274,153,ki_chroma_acts
172,4,128.23466666666664,136.2133333333333,7.978666666666669,274,291,17,ki_chroma_acts
172,5,136.2133333333333,141.37599999999998,5.1626666666666665,291,302,11,ki_chroma_acts
172,6,141.37599999999998,194.88,53.50400000000002,302,416,114,ki_chroma_acts
172,7,194.88,239.93599999999998,45.05599999999998,416,512,96,ki_chroma_acts
172,8,239.93599999999998,258.70933333333335,18.77333333333337,512,552,40,ki_chroma_acts
172,9,258.70933333333335,319.964,61.25466666666665,552,681,129,ki_chroma_acts
172,1,0.0,3.392,3.392,0,8,8,ki_chroma_acts_smoothed
172,2,3.392,55.488,52.096,8,119,111,ki_chroma_acts_smoothed
172,3,55.488,128.23466666666664,72.74666666666664,119,274,155,ki_chroma_acts_smoothed
172,4,128.23466666666664,141.37599999999998,13.141333333333336,274,302,28,ki_chroma_acts_smoothed
172,5,141.37599999999998,194.88,53.50400000000002,302,416,114,ki_chroma_acts_smoothed
172,6,194.88,240.40533333333332,45.52533333333332,416,513,97,ki_chroma_acts_smoothed
172,7,240.40533333333332,258.70933333333335,18.30400000000003,513,552,39,ki_chroma_acts_smoothed
172,8,258.70933333333335,266.688,7.978666666666641,552,569,17,ki_chroma_acts_smoothed
172,9,266.688,319.964,53.27600000000001,569,681,112,ki_chroma_acts_smoothed
175,1,0.0,7.5840000000000005,7.5840000000000005,0,16,16,chromagram
175,2,7.5840000000000005,9.056000000000001,1.4720000000000004,16,19,3,chromagram
175,3,9.056000000000001,31.136000000000003,22.080000000000002,19,64,45,chromagram
175,4,31.136000000000003,45.36533333333333,14.22933333333333,64,93,29,chromagram
175,5,45.36533333333333,76.76800000000001,31.402666666666683,93,157,64,chromagram
175,6,76.76800000000001,79.22133333333335,2.453333333333333,157,162,5,chromagram
175,7,79.22133333333335,112.096,32.874666666666656,162,229,67,chromagram
175,8,112.096,156.74666666666667,44.650666666666666,229,320,91,chromagram
175,9,156.74666666666667,190.4,33.653333333333336,320,387,67,chromagram
175,1,0.0,18.869333333333334,18.869333333333334,0,39,39,chroma_acts
175,2,18.869333333333334,23.776,4.906666666666666,39,49,10,chroma_acts
175,3,23.776,27.21066666666667,3.4346666666666685,49,56,7,chroma_acts
175,4,27.21066666666667,29.664,2.453333333333333,56,61,5,chroma_acts
175,5,29.664,45.36533333333333,15.70133333333333,61,93,32,chroma_acts
175,6,45.36533333333333,79.22133333333335,33.856000000000016,93,162,69,chroma_acts
175,7,79.22133333333335,110.13333333333334,30.911999999999992,162,225,63,chroma_acts
175,8,110.13333333333334,148.40533333333335,38.272000000000006,225,303,78,chroma_acts
175,9,148.40533333333335,190.4,41.99466666666666,303,387,84,chroma_acts
175,1,0.0,18.869333333333334,18.869333333333334,0,39,39,chroma_acts_smoothed
175,2,18.869333333333334,23.776,4.906666666666666,39,49,10,chroma_acts_smoothed
175,3,23.776,27.21066666666667,3.4346666666666685,49,56,7,chroma_acts_smoothed
175,4,27.21066666666667,31.136000000000003,3.9253333333333345,56,64,8,chroma_acts_smoothed
175,5,31.136000000000003,45.36533333333333,14.22933333333333,64,93,29,chroma_acts_smoothed
175,6,45.36533333333333,79.22133333333335,33.856000000000016,93,162,69,chroma_acts_smoothed
175,7,79.22133333333335,110.13333333333334,30.911999999999992,162,225,63,chroma_acts_smoothed
175,8,110.13333333333334,155.76533333333333,45.63199999999999,225,318,93,chroma_acts_smoothed
175,9,155.76533333333333,190.4,34.634666666666675,318,387,69,chroma_acts_smoothed
175,1,0.0,7.5840000000000005,7.5840000000000005,0,16,16,ki_chroma
175,2,7.5840000000000005,9.056000000000001,1.4720000000000004,16,19,3,ki_chroma
175,3,9.056000000000001,31.136000000000003,22.080000000000002,19,64,45,ki_chroma
175,4,31.136000000000003,45.36533333333333,14.22933333333333,64,93,29,ki_chroma
175,5,45.36533333333333,76.76800000000001,31.402666666666683,93,157,64,ki_chroma
175,6,76.76800000000001,79.22133333333335,2.453333333333333,157,162,5,ki_chroma
175,7,79.22133333333335,112.096,32.874666666666656,162,229,67,ki_chroma
175,8,112.096,156.74666666666667,44.650666666666666,229,320,91,ki_chroma
175,9,156.74666666666667,190.4,33.653333333333336,320,387,67,ki_chroma
175,1,0.0,18.869333333333334,18.869333333333334,0,39,39,ki_chroma_acts
175,2,18.869333333333334,23.776,4.906666666666666,39,49,10,ki_chroma_acts
175,3,23.776,27.21066666666667,3.4346666666666685,49,56,7,ki_chroma_acts
175,4,27.21066666666667,29.664,2.453333333333333,56,61,5,ki_chroma_acts
175,5,29.664,45.36533333333333,15.70133333333333,61,93,32,ki_chroma_acts
175,6,45.36533333333333,79.22133333333335,33.856000000000016,93,162,69,ki_chroma_acts
175,7,79.22133333333335,110.13333333333334,30.911999999999992,162,225,63,ki_chroma_acts
175,8,110.13333333333334,148.40533333333335,38.272000000000006,225,303,78,ki_chroma_acts
175,9,148.40533333333335,190.4,41.99466666666666,303,387,84,ki_chroma_acts
175,1,0.0,18.869333333333334,18.869333333333334,0,39,39,ki_chroma_acts_smoothed
175,2,18.869333333333334,23.776,4.906666666666666,39,49,10,ki_chroma_acts_smoothed
175,3,23.776,27.21066666666667,3.4346666666666685,49,56,7,ki_chroma_acts_smoothed
175,4,27.21066666666667,31.136000000000003,3.9253333333333345,56,64,8,ki_chroma_acts_smoothed
175,5,31.136000000000003,45.36533333333333,14.22933333333333,64,93,29,ki_chroma_acts_smoothed
175,6,45.36533333333333,79.22133333333335,33.856000000000016,93,162,69,ki_chroma_acts_smoothed
175,7,79.22133333333335,110.13333333333334,30.911999999999992,162,225,63,ki_chroma_acts_smoothed
175,8,110.13333333333334,155.76533333333333,45.63199999999999,225,318,93,ki_chroma_acts_smoothed
175,9,155.76533333333333,190.4,34.634666666666675,318,387,69,ki_chroma_acts_smoothed
176,1,0.0,15.381333333333332,15.381333333333332,0,33,33,chromagram
176,2,15.381333333333332,45.62133333333333,30.240000000000002,33,96,63,chromagram
176,3,45.62133333333333,51.38133333333333,5.759999999999998,96,108,12,chromagram
176,4,51.38133333333333,109.94133333333333,58.56,108,230,122,chromagram
176,5,109.94133333333333,114.26133333333333,4.319999999999993,230,239,9,chromagram
176,6,114.26133333333333,117.62133333333333,3.3599999999999994,239,246,7,chromagram
176,7,117.62133333333333,121.94133333333333,4.320000000000007,246,255,9,chromagram
176,8,121.94133333333333,125.30133333333333,3.3599999999999994,255,262,7,chromagram
176,9,125.30133333333333,183.553,58.251666666666665,262,382,120,chromagram
176,1,0.0,15.381333333333332,15.381333333333332,0,33,33,chroma_acts
176,2,15.381333333333332,49.46133333333333,34.08,33,104,71,chroma_acts
176,3,49.46133333333333,51.38133333333333,1.9200000000000017,104,108,4,chroma_acts
176,4,51.38133333333333,109.94133333333333,58.56,108,230,122,chroma_acts
176,5,109.94133333333333,114.26133333333333,4.319999999999993,230,239,9,chroma_acts
176,6,114.26133333333333,117.62133333333333,3.3599999999999994,239,246,7,chroma_acts
176,7,117.62133333333333,121.94133333333333,4.320000000000007,246,255,9,chroma_acts
176,8,121.94133333333333,125.30133333333333,3.3599999999999994,255,262,7,chroma_acts
176,9,125.30133333333333,183.553,58.251666666666665,262,382,120,chroma_acts
176,1,0.0,15.381333333333332,15.381333333333332,0,33,33,chroma_acts_smoothed
176,2,15.381333333333332,45.14133333333333,29.759999999999998,33,95,62,chroma_acts_smoothed
176,3,45.14133333333333,109.94133333333333,64.80000000000001,95,230,135,chroma_acts_smoothed
176,4,109.94133333333333,114.26133333333333,4.319999999999993,230,239,9,chroma_acts_smoothed
176,5,114.26133333333333,117.62133333333333,3.3599999999999994,239,246,7,chroma_acts_smoothed
176,6,117.62133333333333,121.94133333333333,4.320000000000007,246,255,9,chroma_acts_smoothed
176,7,121.94133333333333,125.30133333333333,3.3599999999999994,255,262,7,chroma_acts_smoothed
176,8,125.30133333333333,129.62133333333333,4.319999999999993,262,271,9,chroma_acts_smoothed
176,9,129.62133333333333,183.553,53.93166666666667,271,382,111,chroma_acts_smoothed
176,1,0.0,15.381333333333332,15.381333333333332,0,33,33,ki_chroma
176,2,15.381333333333332,45.62133333333333,30.240000000000002,33,96,63,ki_chroma
176,3,45.62133333333333,51.38133333333333,5.759999999999998,96,108,12,ki_chroma
176,4,51.38133333333333,109.94133333333333,58.56,108,230,122,ki_chroma
176,5,109.94133333333333,114.26133333333333,4.319999999999993,230,239,9,ki_chroma
176,6,114.26133333333333,117.62133333333333,3.3599999999999994,239,246,7,ki_chroma
176,7,117.62133333333333,121.94133333333333,4.320000000000007,246,255,9,ki_chroma
176,8,121.94133333333333,125.30133333333333,3.3599999999999994,255,262,7,ki_chroma
176,9,125.30133333333333,183.553,58.251666666666665,262,382,120,ki_chroma
176,1,0.0,15.381333333333332,15.381333333333332,0,33,33,ki_chroma_acts
176,2,15.381333333333332,49.46133333333333,34.08,33,104,71,ki_chroma_acts
176,3,49.46133333333333,51.38133333333333,1.9200000000000017,104,108,4,ki_chroma_acts
176,4,51.38133333333333,109.94133333333333,58.56,108,230,122,ki_chroma_acts
176,5,109.94133333333333,114.26133333333333,4.319999999999993,230,239,9,ki_chroma_acts
176,6,114.26133333333333,117.62133333333333,3.3599999999999994,239,246,7,ki_chroma_acts
176,7,117.62133333333333,121.94133333333333,4.320000000000007,246,255,9,ki_chroma_acts
176,8,121.94133333333333,125.30133333333333,3.3599999999999994,255,262,7,ki_chroma_acts
176,9,125.30133333333333,183.553,58.251666666666665,262,382,120,ki_chroma_acts
176,1,0.0,15.381333333333332,15.381333333333332,0,33,33,ki_chroma_acts_smoothed
176,2,15.381333333333332,45.14133333333333,29.759999999999998,33,95,62,ki_chroma_acts_smoothed
176,3,45.14133333333333,109.94133333333333,64.80000000000001,95,230,135,ki_chroma_acts_smoothed
176,4,109.94133333333333,114.26133333333333,4.319999999999993,230,239,9,ki_chroma_acts_smoothed
176,5,114.26133333333333,117.62133333333333,3.3599999999999994,239,246,7,ki_chroma_acts_smoothed
176,6,117.62133333333333,121.94133333333333,4.320000000000007,246,255,9,ki_chroma_acts_smoothed
176,7,121.94133333333333,125.30133333333333,3.3599999999999994,255,262,7,ki_chroma_acts_smoothed
176,8,125.30133333333333,129.62133333333333,4.319999999999993,262,271,9,ki_chroma_acts_smoothed
176,9,129.62133333333333,183.553,53.93166666666667,271,382,111,ki_chroma_acts_smoothed
177,1,0.0,6.272,6.272,0,14,14,chromagram
177,2,6.272,23.072,16.799999999999997,14,49,35,chromagram
177,3,23.072,68.672,45.599999999999994,49,144,95,chromagram
177,4,68.672,78.752,10.079999999999998,144,165,21,chromagram
177,5,78.752,81.63199999999999,2.8799999999999955,165,171,6,chromagram
177,6,81.63199999999999,103.71199999999999,22.08,171,217,46,chromagram
177,7,103.71199999999999,120.032,16.320000000000007,217,251,34,chromagram
177,8,120.032,152.359,32.32700000000001,251,317,66,chromagram
177,1,0.0,7.231999999999999,7.231999999999999,0,16,16,chroma_acts
177,2,7.231999999999999,23.072,15.84,16,49,33,chroma_acts
177,3,23.072,68.672,45.599999999999994,49,144,95,chroma_acts
177,4,68.672,75.872,7.200000000000003,144,159,15,chroma_acts
177,5,75.872,81.63199999999999,5.759999999999991,159,171,12,chroma_acts
177,6,81.63199999999999,103.232,21.60000000000001,171,216,45,chroma_acts
177,7,103.232,120.99199999999999,17.75999999999999,216,253,37,chroma_acts
177,8,120.99199999999999,152.359,31.36700000000002,253,317,64,chroma_acts
177,1,0.0,7.231999999999999,7.231999999999999,0,16,16,chroma_acts_smoothed
177,2,7.231999999999999,23.072,15.84,16,49,33,chroma_acts_smoothed
177,3,23.072,68.192,45.11999999999999,49,143,94,chroma_acts_smoothed
177,4,68.192,75.872,7.680000000000007,143,159,16,chroma_acts_smoothed
177,5,75.872,81.63199999999999,5.759999999999991,159,171,12,chroma_acts_smoothed
177,6,81.63199999999999,103.71199999999999,22.08,171,217,46,chroma_acts_smoothed
177,7,103.71199999999999,120.99199999999999,17.28,217,253,36,chroma_acts_smoothed
177,8,120.99199999999999,152.359,31.36700000000002,253,317,64,chroma_acts_smoothed
177,1,0.0,6.272,6.272,0,14,14,ki_chroma
177,2,6.272,23.072,16.799999999999997,14,49,35,ki_chroma
177,3,23.072,68.672,45.599999999999994,49,144,95,ki_chroma
177,4,68.672,78.752,10.079999999999998,144,165,21,ki_chroma
177,5,78.752,81.63199999999999,2.8799999999999955,165,171,6,ki_chroma
177,6,81.63199999999999,103.71199999999999,22.08,171,217,46,ki_chroma
177,7,103.71199999999999,120.032,16.320000000000007,217,251,34,ki_chroma
177,8,120.032,152.359,32.32700000000001,251,317,66,ki_chroma
177,1,0.0,7.231999999999999,7.231999999999999,0,16,16,ki_chroma_acts
177,2,7.231999999999999,23.072,15.84,16,49,33,ki_chroma_acts
177,3,23.072,68.672,45.599999999999994,49,144,95,ki_chroma_acts
177,4,68.672,75.872,7.200000000000003,144,159,15,ki_chroma_acts
177,5,75.872,81.63199999999999,5.759999999999991,159,171,12,ki_chroma_acts
177,6,81.63199999999999,103.232,21.60000000000001,171,216,45,ki_chroma_acts
177,7,103.232,120.99199999999999,17.75999999999999,216,253,37,ki_chroma_acts
177,8,120.99199999999999,152.359,31.36700000000002,253,317,64,ki_chroma_acts
177,1,0.0,7.231999999999999,7.231999999999999,0,16,16,ki_chroma_acts_smoothed
177,2,7.231999999999999,23.072,15.84,16,49,33,ki_chroma_acts_smoothed
177,3,23.072,68.192,45.11999999999999,49,143,94,ki_chroma_acts_smoothed
177,4,68.192,75.872,7.680000000000007,143,159,16,ki_chroma_acts_smoothed
177,5,75.872,81.63199999999999,5.759999999999991,159,171,12,ki_chroma_acts_smoothed
177,6,81.63199999999999,103.71199999999999,22.08,171,217,46,ki_chroma_acts_smoothed
177,7,103.71199999999999,120.99199999999999,17.28,217,253,36,ki_chroma_acts_smoothed
177,8,120.99199999999999,152.359,31.36700000000002,253,317,64,ki_chroma_acts_smoothed
178,1,0.0,29.301333333333332,29.301333333333332,0,62,62,chromagram
178,2,29.301333333333332,69.14133333333334,39.84,62,145,83,chromagram
178,3,69.14133333333334,75.38133333333333,6.239999999999995,145,158,13,chromagram
178,4,75.38133333333333,92.18133333333333,16.799999999999997,158,193,35,chromagram
178,5,92.18133333333333,108.50133333333332,16.319999999999993,193,227,34,chromagram
178,6,108.50133333333332,121.46133333333333,12.960000000000008,227,254,27,chromagram
178,7,121.46133333333333,156.218,34.75666666666666,254,325,71,chromagram
178,1,0.0,26.901333333333334,26.901333333333334,0,57,57,chroma_acts
178,2,26.901333333333334,29.301333333333332,2.3999999999999986,57,62,5,chroma_acts
178,3,29.301333333333332,69.14133333333334,39.84,62,145,83,chroma_acts
178,4,69.14133333333334,75.38133333333333,6.239999999999995,145,158,13,chroma_acts
178,5,75.38133333333333,92.18133333333333,16.799999999999997,158,193,35,chroma_acts
178,6,92.18133333333333,121.46133333333333,29.28,193,254,61,chroma_acts
178,7,121.46133333333333,156.218,34.75666666666666,254,325,71,chroma_acts
178,1,0.0,29.301333333333332,29.301333333333332,0,62,62,chroma_acts_smoothed
178,2,29.301333333333332,69.62133333333333,40.31999999999999,62,146,84,chroma_acts_smoothed
178,3,69.62133333333333,75.38133333333333,5.760000000000005,146,158,12,chroma_acts_smoothed
178,4,75.38133333333333,92.18133333333333,16.799999999999997,158,193,35,chroma_acts_smoothed
178,5,92.18133333333333,107.54133333333333,15.36,193,225,32,chroma_acts_smoothed
178,6,107.54133333333333,121.46133333333333,13.920000000000002,225,254,29,chroma_acts_smoothed
178,7,121.46133333333333,152.66133333333332,31.19999999999999,254,319,65,chroma_acts_smoothed
178,8,152.66133333333332,156.218,3.556666666666672,319,325,6,chroma_acts_smoothed
178,1,0.0,29.301333333333332,29.301333333333332,0,62,62,ki_chroma
178,2,29.301333333333332,69.14133333333334,39.84,62,145,83,ki_chroma
178,3,69.14133333333334,75.38133333333333,6.239999999999995,145,158,13,ki_chroma
178,4,75.38133333333333,92.18133333333333,16.799999999999997,158,193,35,ki_chroma
178,5,92.18133333333333,108.50133333333332,16.319999999999993,193,227,34,ki_chroma
178,6,108.50133333333332,121.46133333333333,12.960000000000008,227,254,27,ki_chroma
178,7,121.46133333333333,156.218,34.75666666666666,254,325,71,ki_chroma
178,1,0.0,26.901333333333334,26.901333333333334,0,57,57,ki_chroma_acts
178,2,26.901333333333334,29.301333333333332,2.3999999999999986,57,62,5,ki_chroma_acts
178,3,29.301333333333332,69.14133333333334,39.84,62,145,83,ki_chroma_acts
178,4,69.14133333333334,75.38133333333333,6.239999999999995,145,158,13,ki_chroma_acts
178,5,75.38133333333333,92.18133333333333,16.799999999999997,158,193,35,ki_chroma_acts
178,6,92.18133333333333,121.46133333333333,29.28,193,254,61,ki_chroma_acts
178,7,121.46133333333333,156.218,34.75666666666666,254,325,71,ki_chroma_acts
178,1,0.0,29.301333333333332,29.301333333333332,0,62,62,ki_chroma_acts_smoothed
178,2,29.301333333333332,69.62133333333333,40.31999999999999,62,146,84,ki_chroma_acts_smoothed
178,3,69.62133333333333,75.38133333333333,5.760000000000005,146,158,12,ki_chroma_acts_smoothed
178,4,75.38133333333333,92.18133333333333,16.799999999999997,158,193,35,ki_chroma_acts_smoothed
178,5,92.18133333333333,107.54133333333333,15.36,193,225,32,ki_chroma_acts_smoothed
178,6,107.54133333333333,121.46133333333333,13.920000000000002,225,254,29,ki_chroma_acts_smoothed
178,7,121.46133333333333,152.66133333333332,31.19999999999999,254,319,65,ki_chroma_acts_smoothed
178,8,152.66133333333332,156.218,3.556666666666672,319,325,6,ki_chroma_acts_smoothed
179,1,0.0,15.456,15.456,0,33,33,chromagram
179,2,15.456,29.855999999999998,14.399999999999999,33,63,30,chromagram
179,3,29.855999999999998,60.57599999999999,30.719999999999995,63,127,64,chromagram
179,4,60.57599999999999,152.736,92.16,127,319,192,chromagram
179,5,152.736,184.416,31.680000000000007,319,385,66,chromagram
179,6,184.416,217.536,33.120000000000005,385,454,69,chromagram
179,7,217.536,265.536,48.0,454,554,100,chromagram
179,8,265.536,280.416,14.879999999999995,554,585,31,chromagram
179,9,280.416,294.926,14.509999999999991,585,614,29,chromagram
179,1,0.0,15.456,15.456,0,33,33,chroma_acts
179,2,15.456,29.855999999999998,14.399999999999999,33,63,30,chroma_acts
179,3,29.855999999999998,60.096,30.24,63,126,63,chroma_acts
179,4,60.096,153.216,93.12,126,320,194,chroma_acts
179,5,153.216,184.416,31.19999999999999,320,385,65,chroma_acts
179,6,184.416,218.016,33.599999999999994,385,455,70,chroma_acts
179,7,218.016,263.13599999999997,45.119999999999976,455,549,94,chroma_acts
179,8,263.13599999999997,279.936,16.80000000000001,549,584,35,chroma_acts
179,9,279.936,294.926,14.990000000000009,584,614,30,chroma_acts
179,1,0.0,15.936,15.936,0,34,34,chroma_acts_smoothed
179,2,15.936,29.855999999999998,13.919999999999998,34,63,29,chroma_acts_smoothed
179,3,29.855999999999998,60.096,30.24,63,126,63,chroma_acts_smoothed
179,4,60.096,152.736,92.63999999999999,126,319,193,chroma_acts_smoothed
179,5,152.736,184.416,31.680000000000007,319,385,66,chroma_acts_smoothed
179,6,184.416,218.016,33.599999999999994,385,455,70,chroma_acts_smoothed
179,7,218.016,263.13599999999997,45.119999999999976,455,549,94,chroma_acts_smoothed
179,8,263.13599999999997,279.936,16.80000000000001,549,584,35,chroma_acts_smoothed
179,9,279.936,294.926,14.990000000000009,584,614,30,chroma_acts_smoothed
179,1,0.0,15.456,15.456,0,33,33,ki_chroma
179,2,15.456,29.855999999999998,14.399999999999999,33,63,30,ki_chroma
179,3,29.855999999999998,60.57599999999999,30.719999999999995,63,127,64,ki_chroma
179,4,60.57599999999999,152.736,92.16,127,319,192,ki_chroma
179,5,152.736,184.416,31.680000000000007,319,385,66,ki_chroma
179,6,184.416,217.536,33.120000000000005,385,454,69,ki_chroma
179,7,217.536,265.536,48.0,454,554,100,ki_chroma
179,8,265.536,280.416,14.879999999999995,554,585,31,ki_chroma
179,9,280.416,294.926,14.509999999999991,585,614,29,ki_chroma
179,1,0.0,15.456,15.456,0,33,33,ki_chroma_acts
179,2,15.456,29.855999999999998,14.399999999999999,33,63,30,ki_chroma_acts
179,3,29.855999999999998,60.096,30.24,63,126,63,ki_chroma_acts
179,4,60.096,153.216,93.12,126,320,194,ki_chroma_acts
179,5,153.216,184.416,31.19999999999999,320,385,65,ki_chroma_acts
179,6,184.416,218.016,33.599999999999994,385,455,70,ki_chroma_acts
179,7,218.016,263.13599999999997,45.119999999999976,455,549,94,ki_chroma_acts
179,8,263.13599999999997,279.936,16.80000000000001,549,584,35,ki_chroma_acts
179,9,279.936,294.926,14.990000000000009,584,614,30,ki_chroma_acts
179,1,0.0,15.936,15.936,0,34,34,ki_chroma_acts_smoothed
179,2,15.936,29.855999999999998,13.919999999999998,34,63,29,ki_chroma_acts_smoothed
179,3,29.855999999999998,60.096,30.24,63,126,63,ki_chroma_acts_smoothed
179,4,60.096,152.736,92.63999999999999,126,319,193,ki_chroma_acts_smoothed
179,5,152.736,184.416,31.680000000000007,319,385,66,ki_chroma_acts_smoothed
179,6,184.416,218.016,33.599999999999994,385,455,70,ki_chroma_acts_smoothed
179,7,218.016,263.13599999999997,45.119999999999976,455,549,94,ki_chroma_acts_smoothed
179,8,263.13599999999997,279.936,16.80000000000001,549,584,35,ki_chroma_acts_smoothed
179,9,279.936,294.926,14.990000000000009,584,614,30,ki_chroma_acts_smoothed
180,1,0.0,26.496,26.496,0,56,56,chromagram
180,2,26.496,30.816,4.32,56,65,9,chromagram
180,3,30.816,48.096,17.279999999999998,65,101,36,chromagram
180,4,48.096,92.736,44.64000000000001,101,194,93,chromagram
180,5,92.736,111.456,18.72,194,233,39,chromagram
180,6,111.456,205.05599999999998,93.59999999999998,233,428,195,chromagram
180,7,205.05599999999998,223.77599999999998,18.72,428,467,39,chromagram
180,8,223.77599999999998,289.304,65.52799999999999,467,602,135,chromagram
180,1,0.0,26.496,26.496,0,56,56,chroma_acts
180,2,26.496,30.816,4.32,56,65,9,chroma_acts
180,3,30.816,48.096,17.279999999999998,65,101,36,chroma_acts
180,4,48.096,92.736,44.64000000000001,101,194,93,chroma_acts
180,5,92.736,111.456,18.72,194,233,39,chroma_acts
180,6,111.456,160.416,48.959999999999994,233,335,102,chroma_acts
180,7,160.416,205.05599999999998,44.639999999999986,335,428,93,chroma_acts
180,8,205.05599999999998,224.256,19.200000000000017,428,468,40,chroma_acts
180,9,224.256,289.304,65.04799999999997,468,602,134,chroma_acts
180,1,0.0,26.976,26.976,0,57,57,chroma_acts_smoothed
180,2,26.976,30.816,3.84,57,65,8,chroma_acts_smoothed
180,3,30.816,47.61599999999999,16.799999999999994,65,100,35,chroma_acts_smoothed
180,4,47.61599999999999,93.216,45.6,100,195,95,chroma_acts_smoothed
180,5,93.216,111.456,18.24000000000001,195,233,38,chroma_acts_smoothed
180,6,111.456,160.416,48.959999999999994,233,335,102,chroma_acts_smoothed
180,7,160.416,204.576,44.16,335,427,92,chroma_acts_smoothed
180,8,204.576,223.296,18.72,427,466,39,chroma_acts_smoothed
180,9,223.296,289.304,66.00799999999998,466,602,136,chroma_acts_smoothed
180,1,0.0,26.496,26.496,0,56,56,ki_chroma
180,2,26.496,30.816,4.32,56,65,9,ki_chroma
180,3,30.816,48.096,17.279999999999998,65,101,36,ki_chroma
180,4,48.096,92.736,44.64000000000001,101,194,93,ki_chroma
180,5,92.736,111.456,18.72,194,233,39,ki_chroma
180,6,111.456,205.05599999999998,93.59999999999998,233,428,195,ki_chroma
180,7,205.05599999999998,223.77599999999998,18.72,428,467,39,ki_chroma
180,8,223.77599999999998,289.304,65.52799999999999,467,602,135,ki_chroma
180,1,0.0,26.496,26.496,0,56,56,ki_chroma_acts
180,2,26.496,30.816,4.32,56,65,9,ki_chroma_acts
180,3,30.816,48.096,17.279999999999998,65,101,36,ki_chroma_acts
180,4,48.096,92.736,44.64000000000001,101,194,93,ki_chroma_acts
180,5,92.736,111.456,18.72,194,233,39,ki_chroma_acts
180,6,111.456,160.416,48.959999999999994,233,335,102,ki_chroma_acts
180,7,160.416,205.05599999999998,44.639999999999986,335,428,93,ki_chroma_acts
180,8,205.05599999999998,224.256,19.200000000000017,428,468,40,ki_chroma_acts
180,9,224.256,289.304,65.04799999999997,468,602,134,ki_chroma_acts
180,1,0.0,26.976,26.976,0,57,57,ki_chroma_acts_smoothed
180,2,26.976,30.816,3.84,57,65,8,ki_chroma_acts_smoothed
180,3,30.816,47.61599999999999,16.799999999999994,65,100,35,ki_chroma_acts_smoothed
180,4,47.61599999999999,93.216,45.6,100,195,95,ki_chroma_acts_smoothed
180,5,93.216,111.456,18.24000000000001,195,233,38,ki_chroma_acts_smoothed
180,6,111.456,160.416,48.959999999999994,233,335,102,ki_chroma_acts_smoothed
180,7,160.416,204.576,44.16,335,427,92,ki_chroma_acts_smoothed
180,8,204.576,223.296,18.72,427,466,39,ki_chroma_acts_smoothed
180,9,223.296,289.304,66.00799999999998,466,602,136,ki_chroma_acts_smoothed
182,1,0.0,44.59733333333334,44.59733333333334,0,111,111,chromagram
182,2,44.59733333333334,72.97066666666667,28.373333333333335,111,181,70,chromagram
182,3,72.97066666666667,82.69866666666667,9.727999999999994,181,205,24,chromagram
182,4,82.69866666666667,114.72000000000001,32.021333333333345,205,284,79,chromagram
182,5,114.72000000000001,134.17600000000002,19.456000000000003,284,332,48,chromagram
182,6,134.17600000000002,162.14400000000003,27.968000000000018,332,401,69,chromagram
182,7,162.14400000000003,172.27733333333336,10.133333333333326,401,426,25,chromagram
182,8,172.27733333333336,196.59733333333338,24.32000000000002,426,486,60,chromagram
182,9,196.59733333333338,213.808,17.21066666666661,486,527,41,chromagram
182,1,0.0,28.789333333333335,28.789333333333335,0,72,72,chroma_acts
182,2,28.789333333333335,46.21866666666667,17.429333333333336,72,115,43,chroma_acts
182,3,46.21866666666667,72.97066666666667,26.752000000000002,115,181,66,chroma_acts
182,4,72.97066666666667,82.69866666666667,9.727999999999994,181,205,24,chroma_acts
182,5,82.69866666666667,134.17600000000002,51.47733333333335,205,332,127,chroma_acts
182,6,134.17600000000002,162.14400000000003,27.968000000000018,332,401,69,chroma_acts
182,7,162.14400000000003,172.27733333333336,10.133333333333326,401,426,25,chroma_acts
182,8,172.27733333333336,196.59733333333338,24.32000000000002,426,486,60,chroma_acts
182,9,196.59733333333338,213.808,17.21066666666661,486,527,41,chroma_acts
182,1,0.0,44.59733333333334,44.59733333333334,0,111,111,chroma_acts_smoothed
182,2,44.59733333333334,72.97066666666667,28.373333333333335,111,181,70,chroma_acts_smoothed
182,3,72.97066666666667,82.69866666666667,9.727999999999994,181,205,24,chroma_acts_smoothed
182,4,82.69866666666667,105.80266666666668,23.104000000000013,205,262,57,chroma_acts_smoothed
182,5,105.80266666666668,134.17600000000002,28.373333333333335,262,332,70,chroma_acts_smoothed
182,6,134.17600000000002,162.14400000000003,27.968000000000018,332,401,69,chroma_acts_smoothed
182,7,162.14400000000003,172.27733333333336,10.133333333333326,401,426,25,chroma_acts_smoothed
182,8,172.27733333333336,197.0026666666667,24.72533333333334,426,487,61,chroma_acts_smoothed
182,9,197.0026666666667,213.808,16.805333333333294,487,527,40,chroma_acts_smoothed
182,1,0.0,44.59733333333334,44.59733333333334,0,111,111,ki_chroma
182,2,44.59733333333334,72.97066666666667,28.373333333333335,111,181,70,ki_chroma
182,3,72.97066666666667,82.69866666666667,9.727999999999994,181,205,24,ki_chroma
182,4,82.69866666666667,114.72000000000001,32.021333333333345,205,284,79,ki_chroma
182,5,114.72000000000001,134.17600000000002,19.456000000000003,284,332,48,ki_chroma
182,6,134.17600000000002,162.14400000000003,27.968000000000018,332,401,69,ki_chroma
182,7,162.14400000000003,172.27733333333336,10.133333333333326,401,426,25,ki_chroma
182,8,172.27733333333336,196.59733333333338,24.32000000000002,426,486,60,ki_chroma
182,9,196.59733333333338,213.808,17.21066666666661,486,527,41,ki_chroma
182,1,0.0,28.789333333333335,28.789333333333335,0,72,72,ki_chroma_acts
182,2,28.789333333333335,46.21866666666667,17.429333333333336,72,115,43,ki_chroma_acts
182,3,46.21866666666667,72.97066666666667,26.752000000000002,115,181,66,ki_chroma_acts
182,4,72.97066666666667,82.69866666666667,9.727999999999994,181,205,24,ki_chroma_acts
182,5,82.69866666666667,134.17600000000002,51.47733333333335,205,332,127,ki_chroma_acts
182,6,134.17600000000002,162.14400000000003,27.968000000000018,332,401,69,ki_chroma_acts
182,7,162.14400000000003,172.27733333333336,10.133333333333326,401,426,25,ki_chroma_acts
182,8,172.27733333333336,196.59733333333338,24.32000000000002,426,486,60,ki_chroma_acts
182,9,196.59733333333338,213.808,17.21066666666661,486,527,41,ki_chroma_acts
182,1,0.0,44.59733333333334,44.59733333333334,0,111,111,ki_chroma_acts_smoothed
182,2,44.59733333333334,72.97066666666667,28.373333333333335,111,181,70,ki_chroma_acts_smoothed
182,3,72.97066666666667,82.69866666666667,9.727999999999994,181,205,24,ki_chroma_acts_smoothed
182,4,82.69866666666667,105.80266666666668,23.104000000000013,205,262,57,ki_chroma_acts_smoothed
182,5,105.80266666666668,134.17600000000002,28.373333333333335,262,332,70,ki_chroma_acts_smoothed
182,6,134.17600000000002,162.14400000000003,27.968000000000018,332,401,69,ki_chroma_acts_smoothed
182,7,162.14400000000003,172.27733333333336,10.133333333333326,401,426,25,ki_chroma_acts_smoothed
182,8,172.27733333333336,197.0026666666667,24.72533333333334,426,487,61,ki_chroma_acts_smoothed
182,9,197.0026666666667,213.808,16.805333333333294,487,527,40,ki_chroma_acts_smoothed
183,1,0.0,13.376000000000001,13.376000000000001,0,33,33,chromagram
183,2,13.376000000000001,32.928,19.551999999999996,33,80,47,chromagram
183,3,32.928,39.584,6.656000000000006,80,96,16,chromagram
183,4,39.584,64.128,24.543999999999997,96,155,59,chromagram
183,5,64.128,72.44800000000001,8.320000000000007,155,175,20,chromagram
183,6,72.44800000000001,79.10400000000001,6.656000000000006,175,191,16,chromagram
183,7,79.10400000000001,93.24800000000002,14.144000000000005,191,225,34,chromagram
183,8,93.24800000000002,102.81600000000002,9.567999999999998,225,248,23,chromagram
183,9,102.81600000000002,111.781,8.96499999999999,248,268,20,chromagram
183,1,0.0,12.96,12.96,0,32,32,chroma_acts
183,2,12.96,32.928,19.967999999999996,32,80,48,chroma_acts
183,3,32.928,38.336,5.408000000000001,80,93,13,chroma_acts
183,4,38.336,64.128,25.792,93,155,62,chroma_acts
183,5,64.128,72.44800000000001,8.320000000000007,155,175,20,chroma_acts
183,6,72.44800000000001,88.67200000000001,16.224000000000004,175,214,39,chroma_acts
183,7,88.67200000000001,92.00000000000001,3.328000000000003,214,222,8,chroma_acts
183,8,92.00000000000001,102.81600000000002,10.816000000000003,222,248,26,chroma_acts
183,9,102.81600000000002,111.781,8.96499999999999,248,268,20,chroma_acts
183,1,0.0,12.96,12.96,0,32,32,chroma_acts_smoothed
183,2,12.96,32.928,19.967999999999996,32,80,48,chroma_acts_smoothed
183,3,32.928,39.168,6.240000000000002,80,95,15,chroma_acts_smoothed
183,4,39.168,64.128,24.96,95,155,60,chroma_acts_smoothed
183,5,64.128,72.44800000000001,8.320000000000007,155,175,20,chroma_acts_smoothed
183,6,72.44800000000001,88.67200000000001,16.224000000000004,175,214,39,chroma_acts_smoothed
183,7,88.67200000000001,92.00000000000001,3.328000000000003,214,222,8,chroma_acts_smoothed
183,8,92.00000000000001,102.81600000000002,10.816000000000003,222,248,26,chroma_acts_smoothed
183,9,102.81600000000002,111.781,8.96499999999999,248,268,20,chroma_acts_smoothed
183,1,0.0,13.376000000000001,13.376000000000001,0,33,33,ki_chroma
183,2,13.376000000000001,32.928,19.551999999999996,33,80,47,ki_chroma
183,3,32.928,39.584,6.656000000000006,80,96,16,ki_chroma
183,4,39.584,64.128,24.543999999999997,96,155,59,ki_chroma
183,5,64.128,72.44800000000001,8.320000000000007,155,175,20,ki_chroma
183,6,72.44800000000001,79.10400000000001,6.656000000000006,175,191,16,ki_chroma
183,7,79.10400000000001,93.24800000000002,14.144000000000005,191,225,34,ki_chroma
183,8,93.24800000000002,102.81600000000002,9.567999999999998,225,248,23,ki_chroma
183,9,102.81600000000002,111.781,8.96499999999999,248,268,20,ki_chroma
183,1,0.0,12.96,12.96,0,32,32,ki_chroma_acts
183,2,12.96,32.928,19.967999999999996,32,80,48,ki_chroma_acts
183,3,32.928,38.336,5.408000000000001,80,93,13,ki_chroma_acts
183,4,38.336,64.128,25.792,93,155,62,ki_chroma_acts
183,5,64.128,72.44800000000001,8.320000000000007,155,175,20,ki_chroma_acts
183,6,72.44800000000001,88.67200000000001,16.224000000000004,175,214,39,ki_chroma_acts
183,7,88.67200000000001,92.00000000000001,3.328000000000003,214,222,8,ki_chroma_acts
183,8,92.00000000000001,102.81600000000002,10.816000000000003,222,248,26,ki_chroma_acts
183,9,102.81600000000002,111.781,8.96499999999999,248,268,20,ki_chroma_acts
183,1,0.0,12.96,12.96,0,32,32,ki_chroma_acts_smoothed
183,2,12.96,32.928,19.967999999999996,32,80,48,ki_chroma_acts_smoothed
183,3,32.928,39.168,6.240000000000002,80,95,15,ki_chroma_acts_smoothed
183,4,39.168,64.128,24.96,95,155,60,ki_chroma_acts_smoothed
183,5,64.128,72.44800000000001,8.320000000000007,155,175,20,ki_chroma_acts_smoothed
183,6,72.44800000000001,88.67200000000001,16.224000000000004,175,214,39,ki_chroma_acts_smoothed
183,7,88.67200000000001,92.00000000000001,3.328000000000003,214,222,8,ki_chroma_acts_smoothed
183,8,92.00000000000001,102.81600000000002,10.816000000000003,222,248,26,ki_chroma_acts_smoothed
183,9,102.81600000000002,111.781,8.96499999999999,248,268,20,ki_chroma_acts_smoothed
185,1,0.0,5.482666666666667,5.482666666666667,0,12,12,chromagram
185,2,5.482666666666667,42.922666666666665,37.44,12,90,78,chromagram
185,3,42.922666666666665,46.76266666666667,3.8400000000000034,90,98,8,chromagram
185,4,46.76266666666667,58.282666666666664,11.519999999999996,98,122,24,chromagram
185,5,58.282666666666664,62.602666666666664,4.32,122,131,9,chromagram
185,6,62.602666666666664,149.00266666666664,86.39999999999998,131,311,180,chromagram
185,7,149.00266666666664,153.80266666666665,4.800000000000011,311,321,10,chromagram
185,8,153.80266666666665,221.96266666666665,68.16,321,463,142,chromagram
185,9,221.96266666666665,230.387,8.424333333333351,463,479,16,chromagram
185,1,0.0,33.32266666666666,33.32266666666666,0,70,70,chroma_acts
185,2,33.32266666666666,42.922666666666665,9.600000000000001,70,90,20,chroma_acts
185,3,42.922666666666665,46.76266666666667,3.8400000000000034,90,98,8,chroma_acts
185,4,46.76266666666667,75.08266666666667,28.32,98,157,59,chroma_acts
185,5,75.08266666666667,77.00266666666667,1.9200000000000017,157,161,4,chroma_acts
185,6,77.00266666666667,134.60266666666664,57.599999999999966,161,281,120,chroma_acts
185,7,134.60266666666664,184.04266666666663,49.44,281,384,103,chroma_acts
185,8,184.04266666666663,221.96266666666665,37.920000000000016,384,463,79,chroma_acts
185,9,221.96266666666665,230.387,8.424333333333351,463,479,16,chroma_acts
185,1,0.0,33.32266666666666,33.32266666666666,0,70,70,chroma_acts_smoothed
185,2,33.32266666666666,42.922666666666665,9.600000000000001,70,90,20,chroma_acts_smoothed
185,3,42.922666666666665,46.282666666666664,3.3599999999999994,90,97,7,chroma_acts_smoothed
185,4,46.282666666666664,75.08266666666667,28.800000000000004,97,157,60,chroma_acts_smoothed
185,5,75.08266666666667,134.60266666666664,59.51999999999997,157,281,124,chroma_acts_smoothed
185,6,134.60266666666664,138.44266666666664,3.8400000000000034,281,289,8,chroma_acts_smoothed
185,7,138.44266666666664,184.04266666666663,45.599999999999994,289,384,95,chroma_acts_smoothed
185,8,184.04266666666663,221.96266666666665,37.920000000000016,384,463,79,chroma_acts_smoothed
185,9,221.96266666666665,230.387,8.424333333333351,463,479,16,chroma_acts_smoothed
185,1,0.0,5.482666666666667,5.482666666666667,0,12,12,ki_chroma
185,2,5.482666666666667,42.922666666666665,37.44,12,90,78,ki_chroma
185,3,42.922666666666665,46.76266666666667,3.8400000000000034,90,98,8,ki_chroma
185,4,46.76266666666667,58.282666666666664,11.519999999999996,98,122,24,ki_chroma
185,5,58.282666666666664,62.602666666666664,4.32,122,131,9,ki_chroma
185,6,62.602666666666664,149.00266666666664,86.39999999999998,131,311,180,ki_chroma
185,7,149.00266666666664,153.80266666666665,4.800000000000011,311,321,10,ki_chroma
185,8,153.80266666666665,221.96266666666665,68.16,321,463,142,ki_chroma
185,9,221.96266666666665,230.387,8.424333333333351,463,479,16,ki_chroma
185,1,0.0,33.32266666666666,33.32266666666666,0,70,70,ki_chroma_acts
185,2,33.32266666666666,42.922666666666665,9.600000000000001,70,90,20,ki_chroma_acts
185,3,42.922666666666665,46.76266666666667,3.8400000000000034,90,98,8,ki_chroma_acts
185,4,46.76266666666667,75.08266666666667,28.32,98,157,59,ki_chroma_acts
185,5,75.08266666666667,77.00266666666667,1.9200000000000017,157,161,4,ki_chroma_acts
185,6,77.00266666666667,134.60266666666664,57.599999999999966,161,281,120,ki_chroma_acts
185,7,134.60266666666664,184.04266666666663,49.44,281,384,103,ki_chroma_acts
185,8,184.04266666666663,221.96266666666665,37.920000000000016,384,463,79,ki_chroma_acts
185,9,221.96266666666665,230.387,8.424333333333351,463,479,16,ki_chroma_acts
185,1,0.0,33.32266666666666,33.32266666666666,0,70,70,ki_chroma_acts_smoothed
185,2,33.32266666666666,42.922666666666665,9.600000000000001,70,90,20,ki_chroma_acts_smoothed
185,3,42.922666666666665,46.282666666666664,3.3599999999999994,90,97,7,ki_chroma_acts_smoothed
185,4,46.282666666666664,75.08266666666667,28.800000000000004,97,157,60,ki_chroma_acts_smoothed
185,5,75.08266666666667,134.60266666666664,59.51999999999997,157,281,124,ki_chroma_acts_smoothed
185,6,134.60266666666664,138.44266666666664,3.8400000000000034,281,289,8,ki_chroma_acts_smoothed
185,7,138.44266666666664,184.04266666666663,45.599999999999994,289,384,95,ki_chroma_acts_smoothed
185,8,184.04266666666663,221.96266666666665,37.920000000000016,384,463,79,ki_chroma_acts_smoothed
185,9,221.96266666666665,230.387,8.424333333333351,463,479,16,ki_chroma_acts_smoothed
186,1,0.0,14.250666666666667,14.250666666666667,0,31,31,chromagram
186,2,14.250666666666667,46.165333333333336,31.91466666666667,31,99,68,chromagram
186,3,46.165333333333336,89.81333333333333,43.647999999999996,99,192,93,chromagram
186,4,89.81333333333333,104.832,15.018666666666661,192,224,32,chromagram
186,5,104.832,109.99466666666666,5.1626666666666665,224,235,11,chromagram
186,6,109.99466666666666,117.03466666666667,7.040000000000006,235,250,15,chromagram
186,7,117.03466666666667,136.27733333333333,19.242666666666665,250,291,41,chromagram
186,8,136.27733333333333,164.90666666666667,28.629333333333335,291,352,61,chromagram
186,9,164.90666666666667,195.926,31.01933333333332,352,417,65,chromagram
186,1,0.0,15.189333333333334,15.189333333333334,0,33,33,chroma_acts
186,2,15.189333333333334,46.165333333333336,30.976000000000003,33,99,66,chroma_acts
186,3,46.165333333333336,88.87466666666666,42.70933333333332,99,190,91,chroma_acts
186,4,88.87466666666666,104.832,15.957333333333338,190,224,34,chroma_acts
186,5,104.832,109.99466666666666,5.1626666666666665,224,235,11,chroma_acts
186,6,109.99466666666666,117.03466666666667,7.040000000000006,235,250,15,chroma_acts
186,7,117.03466666666667,138.624,21.58933333333333,250,296,46,chroma_acts
186,8,138.624,160.68266666666668,22.05866666666668,296,343,47,chroma_acts
186,9,160.68266666666668,195.926,35.24333333333331,343,417,74,chroma_acts
186,1,0.0,15.189333333333334,15.189333333333334,0,33,33,chroma_acts_smoothed
186,2,15.189333333333334,44.757333333333335,29.568,33,96,63,chroma_acts_smoothed
186,3,44.757333333333335,88.87466666666666,44.11733333333332,96,190,94,chroma_acts_smoothed
186,4,88.87466666666666,104.832,15.957333333333338,190,224,34,chroma_acts_smoothed
186,5,104.832,109.52533333333332,4.693333333333328,224,234,10,chroma_acts_smoothed
186,6,109.52533333333332,117.03466666666667,7.509333333333345,234,250,16,chroma_acts_smoothed
186,7,117.03466666666667,138.624,21.58933333333333,250,296,46,chroma_acts_smoothed
186,8,138.624,165.376,26.75200000000001,296,353,57,chroma_acts_smoothed
186,9,165.376,195.926,30.549999999999983,353,417,64,chroma_acts_smoothed
186,1,0.0,14.250666666666667,14.250666666666667,0,31,31,ki_chroma
186,2,14.250666666666667,46.165333333333336,31.91466666666667,31,99,68,ki_chroma
186,3,46.165333333333336,89.81333333333333,43.647999999999996,99,192,93,ki_chroma
186,4,89.81333333333333,104.832,15.018666666666661,192,224,32,ki_chroma
186,5,104.832,109.99466666666666,5.1626666666666665,224,235,11,ki_chroma
186,6,109.99466666666666,117.03466666666667,7.040000000000006,235,250,15,ki_chroma
186,7,117.03466666666667,136.27733333333333,19.242666666666665,250,291,41,ki_chroma
186,8,136.27733333333333,164.90666666666667,28.629333333333335,291,352,61,ki_chroma
186,9,164.90666666666667,195.926,31.01933333333332,352,417,65,ki_chroma
186,1,0.0,15.189333333333334,15.189333333333334,0,33,33,ki_chroma_acts
186,2,15.189333333333334,46.165333333333336,30.976000000000003,33,99,66,ki_chroma_acts
186,3,46.165333333333336,88.87466666666666,42.70933333333332,99,190,91,ki_chroma_acts
186,4,88.87466666666666,104.832,15.957333333333338,190,224,34,ki_chroma_acts
186,5,104.832,109.99466666666666,5.1626666666666665,224,235,11,ki_chroma_acts
186,6,109.99466666666666,117.03466666666667,7.040000000000006,235,250,15,ki_chroma_acts
186,7,117.03466666666667,138.624,21.58933333333333,250,296,46,ki_chroma_acts
186,8,138.624,160.68266666666668,22.05866666666668,296,343,47,ki_chroma_acts
186,9,160.68266666666668,195.926,35.24333333333331,343,417,74,ki_chroma_acts
186,1,0.0,15.189333333333334,15.189333333333334,0,33,33,ki_chroma_acts_smoothed
186,2,15.189333333333334,44.757333333333335,29.568,33,96,63,ki_chroma_acts_smoothed
186,3,44.757333333333335,88.87466666666666,44.11733333333332,96,190,94,ki_chroma_acts_smoothed
186,4,88.87466666666666,104.832,15.957333333333338,190,224,34,ki_chroma_acts_smoothed
186,5,104.832,109.52533333333332,4.693333333333328,224,234,10,ki_chroma_acts_smoothed
186,6,109.52533333333332,117.03466666666667,7.509333333333345,234,250,16,ki_chroma_acts_smoothed
186,7,117.03466666666667,138.624,21.58933333333333,250,296,46,ki_chroma_acts_smoothed
186,8,138.624,165.376,26.75200000000001,296,353,57,ki_chroma_acts_smoothed
186,9,165.376,195.926,30.549999999999983,353,417,64,ki_chroma_acts_smoothed
195,1,0.0,67.648,67.648,0,145,145,chromagram
195,2,67.648,105.19466666666666,37.54666666666667,145,225,80,chromagram
195,3,105.19466666666666,111.76533333333333,6.570666666666668,225,239,14,chromagram
195,4,111.76533333333333,138.98666666666665,27.22133333333332,239,297,58,chromagram
195,5,138.98666666666665,142.272,3.285333333333341,297,304,7,chromagram
195,6,142.272,157.76,15.488,304,337,33,chromagram
195,7,157.76,187.328,29.568000000000012,337,400,63,chromagram
195,8,187.328,218.145,30.817000000000007,400,464,64,chromagram
195,1,0.0,67.648,67.648,0,145,145,chroma_acts
195,2,67.648,105.19466666666666,37.54666666666667,145,225,80,chroma_acts
195,3,105.19466666666666,112.23466666666667,7.040000000000006,225,240,15,chroma_acts
195,4,112.23466666666667,138.98666666666665,26.75199999999998,240,297,57,chroma_acts
195,5,138.98666666666665,142.272,3.285333333333341,297,304,7,chroma_acts
195,6,142.272,157.29066666666665,15.018666666666661,304,336,32,chroma_acts
195,7,157.29066666666665,187.328,30.03733333333335,336,400,64,chroma_acts
195,8,187.328,218.145,30.817000000000007,400,464,64,chroma_acts
195,1,0.0,67.648,67.648,0,145,145,chroma_acts_smoothed
195,2,67.648,104.72533333333332,37.07733333333333,145,224,79,chroma_acts_smoothed
195,3,104.72533333333332,112.23466666666667,7.509333333333345,224,240,16,chroma_acts_smoothed
195,4,112.23466666666667,138.98666666666665,26.75199999999998,240,297,57,chroma_acts_smoothed
195,5,138.98666666666665,142.272,3.285333333333341,297,304,7,chroma_acts_smoothed
195,6,142.272,157.29066666666665,15.018666666666661,304,336,32,chroma_acts_smoothed
195,7,157.29066666666665,187.328,30.03733333333335,336,400,64,chroma_acts_smoothed
195,8,187.328,218.145,30.817000000000007,400,464,64,chroma_acts_smoothed
195,1,0.0,67.648,67.648,0,145,145,ki_chroma
195,2,67.648,105.19466666666666,37.54666666666667,145,225,80,ki_chroma
195,3,105.19466666666666,111.76533333333333,6.570666666666668,225,239,14,ki_chroma
195,4,111.76533333333333,138.98666666666665,27.22133333333332,239,297,58,ki_chroma
195,5,138.98666666666665,142.272,3.285333333333341,297,304,7,ki_chroma
195,6,142.272,157.76,15.488,304,337,33,ki_chroma
195,7,157.76,187.328,29.568000000000012,337,400,63,ki_chroma
195,8,187.328,218.145,30.817000000000007,400,464,64,ki_chroma
195,1,0.0,67.648,67.648,0,145,145,ki_chroma_acts
195,2,67.648,105.19466666666666,37.54666666666667,145,225,80,ki_chroma_acts
195,3,105.19466666666666,112.23466666666667,7.040000000000006,225,240,15,ki_chroma_acts
195,4,112.23466666666667,138.98666666666665,26.75199999999998,240,297,57,ki_chroma_acts
195,5,138.98666666666665,142.272,3.285333333333341,297,304,7,ki_chroma_acts
195,6,142.272,157.29066666666665,15.018666666666661,304,336,32,ki_chroma_acts
195,7,157.29066666666665,187.328,30.03733333333335,336,400,64,ki_chroma_acts
195,8,187.328,218.145,30.817000000000007,400,464,64,ki_chroma_acts
195,1,0.0,67.648,67.648,0,145,145,ki_chroma_acts_smoothed
195,2,67.648,104.72533333333332,37.07733333333333,145,224,79,ki_chroma_acts_smoothed
195,3,104.72533333333332,112.23466666666667,7.509333333333345,224,240,16,ki_chroma_acts_smoothed
195,4,112.23466666666667,138.98666666666665,26.75199999999998,240,297,57,ki_chroma_acts_smoothed
195,5,138.98666666666665,142.272,3.285333333333341,297,304,7,ki_chroma_acts_smoothed
195,6,142.272,157.29066666666665,15.018666666666661,304,336,32,ki_chroma_acts_smoothed
195,7,157.29066666666665,187.328,30.03733333333335,336,400,64,ki_chroma_acts_smoothed
195,8,187.328,218.145,30.817000000000007,400,464,64,ki_chroma_acts_smoothed
196,1,0.0,30.752,30.752,0,65,65,chromagram
196,2,30.752,47.071999999999996,16.319999999999997,65,99,34,chromagram
196,3,47.071999999999996,50.431999999999995,3.3599999999999994,99,106,7,chromagram
196,4,50.431999999999995,76.352,25.92000000000001,106,160,54,chromagram
196,5,76.352,96.992,20.64,160,203,43,chromagram
196,6,96.992,127.232,30.239999999999995,203,266,63,chromagram
196,7,127.232,143.07199999999997,15.839999999999975,266,299,33,chromagram
196,8,143.07199999999997,146.432,3.3600000000000136,299,306,7,chromagram
196,9,146.432,173.945,27.513000000000005,306,362,56,chromagram
196,1,0.0,30.752,30.752,0,65,65,chroma_acts
196,2,30.752,47.071999999999996,16.319999999999997,65,99,34,chroma_acts
196,3,47.071999999999996,50.912,3.8400000000000034,99,107,8,chroma_acts
196,4,50.912,76.352,25.440000000000005,107,160,53,chroma_acts
196,5,76.352,97.472,21.11999999999999,160,204,44,chroma_acts
196,6,97.472,127.232,29.760000000000005,204,266,62,chroma_acts
196,7,127.232,143.07199999999997,15.839999999999975,266,299,33,chroma_acts
196,8,143.07199999999997,146.432,3.3600000000000136,299,306,7,chroma_acts
196,9,146.432,173.945,27.513000000000005,306,362,56,chroma_acts
196,1,0.0,30.752,30.752,0,65,65,chroma_acts_smoothed
196,2,30.752,46.111999999999995,15.359999999999996,65,97,32,chroma_acts_smoothed
196,3,46.111999999999995,50.431999999999995,4.32,97,106,9,chroma_acts_smoothed
196,4,50.431999999999995,76.83200000000001,26.400000000000013,106,161,55,chroma_acts_smoothed
196,5,76.83200000000001,96.992,20.159999999999997,161,203,42,chroma_acts_smoothed
196,6,96.992,127.232,30.239999999999995,203,266,63,chroma_acts_smoothed
196,7,127.232,142.59199999999998,15.359999999999985,266,298,32,chroma_acts_smoothed
196,8,142.59199999999998,146.432,3.8400000000000034,298,306,8,chroma_acts_smoothed
196,9,146.432,173.945,27.513000000000005,306,362,56,chroma_acts_smoothed
196,1,0.0,30.752,30.752,0,65,65,ki_chroma
196,2,30.752,47.071999999999996,16.319999999999997,65,99,34,ki_chroma
196,3,47.071999999999996,50.431999999999995,3.3599999999999994,99,106,7,ki_chroma
196,4,50.431999999999995,76.352,25.92000000000001,106,160,54,ki_chroma
196,5,76.352,96.992,20.64,160,203,43,ki_chroma
196,6,96.992,127.232,30.239999999999995,203,266,63,ki_chroma
196,7,127.232,143.07199999999997,15.839999999999975,266,299,33,ki_chroma
196,8,143.07199999999997,146.432,3.3600000000000136,299,306,7,ki_chroma
196,9,146.432,173.945,27.513000000000005,306,362,56,ki_chroma
196,1,0.0,30.752,30.752,0,65,65,ki_chroma_acts
196,2,30.752,47.071999999999996,16.319999999999997,65,99,34,ki_chroma_acts
196,3,47.071999999999996,50.912,3.8400000000000034,99,107,8,ki_chroma_acts
196,4,50.912,76.352,25.440000000000005,107,160,53,ki_chroma_acts
196,5,76.352,97.472,21.11999999999999,160,204,44,ki_chroma_acts
196,6,97.472,127.232,29.760000000000005,204,266,62,ki_chroma_acts
196,7,127.232,143.07199999999997,15.839999999999975,266,299,33,ki_chroma_acts
196,8,143.07199999999997,146.432,3.3600000000000136,299,306,7,ki_chroma_acts
196,9,146.432,173.945,27.513000000000005,306,362,56,ki_chroma_acts
196,1,0.0,30.752,30.752,0,65,65,ki_chroma_acts_smoothed
196,2,30.752,46.111999999999995,15.359999999999996,65,97,32,ki_chroma_acts_smoothed
196,3,46.111999999999995,50.431999999999995,4.32,97,106,9,ki_chroma_acts_smoothed
196,4,50.431999999999995,76.83200000000001,26.400000000000013,106,161,55,ki_chroma_acts_smoothed
196,5,76.83200000000001,96.992,20.159999999999997,161,203,42,ki_chroma_acts_smoothed
196,6,96.992,127.232,30.239999999999995,203,266,63,ki_chroma_acts_smoothed
196,7,127.232,142.59199999999998,15.359999999999985,266,298,32,ki_chroma_acts_smoothed
196,8,142.59199999999998,146.432,3.8400000000000034,298,306,8,ki_chroma_acts_smoothed
196,9,146.432,173.945,27.513000000000005,306,362,56,ki_chroma_acts_smoothed
197,1,0.0,13.706666666666667,13.706666666666667,0,29,29,chromagram
197,2,13.706666666666667,48.266666666666666,34.56,29,101,72,chromagram
197,3,48.266666666666666,61.70666666666666,13.439999999999998,101,129,28,chromagram
197,4,61.70666666666666,77.06666666666666,15.36,129,161,32,chromagram
197,5,77.06666666666666,92.42666666666666,15.36,161,193,32,chromagram
197,6,92.42666666666666,115.46666666666665,23.039999999999992,193,241,48,chromagram
197,7,115.46666666666665,130.82666666666668,15.360000000000028,241,273,32,chromagram
197,8,130.82666666666668,144.26666666666668,13.439999999999998,273,301,28,chromagram
197,9,144.26666666666668,160.377,16.11033333333333,301,333,32,chromagram
197,1,0.0,13.706666666666667,13.706666666666667,0,29,29,chroma_acts
197,2,13.706666666666667,48.266666666666666,34.56,29,101,72,chroma_acts
197,3,48.266666666666666,61.70666666666666,13.439999999999998,101,129,28,chroma_acts
197,4,61.70666666666666,77.06666666666666,15.36,129,161,32,chroma_acts
197,5,77.06666666666666,92.42666666666666,15.36,161,193,32,chroma_acts
197,6,92.42666666666666,115.46666666666665,23.039999999999992,193,241,48,chroma_acts
197,7,115.46666666666665,130.82666666666668,15.360000000000028,241,273,32,chroma_acts
197,8,130.82666666666668,144.26666666666668,13.439999999999998,273,301,28,chroma_acts
197,9,144.26666666666668,160.377,16.11033333333333,301,333,32,chroma_acts
197,1,0.0,13.706666666666667,13.706666666666667,0,29,29,chroma_acts_smoothed
197,2,13.706666666666667,38.18666666666667,24.48,29,80,51,chroma_acts_smoothed
197,3,38.18666666666667,48.266666666666666,10.079999999999998,80,101,21,chroma_acts_smoothed
197,4,48.266666666666666,77.54666666666667,29.28,101,162,61,chroma_acts_smoothed
197,5,77.54666666666667,92.42666666666666,14.879999999999995,162,193,31,chroma_acts_smoothed
197,6,92.42666666666666,115.46666666666665,23.039999999999992,193,241,48,chroma_acts_smoothed
197,7,115.46666666666665,130.82666666666668,15.360000000000028,241,273,32,chroma_acts_smoothed
197,8,130.82666666666668,144.26666666666668,13.439999999999998,273,301,28,chroma_acts_smoothed
197,9,144.26666666666668,160.377,16.11033333333333,301,333,32,chroma_acts_smoothed
197,1,0.0,13.706666666666667,13.706666666666667,0,29,29,ki_chroma
197,2,13.706666666666667,48.266666666666666,34.56,29,101,72,ki_chroma
197,3,48.266666666666666,61.70666666666666,13.439999999999998,101,129,28,ki_chroma
197,4,61.70666666666666,77.06666666666666,15.36,129,161,32,ki_chroma
197,5,77.06666666666666,92.42666666666666,15.36,161,193,32,ki_chroma
197,6,92.42666666666666,115.46666666666665,23.039999999999992,193,241,48,ki_chroma
197,7,115.46666666666665,130.82666666666668,15.360000000000028,241,273,32,ki_chroma
197,8,130.82666666666668,144.26666666666668,13.439999999999998,273,301,28,ki_chroma
197,9,144.26666666666668,160.377,16.11033333333333,301,333,32,ki_chroma
197,1,0.0,13.706666666666667,13.706666666666667,0,29,29,ki_chroma_acts
197,2,13.706666666666667,48.266666666666666,34.56,29,101,72,ki_chroma_acts
197,3,48.266666666666666,61.70666666666666,13.439999999999998,101,129,28,ki_chroma_acts
197,4,61.70666666666666,77.06666666666666,15.36,129,161,32,ki_chroma_acts
197,5,77.06666666666666,92.42666666666666,15.36,161,193,32,ki_chroma_acts
197,6,92.42666666666666,115.46666666666665,23.039999999999992,193,241,48,ki_chroma_acts
197,7,115.46666666666665,130.82666666666668,15.360000000000028,241,273,32,ki_chroma_acts
197,8,130.82666666666668,144.26666666666668,13.439999999999998,273,301,28,ki_chroma_acts
197,9,144.26666666666668,160.377,16.11033333333333,301,333,32,ki_chroma_acts
197,1,0.0,13.706666666666667,13.706666666666667,0,29,29,ki_chroma_acts_smoothed
197,2,13.706666666666667,38.18666666666667,24.48,29,80,51,ki_chroma_acts_smoothed
197,3,38.18666666666667,48.266666666666666,10.079999999999998,80,101,21,ki_chroma_acts_smoothed
197,4,48.266666666666666,77.54666666666667,29.28,101,162,61,ki_chroma_acts_smoothed
197,5,77.54666666666667,92.42666666666666,14.879999999999995,162,193,31,ki_chroma_acts_smoothed
197,6,92.42666666666666,115.46666666666665,23.039999999999992,193,241,48,ki_chroma_acts_smoothed
197,7,115.46666666666665,130.82666666666668,15.360000000000028,241,273,32,ki_chroma_acts_smoothed
197,8,130.82666666666668,144.26666666666668,13.439999999999998,273,301,28,ki_chroma_acts_smoothed
197,9,144.26666666666668,160.377,16.11033333333333,301,333,32,ki_chroma_acts_smoothed
199,1,0.0,5.429333333333333,5.429333333333333,0,12,12,chromagram
199,2,5.429333333333333,27.509333333333334,22.080000000000002,12,58,46,chromagram
199,3,27.509333333333334,28.469333333333335,0.9600000000000009,58,60,2,chromagram
199,4,28.469333333333335,30.389333333333333,1.9199999999999982,60,64,4,chromagram
199,5,30.389333333333333,76.46933333333332,46.07999999999999,64,160,96,chromagram
199,6,76.46933333333332,91.82933333333332,15.36,160,192,32,chromagram
199,7,91.82933333333332,112.46933333333332,20.64,192,235,43,chromagram
199,8,112.46933333333332,115.82933333333332,3.3599999999999994,235,242,7,chromagram
199,9,115.82933333333332,143.664,27.834666666666664,242,298,56,chromagram
199,1,0.0,15.989333333333333,15.989333333333333,0,34,34,chroma_acts
199,2,15.989333333333333,27.509333333333334,11.520000000000001,34,58,24,chroma_acts
199,3,27.509333333333334,30.389333333333333,2.879999999999999,58,64,6,chroma_acts
199,4,30.389333333333333,76.46933333333332,46.07999999999999,64,160,96,chroma_acts
199,5,76.46933333333332,93.26933333333332,16.799999999999997,160,195,35,chroma_acts
199,6,93.26933333333332,112.46933333333332,19.200000000000003,195,235,40,chroma_acts
199,7,112.46933333333332,115.82933333333332,3.3599999999999994,235,242,7,chroma_acts
199,8,115.82933333333332,130.22933333333333,14.400000000000006,242,272,30,chroma_acts
199,9,130.22933333333333,143.664,13.434666666666658,272,298,26,chroma_acts
199,1,0.0,15.509333333333332,15.509333333333332,0,33,33,chroma_acts_smoothed
199,2,15.509333333333332,27.029333333333334,11.520000000000001,33,57,24,chroma_acts_smoothed
199,3,27.029333333333334,30.389333333333333,3.3599999999999994,57,64,7,chroma_acts_smoothed
199,4,30.389333333333333,76.46933333333332,46.07999999999999,64,160,96,chroma_acts_smoothed
199,5,76.46933333333332,92.78933333333333,16.320000000000007,160,194,34,chroma_acts_smoothed
199,6,92.78933333333333,112.46933333333332,19.679999999999993,194,235,41,chroma_acts_smoothed
199,7,112.46933333333332,115.82933333333332,3.3599999999999994,235,242,7,chroma_acts_smoothed
199,8,115.82933333333332,129.74933333333334,13.920000000000016,242,271,29,chroma_acts_smoothed
199,9,129.74933333333334,143.664,13.914666666666648,271,298,27,chroma_acts_smoothed
199,1,0.0,5.429333333333333,5.429333333333333,0,12,12,ki_chroma
199,2,5.429333333333333,27.509333333333334,22.080000000000002,12,58,46,ki_chroma
199,3,27.509333333333334,28.469333333333335,0.9600000000000009,58,60,2,ki_chroma
199,4,28.469333333333335,30.389333333333333,1.9199999999999982,60,64,4,ki_chroma
199,5,30.389333333333333,76.46933333333332,46.07999999999999,64,160,96,ki_chroma
199,6,76.46933333333332,91.82933333333332,15.36,160,192,32,ki_chroma
199,7,91.82933333333332,112.46933333333332,20.64,192,235,43,ki_chroma
199,8,112.46933333333332,115.82933333333332,3.3599999999999994,235,242,7,ki_chroma
199,9,115.82933333333332,143.664,27.834666666666664,242,298,56,ki_chroma
199,1,0.0,15.989333333333333,15.989333333333333,0,34,34,ki_chroma_acts
199,2,15.989333333333333,27.509333333333334,11.520000000000001,34,58,24,ki_chroma_acts
199,3,27.509333333333334,30.389333333333333,2.879999999999999,58,64,6,ki_chroma_acts
199,4,30.389333333333333,76.46933333333332,46.07999999999999,64,160,96,ki_chroma_acts
199,5,76.46933333333332,93.26933333333332,16.799999999999997,160,195,35,ki_chroma_acts
199,6,93.26933333333332,112.46933333333332,19.200000000000003,195,235,40,ki_chroma_acts
199,7,112.46933333333332,115.82933333333332,3.3599999999999994,235,242,7,ki_chroma_acts
199,8,115.82933333333332,130.22933333333333,14.400000000000006,242,272,30,ki_chroma_acts
199,9,130.22933333333333,143.664,13.434666666666658,272,298,26,ki_chroma_acts
199,1,0.0,15.509333333333332,15.509333333333332,0,33,33,ki_chroma_acts_smoothed
199,2,15.509333333333332,27.029333333333334,11.520000000000001,33,57,24,ki_chroma_acts_smoothed
199,3,27.029333333333334,30.389333333333333,3.3599999999999994,57,64,7,ki_chroma_acts_smoothed
199,4,30.389333333333333,76.46933333333332,46.07999999999999,64,160,96,ki_chroma_acts_smoothed
199,5,76.46933333333332,92.78933333333333,16.320000000000007,160,194,34,ki_chroma_acts_smoothed
199,6,92.78933333333333,112.46933333333332,19.679999999999993,194,235,41,ki_chroma_acts_smoothed
199,7,112.46933333333332,115.82933333333332,3.3599999999999994,235,242,7,ki_chroma_acts_smoothed
199,8,115.82933333333332,129.74933333333334,13.920000000000016,242,271,29,ki_chroma_acts_smoothed
199,9,129.74933333333334,143.664,13.914666666666648,271,298,27,ki_chroma_acts_smoothed
201,1,0.0,9.184000000000001,9.184000000000001,0,20,20,chromagram
201,2,9.184000000000001,15.424,6.239999999999998,20,33,13,chromagram
201,3,15.424,23.104,7.68,33,49,16,chromagram
201,4,23.104,69.184,46.08,49,145,96,chromagram
201,5,69.184,77.824,8.64,145,163,18,chromagram
201,6,77.824,104.22399999999999,26.39999999999999,163,218,55,chromagram
201,7,104.22399999999999,108.064,3.8400000000000034,218,226,8,chromagram
201,8,108.064,158.104,50.04000000000002,226,329,103,chromagram
201,1,0.0,9.184000000000001,9.184000000000001,0,20,20,chroma_acts
201,2,9.184000000000001,15.424,6.239999999999998,20,33,13,chroma_acts
201,3,15.424,23.104,7.68,33,49,16,chroma_acts
201,4,23.104,69.184,46.08,49,145,96,chroma_acts
201,5,69.184,77.824,8.64,145,163,18,chroma_acts
201,6,77.824,104.22399999999999,26.39999999999999,163,218,55,chroma_acts
201,7,104.22399999999999,108.064,3.8400000000000034,218,226,8,chroma_acts
201,8,108.064,158.104,50.04000000000002,226,329,103,chroma_acts
201,1,0.0,15.424,15.424,0,33,33,chroma_acts_smoothed
201,2,15.424,23.104,7.68,33,49,16,chroma_acts_smoothed
201,3,23.104,69.184,46.08,49,145,96,chroma_acts_smoothed
201,4,69.184,77.824,8.64,145,163,18,chroma_acts_smoothed
201,5,77.824,89.344,11.519999999999996,163,187,24,chroma_acts_smoothed
201,6,89.344,104.704,15.36,187,219,32,chroma_acts_smoothed
201,7,104.704,108.544,3.8400000000000034,219,227,8,chroma_acts_smoothed
201,8,108.544,158.104,49.56000000000002,227,329,102,chroma_acts_smoothed
201,1,0.0,9.184000000000001,9.184000000000001,0,20,20,ki_chroma
201,2,9.184000000000001,15.424,6.239999999999998,20,33,13,ki_chroma
201,3,15.424,23.104,7.68,33,49,16,ki_chroma
201,4,23.104,69.184,46.08,49,145,96,ki_chroma
201,5,69.184,77.824,8.64,145,163,18,ki_chroma
201,6,77.824,104.22399999999999,26.39999999999999,163,218,55,ki_chroma
201,7,104.22399999999999,108.064,3.8400000000000034,218,226,8,ki_chroma
201,8,108.064,158.104,50.04000000000002,226,329,103,ki_chroma
201,1,0.0,9.184000000000001,9.184000000000001,0,20,20,ki_chroma_acts
201,2,9.184000000000001,15.424,6.239999999999998,20,33,13,ki_chroma_acts
201,3,15.424,23.104,7.68,33,49,16,ki_chroma_acts
201,4,23.104,69.184,46.08,49,145,96,ki_chroma_acts
201,5,69.184,77.824,8.64,145,163,18,ki_chroma_acts
201,6,77.824,104.22399999999999,26.39999999999999,163,218,55,ki_chroma_acts
201,7,104.22399999999999,108.064,3.8400000000000034,218,226,8,ki_chroma_acts
201,8,108.064,158.104,50.04000000000002,226,329,103,ki_chroma_acts
201,1,0.0,15.424,15.424,0,33,33,ki_chroma_acts_smoothed
201,2,15.424,23.104,7.68,33,49,16,ki_chroma_acts_smoothed
201,3,23.104,69.184,46.08,49,145,96,ki_chroma_acts_smoothed
201,4,69.184,77.824,8.64,145,163,18,ki_chroma_acts_smoothed
201,5,77.824,89.344,11.519999999999996,163,187,24,ki_chroma_acts_smoothed
201,6,89.344,104.704,15.36,187,219,32,ki_chroma_acts_smoothed
201,7,104.704,108.544,3.8400000000000034,219,227,8,ki_chroma_acts_smoothed
201,8,108.544,158.104,49.56000000000002,227,329,102,ki_chroma_acts_smoothed
203,1,0.0,3.328,3.328,0,8,8,chromagram
203,2,3.328,18.816,15.488,8,41,33,chromagram
203,3,18.816,47.44533333333333,28.62933333333333,41,102,61,chromagram
203,4,47.44533333333333,48.85333333333333,1.4080000000000013,102,105,3,chromagram
203,5,48.85333333333333,62.464,13.610666666666667,105,134,29,chromagram
203,6,62.464,92.50133333333333,30.037333333333336,134,198,64,chromagram
203,7,92.50133333333333,94.37866666666666,1.8773333333333255,198,202,4,chromagram
203,8,94.37866666666666,163.048,68.66933333333334,202,347,145,chromagram
203,1,0.0,3.328,3.328,0,8,8,chroma_acts
203,2,3.328,18.816,15.488,8,41,33,chroma_acts
203,3,18.816,47.44533333333333,28.62933333333333,41,102,61,chroma_acts
203,4,47.44533333333333,48.85333333333333,1.4080000000000013,102,105,3,chroma_acts
203,5,48.85333333333333,62.464,13.610666666666667,105,134,29,chroma_acts
203,6,62.464,92.50133333333333,30.037333333333336,134,198,64,chroma_acts
203,7,92.50133333333333,94.37866666666666,1.8773333333333255,198,202,4,chroma_acts
203,8,94.37866666666666,163.048,68.66933333333334,202,347,145,chroma_acts
203,1,0.0,3.7973333333333334,3.7973333333333334,0,9,9,chroma_acts_smoothed
203,2,3.7973333333333334,18.816,15.018666666666665,9,41,32,chroma_acts_smoothed
203,3,18.816,47.44533333333333,28.62933333333333,41,102,61,chroma_acts_smoothed
203,4,47.44533333333333,49.32266666666666,1.8773333333333326,102,106,4,chroma_acts_smoothed
203,5,49.32266666666666,62.464,13.141333333333336,106,134,28,chroma_acts_smoothed
203,6,62.464,92.50133333333333,30.037333333333336,134,198,64,chroma_acts_smoothed
203,7,92.50133333333333,94.848,2.346666666666664,198,203,5,chroma_acts_smoothed
203,8,94.848,163.048,68.2,203,347,144,chroma_acts_smoothed
203,1,0.0,3.328,3.328,0,8,8,ki_chroma
203,2,3.328,18.816,15.488,8,41,33,ki_chroma
203,3,18.816,47.44533333333333,28.62933333333333,41,102,61,ki_chroma
203,4,47.44533333333333,48.85333333333333,1.4080000000000013,102,105,3,ki_chroma
203,5,48.85333333333333,62.464,13.610666666666667,105,134,29,ki_chroma
203,6,62.464,92.50133333333333,30.037333333333336,134,198,64,ki_chroma
203,7,92.50133333333333,94.37866666666666,1.8773333333333255,198,202,4,ki_chroma
203,8,94.37866666666666,163.048,68.66933333333334,202,347,145,ki_chroma
203,1,0.0,3.328,3.328,0,8,8,ki_chroma_acts
203,2,3.328,18.816,15.488,8,41,33,ki_chroma_acts
203,3,18.816,47.44533333333333,28.62933333333333,41,102,61,ki_chroma_acts
203,4,47.44533333333333,48.85333333333333,1.4080000000000013,102,105,3,ki_chroma_acts
203,5,48.85333333333333,62.464,13.610666666666667,105,134,29,ki_chroma_acts
203,6,62.464,92.50133333333333,30.037333333333336,134,198,64,ki_chroma_acts
203,7,92.50133333333333,94.37866666666666,1.8773333333333255,198,202,4,ki_chroma_acts
203,8,94.37866666666666,163.048,68.66933333333334,202,347,145,ki_chroma_acts
203,1,0.0,3.7973333333333334,3.7973333333333334,0,9,9,ki_chroma_acts_smoothed
203,2,3.7973333333333334,18.816,15.018666666666665,9,41,32,ki_chroma_acts_smoothed
203,3,18.816,47.44533333333333,28.62933333333333,41,102,61,ki_chroma_acts_smoothed
203,4,47.44533333333333,49.32266666666666,1.8773333333333326,102,106,4,ki_chroma_acts_smoothed
203,5,49.32266666666666,62.464,13.141333333333336,106,134,28,ki_chroma_acts_smoothed
203,6,62.464,92.50133333333333,30.037333333333336,134,198,64,ki_chroma_acts_smoothed
203,7,92.50133333333333,94.848,2.346666666666664,198,203,5,ki_chroma_acts_smoothed
203,8,94.848,163.048,68.2,203,347,144,ki_chroma_acts_smoothed
206,1,0.0,40.522666666666666,40.522666666666666,0,85,85,chromagram
206,2,40.522666666666666,62.12266666666666,21.599999999999994,85,130,45,chromagram
206,3,62.12266666666666,92.36266666666667,30.24000000000001,130,193,63,chromagram
206,4,92.36266666666667,118.28266666666667,25.92,193,247,54,chromagram
206,5,118.28266666666667,132.20266666666666,13.919999999999987,247,276,29,chromagram
206,6,132.20266666666666,139.40266666666665,7.199999999999989,276,291,15,chromagram
206,7,139.40266666666665,142.76266666666666,3.3600000000000136,291,298,7,chromagram
206,8,142.76266666666666,173.00266666666664,30.23999999999998,298,361,63,chromagram
206,9,173.00266666666664,185.891,12.88833333333335,361,386,25,chromagram
206,1,0.0,6.442666666666667,6.442666666666667,0,14,14,chroma_acts
206,2,6.442666666666667,39.562666666666665,33.12,14,83,69,chroma_acts
206,3,39.562666666666665,48.68266666666666,9.119999999999997,83,102,19,chroma_acts
206,4,48.68266666666666,62.12266666666666,13.439999999999998,102,130,28,chroma_acts
206,5,62.12266666666666,92.36266666666667,30.24000000000001,130,193,63,chroma_acts
206,6,92.36266666666667,118.76266666666668,26.400000000000006,193,248,55,chroma_acts
206,7,118.76266666666668,142.76266666666666,23.999999999999986,248,298,50,chroma_acts
206,8,142.76266666666666,172.52266666666665,29.75999999999999,298,360,62,chroma_acts
206,9,172.52266666666665,185.891,13.36833333333334,360,386,26,chroma_acts
206,1,0.0,5.482666666666666,5.482666666666666,0,12,12,chroma_acts_smoothed
206,2,5.482666666666666,40.04266666666666,34.559999999999995,12,84,72,chroma_acts_smoothed
206,3,40.04266666666666,48.68266666666666,8.64,84,102,18,chroma_acts_smoothed
206,4,48.68266666666666,62.12266666666666,13.439999999999998,102,130,28,chroma_acts_smoothed
206,5,62.12266666666666,91.88266666666667,29.760000000000005,130,192,62,chroma_acts_smoothed
206,6,91.88266666666667,118.76266666666668,26.88000000000001,192,248,56,chroma_acts_smoothed
206,7,118.76266666666668,142.76266666666666,23.999999999999986,248,298,50,chroma_acts_smoothed
206,8,142.76266666666666,172.52266666666665,29.75999999999999,298,360,62,chroma_acts_smoothed
206,9,172.52266666666665,185.891,13.36833333333334,360,386,26,chroma_acts_smoothed
206,1,0.0,40.522666666666666,40.522666666666666,0,85,85,ki_chroma
206,2,40.522666666666666,62.12266666666666,21.599999999999994,85,130,45,ki_chroma
206,3,62.12266666666666,92.36266666666667,30.24000000000001,130,193,63,ki_chroma
206,4,92.36266666666667,118.28266666666667,25.92,193,247,54,ki_chroma
206,5,118.28266666666667,132.20266666666666,13.919999999999987,247,276,29,ki_chroma
206,6,132.20266666666666,139.40266666666665,7.199999999999989,276,291,15,ki_chroma
206,7,139.40266666666665,142.76266666666666,3.3600000000000136,291,298,7,ki_chroma
206,8,142.76266666666666,173.00266666666664,30.23999999999998,298,361,63,ki_chroma
206,9,173.00266666666664,185.891,12.88833333333335,361,386,25,ki_chroma
206,1,0.0,6.442666666666667,6.442666666666667,0,14,14,ki_chroma_acts
206,2,6.442666666666667,39.562666666666665,33.12,14,83,69,ki_chroma_acts
206,3,39.562666666666665,48.68266666666666,9.119999999999997,83,102,19,ki_chroma_acts
206,4,48.68266666666666,62.12266666666666,13.439999999999998,102,130,28,ki_chroma_acts
206,5,62.12266666666666,92.36266666666667,30.24000000000001,130,193,63,ki_chroma_acts
206,6,92.36266666666667,118.76266666666668,26.400000000000006,193,248,55,ki_chroma_acts
206,7,118.76266666666668,142.76266666666666,23.999999999999986,248,298,50,ki_chroma_acts
206,8,142.76266666666666,172.52266666666665,29.75999999999999,298,360,62,ki_chroma_acts
206,9,172.52266666666665,185.891,13.36833333333334,360,386,26,ki_chroma_acts
206,1,0.0,5.482666666666666,5.482666666666666,0,12,12,ki_chroma_acts_smoothed
206,2,5.482666666666666,40.04266666666666,34.559999999999995,12,84,72,ki_chroma_acts_smoothed
206,3,40.04266666666666,48.68266666666666,8.64,84,102,18,ki_chroma_acts_smoothed
206,4,48.68266666666666,62.12266666666666,13.439999999999998,102,130,28,ki_chroma_acts_smoothed
206,5,62.12266666666666,91.88266666666667,29.760000000000005,130,192,62,ki_chroma_acts_smoothed
206,6,91.88266666666667,118.76266666666668,26.88000000000001,192,248,56,ki_chroma_acts_smoothed
206,7,118.76266666666668,142.76266666666666,23.999999999999986,248,298,50,ki_chroma_acts_smoothed
206,8,142.76266666666666,172.52266666666665,29.75999999999999,298,360,62,ki_chroma_acts_smoothed
206,9,172.52266666666665,185.891,13.36833333333334,360,386,26,ki_chroma_acts_smoothed
207,1,0.0,4.661333333333333,4.661333333333333,0,9,9,chromagram
207,2,4.661333333333333,73.20533333333333,68.544,9,128,119,chromagram
207,3,73.20533333333333,106.03733333333332,32.831999999999994,128,185,57,chromagram
207,4,106.03733333333332,138.86933333333332,32.831999999999994,185,242,57,chromagram
207,5,138.86933333333332,143.47733333333332,4.608000000000004,242,250,8,chromagram
207,6,143.47733333333332,148.08533333333332,4.608000000000004,250,258,8,chromagram
207,7,148.08533333333332,152.1173333333333,4.031999999999982,258,265,7,chromagram
207,8,152.1173333333333,156.14933333333332,4.032000000000011,265,272,7,chromagram
207,9,156.14933333333332,221.539,65.38966666666667,272,384,112,chromagram
207,1,0.0,73.20533333333333,73.20533333333333,0,128,128,chroma_acts
207,2,73.20533333333333,110.64533333333333,37.44,128,193,65,chroma_acts
207,3,110.64533333333333,115.25333333333333,4.608000000000004,193,201,8,chroma_acts
207,4,115.25333333333333,138.29333333333332,23.039999999999992,201,241,40,chroma_acts
207,5,138.29333333333332,143.47733333333332,5.1839999999999975,241,250,9,chroma_acts
207,6,143.47733333333332,148.08533333333332,4.608000000000004,250,258,8,chroma_acts
207,7,148.08533333333332,152.69333333333333,4.608000000000004,258,266,8,chroma_acts
207,8,152.69333333333333,156.7253333333333,4.031999999999982,266,273,7,chroma_acts
207,9,156.7253333333333,221.539,64.81366666666668,273,384,111,chroma_acts
207,1,0.0,73.20533333333333,73.20533333333333,0,128,128,chroma_acts_smoothed
207,2,73.20533333333333,110.06933333333333,36.864000000000004,128,192,64,chroma_acts_smoothed
207,3,110.06933333333333,115.25333333333333,5.1839999999999975,192,201,9,chroma_acts_smoothed
207,4,115.25333333333333,138.29333333333332,23.039999999999992,201,241,40,chroma_acts_smoothed
207,5,138.29333333333332,143.47733333333332,5.1839999999999975,241,250,9,chroma_acts_smoothed
207,6,143.47733333333332,148.08533333333332,4.608000000000004,250,258,8,chroma_acts_smoothed
207,7,148.08533333333332,152.69333333333333,4.608000000000004,258,266,8,chroma_acts_smoothed
207,8,152.69333333333333,166.5173333333333,13.823999999999984,266,290,24,chroma_acts_smoothed
207,9,166.5173333333333,221.539,55.021666666666675,290,384,94,chroma_acts_smoothed
207,1,0.0,4.661333333333333,4.661333333333333,0,9,9,ki_chroma
207,2,4.661333333333333,73.20533333333333,68.544,9,128,119,ki_chroma
207,3,73.20533333333333,106.03733333333332,32.831999999999994,128,185,57,ki_chroma
207,4,106.03733333333332,138.86933333333332,32.831999999999994,185,242,57,ki_chroma
207,5,138.86933333333332,143.47733333333332,4.608000000000004,242,250,8,ki_chroma
207,6,143.47733333333332,148.08533333333332,4.608000000000004,250,258,8,ki_chroma
207,7,148.08533333333332,152.1173333333333,4.031999999999982,258,265,7,ki_chroma
207,8,152.1173333333333,156.14933333333332,4.032000000000011,265,272,7,ki_chroma
207,9,156.14933333333332,221.539,65.38966666666667,272,384,112,ki_chroma
207,1,0.0,73.20533333333333,73.20533333333333,0,128,128,ki_chroma_acts
207,2,73.20533333333333,110.64533333333333,37.44,128,193,65,ki_chroma_acts
207,3,110.64533333333333,115.25333333333333,4.608000000000004,193,201,8,ki_chroma_acts
207,4,115.25333333333333,138.29333333333332,23.039999999999992,201,241,40,ki_chroma_acts
207,5,138.29333333333332,143.47733333333332,5.1839999999999975,241,250,9,ki_chroma_acts
207,6,143.47733333333332,148.08533333333332,4.608000000000004,250,258,8,ki_chroma_acts
207,7,148.08533333333332,152.69333333333333,4.608000000000004,258,266,8,ki_chroma_acts
207,8,152.69333333333333,156.7253333333333,4.031999999999982,266,273,7,ki_chroma_acts
207,9,156.7253333333333,221.539,64.81366666666668,273,384,111,ki_chroma_acts
207,1,0.0,73.20533333333333,73.20533333333333,0,128,128,ki_chroma_acts_smoothed
207,2,73.20533333333333,110.06933333333333,36.864000000000004,128,192,64,ki_chroma_acts_smoothed
207,3,110.06933333333333,115.25333333333333,5.1839999999999975,192,201,9,ki_chroma_acts_smoothed
207,4,115.25333333333333,138.29333333333332,23.039999999999992,201,241,40,ki_chroma_acts_smoothed
207,5,138.29333333333332,143.47733333333332,5.1839999999999975,241,250,9,ki_chroma_acts_smoothed
207,6,143.47733333333332,148.08533333333332,4.608000000000004,250,258,8,ki_chroma_acts_smoothed
207,7,148.08533333333332,152.69333333333333,4.608000000000004,258,266,8,ki_chroma_acts_smoothed
207,8,152.69333333333333,166.5173333333333,13.823999999999984,266,290,24,ki_chroma_acts_smoothed
207,9,166.5173333333333,221.539,55.021666666666675,290,384,94,ki_chroma_acts_smoothed
208,1,0.0,34.06933333333333,34.06933333333333,0,70,70,chromagram
208,2,34.06933333333333,53.696000000000005,19.626666666666672,70,110,40,chromagram
208,3,53.696000000000005,68.416,14.719999999999992,110,140,30,chromagram
208,4,68.416,94.912,26.49600000000001,140,194,54,chromagram
208,5,94.912,127.78666666666668,32.87466666666667,194,261,67,chromagram
208,6,127.78666666666668,142.99733333333336,15.210666666666683,261,292,31,chromagram
208,7,142.99733333333336,162.13333333333333,19.135999999999967,292,331,39,chromagram
208,8,162.13333333333333,188.62933333333336,26.496000000000038,331,385,54,chromagram
208,9,188.62933333333336,206.761,18.131666666666632,385,420,35,chromagram
208,1,0.0,33.57866666666666,33.57866666666666,0,69,69,chroma_acts
208,2,33.57866666666666,54.18666666666667,20.608000000000004,69,111,42,chroma_acts
208,3,54.18666666666667,68.416,14.22933333333333,111,140,29,chroma_acts
208,4,68.416,94.912,26.49600000000001,140,194,54,chroma_acts
208,5,94.912,127.78666666666668,32.87466666666667,194,261,67,chroma_acts
208,6,127.78666666666668,131.22133333333335,3.434666666666672,261,268,7,chroma_acts
208,7,131.22133333333335,162.13333333333333,30.911999999999978,268,331,63,chroma_acts
208,8,162.13333333333333,188.62933333333336,26.496000000000038,331,385,54,chroma_acts
208,9,188.62933333333336,206.761,18.131666666666632,385,420,35,chroma_acts
208,1,0.0,34.06933333333333,34.06933333333333,0,70,70,chroma_acts_smoothed
208,2,34.06933333333333,53.696000000000005,19.626666666666672,70,110,40,chroma_acts_smoothed
208,3,53.696000000000005,68.416,14.719999999999992,110,140,30,chroma_acts_smoothed
208,4,68.416,94.42133333333334,26.00533333333334,140,193,53,chroma_acts_smoothed
208,5,94.42133333333334,127.78666666666668,33.36533333333334,193,261,68,chroma_acts_smoothed
208,6,127.78666666666668,142.99733333333336,15.210666666666683,261,292,31,chroma_acts_smoothed
208,7,142.99733333333336,162.13333333333333,19.135999999999967,292,331,39,chroma_acts_smoothed
208,8,162.13333333333333,188.13866666666667,26.00533333333334,331,384,53,chroma_acts_smoothed
208,9,188.13866666666667,206.761,18.62233333333333,384,420,36,chroma_acts_smoothed
208,1,0.0,34.06933333333333,34.06933333333333,0,70,70,ki_chroma
208,2,34.06933333333333,53.696000000000005,19.626666666666672,70,110,40,ki_chroma
208,3,53.696000000000005,68.416,14.719999999999992,110,140,30,ki_chroma
208,4,68.416,94.912,26.49600000000001,140,194,54,ki_chroma
208,5,94.912,127.78666666666668,32.87466666666667,194,261,67,ki_chroma
208,6,127.78666666666668,142.99733333333336,15.210666666666683,261,292,31,ki_chroma
208,7,142.99733333333336,162.13333333333333,19.135999999999967,292,331,39,ki_chroma
208,8,162.13333333333333,188.62933333333336,26.496000000000038,331,385,54,ki_chroma
208,9,188.62933333333336,206.761,18.131666666666632,385,420,35,ki_chroma
208,1,0.0,33.57866666666666,33.57866666666666,0,69,69,ki_chroma_acts
208,2,33.57866666666666,54.18666666666667,20.608000000000004,69,111,42,ki_chroma_acts
208,3,54.18666666666667,68.416,14.22933333333333,111,140,29,ki_chroma_acts
208,4,68.416,94.912,26.49600000000001,140,194,54,ki_chroma_acts
208,5,94.912,127.78666666666668,32.87466666666667,194,261,67,ki_chroma_acts
208,6,127.78666666666668,131.22133333333335,3.434666666666672,261,268,7,ki_chroma_acts
208,7,131.22133333333335,162.13333333333333,30.911999999999978,268,331,63,ki_chroma_acts
208,8,162.13333333333333,188.62933333333336,26.496000000000038,331,385,54,ki_chroma_acts
208,9,188.62933333333336,206.761,18.131666666666632,385,420,35,ki_chroma_acts
208,1,0.0,34.06933333333333,34.06933333333333,0,70,70,ki_chroma_acts_smoothed
208,2,34.06933333333333,53.696000000000005,19.626666666666672,70,110,40,ki_chroma_acts_smoothed
208,3,53.696000000000005,68.416,14.719999999999992,110,140,30,ki_chroma_acts_smoothed
208,4,68.416,94.42133333333334,26.00533333333334,140,193,53,ki_chroma_acts_smoothed
208,5,94.42133333333334,127.78666666666668,33.36533333333334,193,261,68,ki_chroma_acts_smoothed
208,6,127.78666666666668,142.99733333333336,15.210666666666683,261,292,31,ki_chroma_acts_smoothed
208,7,142.99733333333336,162.13333333333333,19.135999999999967,292,331,39,ki_chroma_acts_smoothed
208,8,162.13333333333333,188.13866666666667,26.00533333333334,331,384,53,ki_chroma_acts_smoothed
208,9,188.13866666666667,206.761,18.62233333333333,384,420,36,ki_chroma_acts_smoothed
209,1,0.0,22.154666666666664,22.154666666666664,0,49,49,chromagram
209,2,22.154666666666664,29.49333333333333,7.338666666666665,49,65,16,chromagram
209,3,29.49333333333333,57.471999999999994,27.978666666666665,65,126,61,chromagram
209,4,57.471999999999994,66.64533333333333,9.173333333333332,126,146,20,chromagram
209,5,66.64533333333333,73.984,7.3386666666666684,146,162,16,chromagram
209,6,73.984,101.96266666666665,27.978666666666655,162,223,61,chromagram
209,7,101.96266666666665,132.23466666666664,30.27199999999999,223,289,66,chromagram
209,8,132.23466666666664,161.58933333333331,29.354666666666674,289,353,64,chromagram
209,9,161.58933333333331,193.331,31.741666666666674,353,421,68,chromagram
209,1,0.0,22.154666666666664,22.154666666666664,0,49,49,chroma_acts
209,2,22.154666666666664,29.49333333333333,7.338666666666665,49,65,16,chroma_acts
209,3,29.49333333333333,57.471999999999994,27.978666666666665,65,126,61,chroma_acts
209,4,57.471999999999994,66.64533333333333,9.173333333333332,126,146,20,chroma_acts
209,5,66.64533333333333,73.984,7.3386666666666684,146,162,16,chroma_acts
209,6,73.984,101.96266666666665,27.978666666666655,162,223,61,chroma_acts
209,7,101.96266666666665,161.58933333333331,59.626666666666665,223,353,130,chroma_acts
209,8,161.58933333333331,193.331,31.741666666666674,353,421,68,chroma_acts
209,1,0.0,22.154666666666664,22.154666666666664,0,49,49,chroma_acts_smoothed
209,2,22.154666666666664,29.951999999999995,7.797333333333331,49,66,17,chroma_acts_smoothed
209,3,29.951999999999995,57.471999999999994,27.52,66,126,60,chroma_acts_smoothed
209,4,57.471999999999994,66.64533333333333,9.173333333333332,126,146,20,chroma_acts_smoothed
209,5,66.64533333333333,73.984,7.3386666666666684,146,162,16,chroma_acts_smoothed
209,6,73.984,101.96266666666665,27.978666666666655,162,223,61,chroma_acts_smoothed
209,7,101.96266666666665,161.58933333333331,59.626666666666665,223,353,130,chroma_acts_smoothed
209,8,161.58933333333331,193.331,31.741666666666674,353,421,68,chroma_acts_smoothed
209,1,0.0,22.154666666666664,22.154666666666664,0,49,49,ki_chroma
209,2,22.154666666666664,29.49333333333333,7.338666666666665,49,65,16,ki_chroma
209,3,29.49333333333333,57.471999999999994,27.978666666666665,65,126,61,ki_chroma
209,4,57.471999999999994,66.64533333333333,9.173333333333332,126,146,20,ki_chroma
209,5,66.64533333333333,73.984,7.3386666666666684,146,162,16,ki_chroma
209,6,73.984,101.96266666666665,27.978666666666655,162,223,61,ki_chroma
209,7,101.96266666666665,132.23466666666664,30.27199999999999,223,289,66,ki_chroma
209,8,132.23466666666664,161.58933333333331,29.354666666666674,289,353,64,ki_chroma
209,9,161.58933333333331,193.331,31.741666666666674,353,421,68,ki_chroma
209,1,0.0,22.154666666666664,22.154666666666664,0,49,49,ki_chroma_acts
209,2,22.154666666666664,29.49333333333333,7.338666666666665,49,65,16,ki_chroma_acts
209,3,29.49333333333333,57.471999999999994,27.978666666666665,65,126,61,ki_chroma_acts
209,4,57.471999999999994,66.64533333333333,9.173333333333332,126,146,20,ki_chroma_acts
209,5,66.64533333333333,73.984,7.3386666666666684,146,162,16,ki_chroma_acts
209,6,73.984,101.96266666666665,27.978666666666655,162,223,61,ki_chroma_acts
209,7,101.96266666666665,161.58933333333331,59.626666666666665,223,353,130,ki_chroma_acts
209,8,161.58933333333331,193.331,31.741666666666674,353,421,68,ki_chroma_acts
209,1,0.0,22.154666666666664,22.154666666666664,0,49,49,ki_chroma_acts_smoothed
209,2,22.154666666666664,29.951999999999995,7.797333333333331,49,66,17,ki_chroma_acts_smoothed
209,3,29.951999999999995,57.471999999999994,27.52,66,126,60,ki_chroma_acts_smoothed
209,4,57.471999999999994,66.64533333333333,9.173333333333332,126,146,20,ki_chroma_acts_smoothed
209,5,66.64533333333333,73.984,7.3386666666666684,146,162,16,ki_chroma_acts_smoothed
209,6,73.984,101.96266666666665,27.978666666666655,162,223,61,ki_chroma_acts_smoothed
209,7,101.96266666666665,161.58933333333331,59.626666666666665,223,353,130,ki_chroma_acts_smoothed
209,8,161.58933333333331,193.331,31.741666666666674,353,421,68,ki_chroma_acts_smoothed
212,1,0.0,8.501333333333333,8.501333333333333,0,19,19,chromagram
212,2,8.501333333333333,23.050666666666665,14.549333333333331,19,50,31,chromagram
212,3,23.050666666666665,37.13066666666666,14.079999999999998,50,80,30,chromagram
212,4,37.13066666666666,71.392,34.26133333333333,80,153,73,chromagram
212,5,71.392,74.208,2.8160000000000025,153,159,6,chromagram
212,6,74.208,90.16533333333334,15.957333333333338,159,193,34,chromagram
212,7,90.16533333333334,105.184,15.018666666666661,193,225,32,chromagram
212,8,105.184,123.488,18.304000000000002,225,264,39,chromagram
212,9,123.488,151.086,27.598000000000013,264,321,57,chromagram
212,1,0.0,7.562666666666667,7.562666666666667,0,17,17,chroma_acts
212,2,7.562666666666667,23.050666666666665,15.487999999999998,17,50,33,chroma_acts
212,3,23.050666666666665,37.13066666666666,14.079999999999998,50,80,30,chroma_acts
212,4,37.13066666666666,74.208,37.077333333333335,80,159,79,chroma_acts
212,5,74.208,90.16533333333334,15.957333333333338,159,193,34,chroma_acts
212,6,90.16533333333334,100.96,10.794666666666657,193,216,23,chroma_acts
212,7,100.96,124.896,23.936000000000007,216,267,51,chroma_acts
212,8,124.896,151.086,26.190000000000012,267,321,54,chroma_acts
212,1,0.0,7.562666666666667,7.562666666666667,0,17,17,chroma_acts_smoothed
212,2,7.562666666666667,23.050666666666665,15.487999999999998,17,50,33,chroma_acts_smoothed
212,3,23.050666666666665,37.13066666666666,14.079999999999998,50,80,30,chroma_acts_smoothed
212,4,37.13066666666666,74.67733333333334,37.546666666666674,80,160,80,chroma_acts_smoothed
212,5,74.67733333333334,90.63466666666666,15.957333333333324,160,194,34,chroma_acts_smoothed
212,6,90.63466666666666,100.96,10.325333333333333,194,216,22,chroma_acts_smoothed
212,7,100.96,116.448,15.488,216,249,33,chroma_acts_smoothed
212,8,116.448,124.42666666666666,7.978666666666669,249,266,17,chroma_acts_smoothed
212,9,124.42666666666666,151.086,26.65933333333335,266,321,55,chroma_acts_smoothed
212,1,0.0,8.501333333333333,8.501333333333333,0,19,19,ki_chroma
212,2,8.501333333333333,23.050666666666665,14.549333333333331,19,50,31,ki_chroma
212,3,23.050666666666665,37.13066666666666,14.079999999999998,50,80,30,ki_chroma
212,4,37.13066666666666,71.392,34.26133333333333,80,153,73,ki_chroma
212,5,71.392,74.208,2.8160000000000025,153,159,6,ki_chroma
212,6,74.208,90.16533333333334,15.957333333333338,159,193,34,ki_chroma
212,7,90.16533333333334,105.184,15.018666666666661,193,225,32,ki_chroma
212,8,105.184,123.488,18.304000000000002,225,264,39,ki_chroma
212,9,123.488,151.086,27.598000000000013,264,321,57,ki_chroma
212,1,0.0,7.562666666666667,7.562666666666667,0,17,17,ki_chroma_acts
212,2,7.562666666666667,23.050666666666665,15.487999999999998,17,50,33,ki_chroma_acts
212,3,23.050666666666665,37.13066666666666,14.079999999999998,50,80,30,ki_chroma_acts
212,4,37.13066666666666,74.208,37.077333333333335,80,159,79,ki_chroma_acts
212,5,74.208,90.16533333333334,15.957333333333338,159,193,34,ki_chroma_acts
212,6,90.16533333333334,100.96,10.794666666666657,193,216,23,ki_chroma_acts
212,7,100.96,124.896,23.936000000000007,216,267,51,ki_chroma_acts
212,8,124.896,151.086,26.190000000000012,267,321,54,ki_chroma_acts
212,1,0.0,7.562666666666667,7.562666666666667,0,17,17,ki_chroma_acts_smoothed
212,2,7.562666666666667,23.050666666666665,15.487999999999998,17,50,33,ki_chroma_acts_smoothed
212,3,23.050666666666665,37.13066666666666,14.079999999999998,50,80,30,ki_chroma_acts_smoothed
212,4,37.13066666666666,74.67733333333334,37.546666666666674,80,160,80,ki_chroma_acts_smoothed
212,5,74.67733333333334,90.63466666666666,15.957333333333324,160,194,34,ki_chroma_acts_smoothed
212,6,90.63466666666666,100.96,10.325333333333333,194,216,22,ki_chroma_acts_smoothed
212,7,100.96,116.448,15.488,216,249,33,ki_chroma_acts_smoothed
212,8,116.448,124.42666666666666,7.978666666666669,249,266,17,ki_chroma_acts_smoothed
212,9,124.42666666666666,151.086,26.65933333333335,266,321,55,ki_chroma_acts_smoothed
214,1,0.0,3.3173333333333326,3.3173333333333326,0,8,8,chromagram
214,2,3.3173333333333326,18.45333333333333,15.135999999999997,8,41,33,chromagram
214,3,18.45333333333333,53.77066666666666,35.31733333333334,41,118,77,chromagram
214,4,53.77066666666666,67.53066666666666,13.759999999999998,118,148,30,chromagram
214,5,67.53066666666666,83.12533333333333,15.594666666666669,148,182,34,chromagram
214,6,83.12533333333333,97.80266666666665,14.677333333333323,182,214,32,chromagram
214,7,97.80266666666665,114.31466666666665,16.512,214,250,36,chromagram
214,8,114.31466666666665,145.2,30.885333333333335,250,316,66,chromagram
214,1,0.0,18.45333333333333,18.45333333333333,0,41,41,chroma_acts
214,2,18.45333333333333,53.77066666666666,35.31733333333334,41,118,77,chroma_acts
214,3,53.77066666666666,81.29066666666665,27.51999999999999,118,178,60,chroma_acts
214,4,81.29066666666665,99.17866666666666,17.888000000000005,178,217,39,chroma_acts
214,5,99.17866666666666,104.68266666666666,5.504000000000005,217,229,12,chroma_acts
214,6,104.68266666666666,112.93866666666665,8.255999999999986,229,247,18,chroma_acts
214,7,112.93866666666665,114.31466666666665,1.3760000000000048,247,250,3,chroma_acts
214,8,114.31466666666665,145.2,30.885333333333335,250,316,66,chroma_acts
214,1,0.0,18.45333333333333,18.45333333333333,0,41,41,chroma_acts_smoothed
214,2,18.45333333333333,53.77066666666666,35.31733333333334,41,118,77,chroma_acts_smoothed
214,3,53.77066666666666,77.62133333333333,23.850666666666662,118,170,52,chroma_acts_smoothed
214,4,77.62133333333333,83.12533333333333,5.504000000000005,170,182,12,chroma_acts_smoothed
214,5,83.12533333333333,99.17866666666666,16.053333333333327,182,217,35,chroma_acts_smoothed
214,6,99.17866666666666,104.68266666666666,5.504000000000005,217,229,12,chroma_acts_smoothed
214,7,104.68266666666666,114.31466666666665,9.63199999999999,229,250,21,chroma_acts_smoothed
214,8,114.31466666666665,145.2,30.885333333333335,250,316,66,chroma_acts_smoothed
214,1,0.0,3.3173333333333326,3.3173333333333326,0,8,8,ki_chroma
214,2,3.3173333333333326,18.45333333333333,15.135999999999997,8,41,33,ki_chroma
214,3,18.45333333333333,53.77066666666666,35.31733333333334,41,118,77,ki_chroma
214,4,53.77066666666666,67.53066666666666,13.759999999999998,118,148,30,ki_chroma
214,5,67.53066666666666,83.12533333333333,15.594666666666669,148,182,34,ki_chroma
214,6,83.12533333333333,97.80266666666665,14.677333333333323,182,214,32,ki_chroma
214,7,97.80266666666665,114.31466666666665,16.512,214,250,36,ki_chroma
214,8,114.31466666666665,145.2,30.885333333333335,250,316,66,ki_chroma
214,1,0.0,18.45333333333333,18.45333333333333,0,41,41,ki_chroma_acts
214,2,18.45333333333333,53.77066666666666,35.31733333333334,41,118,77,ki_chroma_acts
214,3,53.77066666666666,81.29066666666665,27.51999999999999,118,178,60,ki_chroma_acts
214,4,81.29066666666665,99.17866666666666,17.888000000000005,178,217,39,ki_chroma_acts
214,5,99.17866666666666,104.68266666666666,5.504000000000005,217,229,12,ki_chroma_acts
214,6,104.68266666666666,112.93866666666665,8.255999999999986,229,247,18,ki_chroma_acts
214,7,112.93866666666665,114.31466666666665,1.3760000000000048,247,250,3,ki_chroma_acts
214,8,114.31466666666665,145.2,30.885333333333335,250,316,66,ki_chroma_acts
214,1,0.0,18.45333333333333,18.45333333333333,0,41,41,ki_chroma_acts_smoothed
214,2,18.45333333333333,53.77066666666666,35.31733333333334,41,118,77,ki_chroma_acts_smoothed
214,3,53.77066666666666,77.62133333333333,23.850666666666662,118,170,52,ki_chroma_acts_smoothed
214,4,77.62133333333333,83.12533333333333,5.504000000000005,170,182,12,ki_chroma_acts_smoothed
214,5,83.12533333333333,99.17866666666666,16.053333333333327,182,217,35,ki_chroma_acts_smoothed
214,6,99.17866666666666,104.68266666666666,5.504000000000005,217,229,12,ki_chroma_acts_smoothed
214,7,104.68266666666666,114.31466666666665,9.63199999999999,229,250,21,ki_chroma_acts_smoothed
214,8,114.31466666666665,145.2,30.885333333333335,250,316,66,ki_chroma_acts_smoothed
215,1,0.0,38.93333333333334,38.93333333333334,0,80,80,chromagram
215,2,38.93333333333334,42.85866666666667,3.9253333333333345,80,88,8,chromagram
215,3,42.85866666666667,101.73866666666667,58.88,88,208,120,chromagram
215,4,101.73866666666667,115.968,14.22933333333333,208,237,29,chromagram
215,5,115.968,148.35200000000003,32.38400000000003,237,303,66,chromagram
215,6,148.35200000000003,187.60533333333336,39.25333333333333,303,383,80,chromagram
215,7,187.60533333333336,191.04000000000002,3.434666666666658,383,390,7,chromagram
215,8,191.04000000000002,199.061,8.020999999999987,390,405,15,chromagram
215,1,0.0,38.93333333333334,38.93333333333334,0,80,80,chroma_acts
215,2,38.93333333333334,101.73866666666667,62.80533333333334,80,208,128,chroma_acts
215,3,101.73866666666667,115.47733333333333,13.73866666666666,208,236,28,chroma_acts
215,4,115.47733333333333,135.59466666666668,20.11733333333335,236,277,41,chroma_acts
215,5,135.59466666666668,148.35200000000003,12.75733333333335,277,303,26,chroma_acts
215,6,148.35200000000003,187.60533333333336,39.25333333333333,303,383,80,chroma_acts
215,7,187.60533333333336,191.5306666666667,3.9253333333333273,383,391,8,chroma_acts
215,8,191.5306666666667,199.061,7.530333333333317,391,405,14,chroma_acts
215,1,0.0,38.93333333333334,38.93333333333334,0,80,80,chroma_acts_smoothed
215,2,38.93333333333334,102.22933333333333,63.29599999999999,80,209,129,chroma_acts_smoothed
215,3,102.22933333333333,115.968,13.738666666666674,209,237,28,chroma_acts_smoothed
215,4,115.968,135.59466666666668,19.62666666666668,237,277,40,chroma_acts_smoothed
215,5,135.59466666666668,148.84266666666667,13.24799999999999,277,304,27,chroma_acts_smoothed
215,6,148.84266666666667,187.60533333333336,38.76266666666669,304,383,79,chroma_acts_smoothed
215,7,187.60533333333336,191.5306666666667,3.9253333333333273,383,391,8,chroma_acts_smoothed
215,8,191.5306666666667,199.061,7.530333333333317,391,405,14,chroma_acts_smoothed
215,1,0.0,38.93333333333334,38.93333333333334,0,80,80,ki_chroma
215,2,38.93333333333334,42.85866666666667,3.9253333333333345,80,88,8,ki_chroma
215,3,42.85866666666667,101.73866666666667,58.88,88,208,120,ki_chroma
215,4,101.73866666666667,115.968,14.22933333333333,208,237,29,ki_chroma
215,5,115.968,148.35200000000003,32.38400000000003,237,303,66,ki_chroma
215,6,148.35200000000003,187.60533333333336,39.25333333333333,303,383,80,ki_chroma
215,7,187.60533333333336,191.04000000000002,3.434666666666658,383,390,7,ki_chroma
215,8,191.04000000000002,199.061,8.020999999999987,390,405,15,ki_chroma
215,1,0.0,38.93333333333334,38.93333333333334,0,80,80,ki_chroma_acts
215,2,38.93333333333334,101.73866666666667,62.80533333333334,80,208,128,ki_chroma_acts
215,3,101.73866666666667,115.47733333333333,13.73866666666666,208,236,28,ki_chroma_acts
215,4,115.47733333333333,135.59466666666668,20.11733333333335,236,277,41,ki_chroma_acts
215,5,135.59466666666668,148.35200000000003,12.75733333333335,277,303,26,ki_chroma_acts
215,6,148.35200000000003,187.60533333333336,39.25333333333333,303,383,80,ki_chroma_acts
215,7,187.60533333333336,191.5306666666667,3.9253333333333273,383,391,8,ki_chroma_acts
215,8,191.5306666666667,199.061,7.530333333333317,391,405,14,ki_chroma_acts
215,1,0.0,38.93333333333334,38.93333333333334,0,80,80,ki_chroma_acts_smoothed
215,2,38.93333333333334,102.22933333333333,63.29599999999999,80,209,129,ki_chroma_acts_smoothed
215,3,102.22933333333333,115.968,13.738666666666674,209,237,28,ki_chroma_acts_smoothed
215,4,115.968,135.59466666666668,19.62666666666668,237,277,40,ki_chroma_acts_smoothed
215,5,135.59466666666668,148.84266666666667,13.24799999999999,277,304,27,ki_chroma_acts_smoothed
215,6,148.84266666666667,187.60533333333336,38.76266666666669,304,383,79,ki_chroma_acts_smoothed
215,7,187.60533333333336,191.5306666666667,3.9253333333333273,383,391,8,ki_chroma_acts_smoothed
215,8,191.5306666666667,199.061,7.530333333333317,391,405,14,ki_chroma_acts_smoothed
219,1,0.0,37.653333333333336,37.653333333333336,0,89,89,chromagram
219,2,37.653333333333336,95.25333333333334,57.60000000000001,89,224,135,chromagram
219,3,95.25333333333334,99.52000000000001,4.266666666666666,224,234,10,chromagram
219,4,99.52000000000001,102.08000000000001,2.5600000000000023,234,240,6,chromagram
219,5,102.08000000000001,106.77333333333334,4.693333333333328,240,251,11,chromagram
219,6,106.77333333333334,108.90666666666668,2.13333333333334,251,256,5,chromagram
219,7,108.90666666666668,137.06666666666666,28.159999999999982,256,322,66,chromagram
219,8,137.06666666666666,180.439,43.37233333333333,322,422,100,chromagram
219,1,0.0,41.06666666666667,41.06666666666667,0,97,97,chroma_acts
219,2,41.06666666666667,95.25333333333334,54.186666666666675,97,224,127,chroma_acts
219,3,95.25333333333334,99.52000000000001,4.266666666666666,224,234,10,chroma_acts
219,4,99.52000000000001,102.08000000000001,2.5600000000000023,234,240,6,chroma_acts
219,5,102.08000000000001,106.77333333333334,4.693333333333328,240,251,11,chroma_acts
219,6,106.77333333333334,108.90666666666668,2.13333333333334,251,256,5,chroma_acts
219,7,108.90666666666668,137.06666666666666,28.159999999999982,256,322,66,chroma_acts
219,8,137.06666666666666,180.439,43.37233333333333,322,422,100,chroma_acts
219,1,0.0,24.0,24.0,0,57,57,chroma_acts_smoothed
219,2,24.0,41.06666666666667,17.06666666666667,57,97,40,chroma_acts_smoothed
219,3,41.06666666666667,99.52000000000001,58.45333333333334,97,234,137,chroma_acts_smoothed
219,4,99.52000000000001,102.08000000000001,2.5600000000000023,234,240,6,chroma_acts_smoothed
219,5,102.08000000000001,106.77333333333334,4.693333333333328,240,251,11,chroma_acts_smoothed
219,6,106.77333333333334,108.90666666666668,2.13333333333334,251,256,5,chroma_acts_smoothed
219,7,108.90666666666668,137.06666666666666,28.159999999999982,256,322,66,chroma_acts_smoothed
219,8,137.06666666666666,180.439,43.37233333333333,322,422,100,chroma_acts_smoothed
219,1,0.0,37.653333333333336,37.653333333333336,0,89,89,ki_chroma
219,2,37.653333333333336,95.25333333333334,57.60000000000001,89,224,135,ki_chroma
219,3,95.25333333333334,99.52000000000001,4.266666666666666,224,234,10,ki_chroma
219,4,99.52000000000001,102.08000000000001,2.5600000000000023,234,240,6,ki_chroma
219,5,102.08000000000001,106.77333333333334,4.693333333333328,240,251,11,ki_chroma
219,6,106.77333333333334,108.90666666666668,2.13333333333334,251,256,5,ki_chroma
219,7,108.90666666666668,137.06666666666666,28.159999999999982,256,322,66,ki_chroma
219,8,137.06666666666666,180.439,43.37233333333333,322,422,100,ki_chroma
219,1,0.0,41.06666666666667,41.06666666666667,0,97,97,ki_chroma_acts
219,2,41.06666666666667,95.25333333333334,54.186666666666675,97,224,127,ki_chroma_acts
219,3,95.25333333333334,99.52000000000001,4.266666666666666,224,234,10,ki_chroma_acts
219,4,99.52000000000001,102.08000000000001,2.5600000000000023,234,240,6,ki_chroma_acts
219,5,102.08000000000001,106.77333333333334,4.693333333333328,240,251,11,ki_chroma_acts
219,6,106.77333333333334,108.90666666666668,2.13333333333334,251,256,5,ki_chroma_acts
219,7,108.90666666666668,137.06666666666666,28.159999999999982,256,322,66,ki_chroma_acts
219,8,137.06666666666666,180.439,43.37233333333333,322,422,100,ki_chroma_acts
219,1,0.0,24.0,24.0,0,57,57,ki_chroma_acts_smoothed
219,2,24.0,41.06666666666667,17.06666666666667,57,97,40,ki_chroma_acts_smoothed
219,3,41.06666666666667,99.52000000000001,58.45333333333334,97,234,137,ki_chroma_acts_smoothed
219,4,99.52000000000001,102.08000000000001,2.5600000000000023,234,240,6,ki_chroma_acts_smoothed
219,5,102.08000000000001,106.77333333333334,4.693333333333328,240,251,11,ki_chroma_acts_smoothed
219,6,106.77333333333334,108.90666666666668,2.13333333333334,251,256,5,ki_chroma_acts_smoothed
219,7,108.90666666666668,137.06666666666666,28.159999999999982,256,322,66,ki_chroma_acts_smoothed
219,8,137.06666666666666,180.439,43.37233333333333,322,422,100,ki_chroma_acts_smoothed
223,1,0.0,15.136,15.136,0,33,33,chromagram
223,2,15.136,47.52,32.384,33,102,69,chromagram
223,3,47.52,55.029333333333334,7.5093333333333305,102,118,16,chromagram
223,4,55.029333333333334,60.66133333333333,5.631999999999998,118,130,12,chromagram
223,5,60.66133333333333,62.06933333333333,1.4080000000000013,130,133,3,chromagram
223,6,62.06933333333333,90.69866666666667,28.629333333333335,133,194,61,chromagram
223,7,90.69866666666667,122.61333333333333,31.914666666666662,194,262,68,chromagram
223,8,122.61333333333333,151.712,29.09866666666666,262,324,62,chromagram
223,9,151.712,167.262,15.550000000000011,324,356,32,chromagram
223,1,0.0,11.381333333333332,11.381333333333332,0,25,25,chroma_acts
223,2,11.381333333333332,15.136,3.754666666666667,25,33,8,chroma_acts
223,3,15.136,47.050666666666665,31.914666666666665,33,101,68,chroma_acts
223,4,47.050666666666665,62.06933333333333,15.018666666666668,101,133,32,chroma_acts
223,5,62.06933333333333,93.984,31.914666666666662,133,201,68,chroma_acts
223,6,93.984,122.61333333333333,28.629333333333335,201,262,61,chroma_acts
223,7,122.61333333333333,137.16266666666667,14.549333333333337,262,293,31,chroma_acts
223,8,137.16266666666667,151.712,14.549333333333323,293,324,31,chroma_acts
223,9,151.712,167.262,15.550000000000011,324,356,32,chroma_acts
223,1,0.0,11.381333333333332,11.381333333333332,0,25,25,chroma_acts_smoothed
223,2,11.381333333333332,17.013333333333335,5.632000000000003,25,37,12,chroma_acts_smoothed
223,3,17.013333333333335,45.64266666666667,28.629333333333335,37,98,61,chroma_acts_smoothed
223,4,45.64266666666667,62.06933333333333,16.426666666666662,98,133,35,chroma_acts_smoothed
223,5,62.06933333333333,93.984,31.914666666666662,133,201,68,chroma_acts_smoothed
223,6,93.984,122.61333333333333,28.629333333333335,201,262,61,chroma_acts_smoothed
223,7,122.61333333333333,137.16266666666667,14.549333333333337,262,293,31,chroma_acts_smoothed
223,8,137.16266666666667,151.712,14.549333333333323,293,324,31,chroma_acts_smoothed
223,9,151.712,167.262,15.550000000000011,324,356,32,chroma_acts_smoothed
223,1,0.0,15.136,15.136,0,33,33,ki_chroma
223,2,15.136,47.52,32.384,33,102,69,ki_chroma
223,3,47.52,55.029333333333334,7.5093333333333305,102,118,16,ki_chroma
223,4,55.029333333333334,60.66133333333333,5.631999999999998,118,130,12,ki_chroma
223,5,60.66133333333333,62.06933333333333,1.4080000000000013,130,133,3,ki_chroma
223,6,62.06933333333333,90.69866666666667,28.629333333333335,133,194,61,ki_chroma
223,7,90.69866666666667,122.61333333333333,31.914666666666662,194,262,68,ki_chroma
223,8,122.61333333333333,151.712,29.09866666666666,262,324,62,ki_chroma
223,9,151.712,167.262,15.550000000000011,324,356,32,ki_chroma
223,1,0.0,11.381333333333332,11.381333333333332,0,25,25,ki_chroma_acts
223,2,11.381333333333332,15.136,3.754666666666667,25,33,8,ki_chroma_acts
223,3,15.136,47.050666666666665,31.914666666666665,33,101,68,ki_chroma_acts
223,4,47.050666666666665,62.06933333333333,15.018666666666668,101,133,32,ki_chroma_acts
223,5,62.06933333333333,93.984,31.914666666666662,133,201,68,ki_chroma_acts
223,6,93.984,122.61333333333333,28.629333333333335,201,262,61,ki_chroma_acts
223,7,122.61333333333333,137.16266666666667,14.549333333333337,262,293,31,ki_chroma_acts
223,8,137.16266666666667,151.712,14.549333333333323,293,324,31,ki_chroma_acts
223,9,151.712,167.262,15.550000000000011,324,356,32,ki_chroma_acts
223,1,0.0,11.381333333333332,11.381333333333332,0,25,25,ki_chroma_acts_smoothed
223,2,11.381333333333332,17.013333333333335,5.632000000000003,25,37,12,ki_chroma_acts_smoothed
223,3,17.013333333333335,45.64266666666667,28.629333333333335,37,98,61,ki_chroma_acts_smoothed
223,4,45.64266666666667,62.06933333333333,16.426666666666662,98,133,35,ki_chroma_acts_smoothed
223,5,62.06933333333333,93.984,31.914666666666662,133,201,68,ki_chroma_acts_smoothed
223,6,93.984,122.61333333333333,28.629333333333335,201,262,61,ki_chroma_acts_smoothed
223,7,122.61333333333333,137.16266666666667,14.549333333333337,262,293,31,ki_chroma_acts_smoothed
223,8,137.16266666666667,151.712,14.549333333333323,293,324,31,ki_chroma_acts_smoothed
223,9,151.712,167.262,15.550000000000011,324,356,32,ki_chroma_acts_smoothed
227,1,0.0,28.416,28.416,0,60,60,chromagram
227,2,28.416,88.89599999999999,60.47999999999999,60,186,126,chromagram
227,3,88.89599999999999,93.216,4.320000000000007,186,195,9,chromagram
227,4,93.216,122.97599999999998,29.75999999999999,195,257,62,chromagram
227,5,122.97599999999998,131.61599999999999,8.64,257,275,18,chromagram
227,6,131.61599999999999,134.976,3.3600000000000136,275,282,7,chromagram
227,7,134.976,138.816,3.8400000000000034,282,290,8,chromagram
227,8,138.816,169.705,30.88900000000001,290,353,63,chromagram
227,1,0.0,28.416,28.416,0,60,60,chroma_acts
227,2,28.416,88.89599999999999,60.47999999999999,60,186,126,chroma_acts
227,3,88.89599999999999,93.216,4.320000000000007,186,195,9,chroma_acts
227,4,93.216,122.97599999999998,29.75999999999999,195,257,62,chroma_acts
227,5,122.97599999999998,131.61599999999999,8.64,257,275,18,chroma_acts
227,6,131.61599999999999,134.976,3.3600000000000136,275,282,7,chroma_acts
227,7,134.976,138.816,3.8400000000000034,282,290,8,chroma_acts
227,8,138.816,169.705,30.88900000000001,290,353,63,chroma_acts
227,1,0.0,28.416,28.416,0,60,60,chroma_acts_smoothed
227,2,28.416,88.89599999999999,60.47999999999999,60,186,126,chroma_acts_smoothed
227,3,88.89599999999999,93.216,4.320000000000007,186,195,9,chroma_acts_smoothed
227,4,93.216,122.97599999999998,29.75999999999999,195,257,62,chroma_acts_smoothed
227,5,122.97599999999998,131.61599999999999,8.64,257,275,18,chroma_acts_smoothed
227,6,131.61599999999999,135.456,3.8400000000000034,275,283,8,chroma_acts_smoothed
227,7,135.456,138.816,3.3600000000000136,283,290,7,chroma_acts_smoothed
227,8,138.816,169.705,30.88900000000001,290,353,63,chroma_acts_smoothed
227,1,0.0,28.416,28.416,0,60,60,ki_chroma
227,2,28.416,88.89599999999999,60.47999999999999,60,186,126,ki_chroma
227,3,88.89599999999999,93.216,4.320000000000007,186,195,9,ki_chroma
227,4,93.216,122.97599999999998,29.75999999999999,195,257,62,ki_chroma
227,5,122.97599999999998,131.61599999999999,8.64,257,275,18,ki_chroma
227,6,131.61599999999999,134.976,3.3600000000000136,275,282,7,ki_chroma
227,7,134.976,138.816,3.8400000000000034,282,290,8,ki_chroma
227,8,138.816,169.705,30.88900000000001,290,353,63,ki_chroma
227,1,0.0,28.416,28.416,0,60,60,ki_chroma_acts
227,2,28.416,88.89599999999999,60.47999999999999,60,186,126,ki_chroma_acts
227,3,88.89599999999999,93.216,4.320000000000007,186,195,9,ki_chroma_acts
227,4,93.216,122.97599999999998,29.75999999999999,195,257,62,ki_chroma_acts
227,5,122.97599999999998,131.61599999999999,8.64,257,275,18,ki_chroma_acts
227,6,131.61599999999999,134.976,3.3600000000000136,275,282,7,ki_chroma_acts
227,7,134.976,138.816,3.8400000000000034,282,290,8,ki_chroma_acts
227,8,138.816,169.705,30.88900000000001,290,353,63,ki_chroma_acts
227,1,0.0,28.416,28.416,0,60,60,ki_chroma_acts_smoothed
227,2,28.416,88.89599999999999,60.47999999999999,60,186,126,ki_chroma_acts_smoothed
227,3,88.89599999999999,93.216,4.320000000000007,186,195,9,ki_chroma_acts_smoothed
227,4,93.216,122.97599999999998,29.75999999999999,195,257,62,ki_chroma_acts_smoothed
227,5,122.97599999999998,131.61599999999999,8.64,257,275,18,ki_chroma_acts_smoothed
227,6,131.61599999999999,135.456,3.8400000000000034,275,283,8,ki_chroma_acts_smoothed
227,7,135.456,138.816,3.3600000000000136,283,290,7,ki_chroma_acts_smoothed
227,8,138.816,169.705,30.88900000000001,290,353,63,ki_chroma_acts_smoothed
229,1,0.0,31.477333333333334,31.477333333333334,0,68,68,chromagram
229,2,31.477333333333334,61.984,30.506666666666668,68,133,65,chromagram
229,3,61.984,65.26933333333334,3.285333333333334,133,140,7,chromagram
229,4,65.26933333333334,77.00266666666667,11.733333333333334,140,165,25,chromagram
229,5,77.00266666666667,89.20533333333333,12.202666666666659,165,191,26,chromagram
229,6,89.20533333333333,118.304,29.098666666666674,191,253,62,chromagram
229,7,118.304,122.05866666666667,3.7546666666666653,253,261,8,chromagram
229,8,122.05866666666667,140.832,18.773333333333326,261,301,40,chromagram
229,9,140.832,170.609,29.777000000000015,301,363,62,chromagram
229,1,0.0,31.477333333333334,31.477333333333334,0,68,68,chroma_acts
229,2,31.477333333333334,61.984,30.506666666666668,68,133,65,chroma_acts
229,3,61.984,65.26933333333334,3.285333333333334,133,140,7,chroma_acts
229,4,65.26933333333334,76.53333333333333,11.263999999999996,140,164,24,chroma_acts
229,5,76.53333333333333,87.328,10.794666666666672,164,187,23,chroma_acts
229,6,87.328,118.304,30.976,187,253,66,chroma_acts
229,7,118.304,122.05866666666667,3.7546666666666653,253,261,8,chroma_acts
229,8,122.05866666666667,140.36266666666666,18.303999999999988,261,300,39,chroma_acts
229,9,140.36266666666666,170.609,30.246333333333354,300,363,63,chroma_acts
229,1,0.0,31.477333333333334,31.477333333333334,0,68,68,chroma_acts_smoothed
229,2,31.477333333333334,61.51466666666667,30.037333333333336,68,132,64,chroma_acts_smoothed
229,3,61.51466666666667,65.73866666666667,4.224000000000004,132,141,9,chroma_acts_smoothed
229,4,65.73866666666667,76.53333333333333,10.794666666666657,141,164,23,chroma_acts_smoothed
229,5,76.53333333333333,87.328,10.794666666666672,164,187,23,chroma_acts_smoothed
229,6,87.328,122.05866666666667,34.730666666666664,187,261,74,chroma_acts_smoothed
229,7,122.05866666666667,140.36266666666666,18.303999999999988,261,300,39,chroma_acts_smoothed
229,8,140.36266666666666,151.15733333333333,10.794666666666672,300,323,23,chroma_acts_smoothed
229,9,151.15733333333333,170.609,19.451666666666682,323,363,40,chroma_acts_smoothed
229,1,0.0,31.477333333333334,31.477333333333334,0,68,68,ki_chroma
229,2,31.477333333333334,61.984,30.506666666666668,68,133,65,ki_chroma
229,3,61.984,65.26933333333334,3.285333333333334,133,140,7,ki_chroma
229,4,65.26933333333334,77.00266666666667,11.733333333333334,140,165,25,ki_chroma
229,5,77.00266666666667,89.20533333333333,12.202666666666659,165,191,26,ki_chroma
229,6,89.20533333333333,118.304,29.098666666666674,191,253,62,ki_chroma
229,7,118.304,122.05866666666667,3.7546666666666653,253,261,8,ki_chroma
229,8,122.05866666666667,140.832,18.773333333333326,261,301,40,ki_chroma
229,9,140.832,170.609,29.777000000000015,301,363,62,ki_chroma
229,1,0.0,31.477333333333334,31.477333333333334,0,68,68,ki_chroma_acts
229,2,31.477333333333334,61.984,30.506666666666668,68,133,65,ki_chroma_acts
229,3,61.984,65.26933333333334,3.285333333333334,133,140,7,ki_chroma_acts
229,4,65.26933333333334,76.53333333333333,11.263999999999996,140,164,24,ki_chroma_acts
229,5,76.53333333333333,87.328,10.794666666666672,164,187,23,ki_chroma_acts
229,6,87.328,118.304,30.976,187,253,66,ki_chroma_acts
229,7,118.304,122.05866666666667,3.7546666666666653,253,261,8,ki_chroma_acts
229,8,122.05866666666667,140.36266666666666,18.303999999999988,261,300,39,ki_chroma_acts
229,9,140.36266666666666,170.609,30.246333333333354,300,363,63,ki_chroma_acts
229,1,0.0,31.477333333333334,31.477333333333334,0,68,68,ki_chroma_acts_smoothed
229,2,31.477333333333334,61.51466666666667,30.037333333333336,68,132,64,ki_chroma_acts_smoothed
229,3,61.51466666666667,65.73866666666667,4.224000000000004,132,141,9,ki_chroma_acts_smoothed
229,4,65.73866666666667,76.53333333333333,10.794666666666657,141,164,23,ki_chroma_acts_smoothed
229,5,76.53333333333333,87.328,10.794666666666672,164,187,23,ki_chroma_acts_smoothed
229,6,87.328,122.05866666666667,34.730666666666664,187,261,74,ki_chroma_acts_smoothed
229,7,122.05866666666667,140.36266666666666,18.303999999999988,261,300,39,ki_chroma_acts_smoothed
229,8,140.36266666666666,151.15733333333333,10.794666666666672,300,323,23,ki_chroma_acts_smoothed
229,9,151.15733333333333,170.609,19.451666666666682,323,363,40,ki_chroma_acts_smoothed
234,1,0.0,13.461333333333332,13.461333333333332,0,29,29,chromagram
234,2,13.461333333333332,30.741333333333333,17.28,29,65,36,chromagram
234,3,30.741333333333333,75.86133333333333,45.120000000000005,65,159,94,chromagram
234,4,75.86133333333333,89.78133333333332,13.919999999999987,159,188,29,chromagram
234,5,89.78133333333332,102.26133333333333,12.480000000000004,188,214,26,chromagram
234,6,102.26133333333333,107.06133333333332,4.799999999999997,214,224,10,chromagram
234,7,107.06133333333332,137.896,30.834666666666664,224,287,63,chromagram
234,1,0.0,13.461333333333332,13.461333333333332,0,29,29,chroma_acts
234,2,13.461333333333332,15.861333333333333,2.4000000000000004,29,34,5,chroma_acts
234,3,15.861333333333333,22.581333333333333,6.720000000000001,34,48,14,chroma_acts
234,4,22.581333333333333,30.741333333333333,8.16,48,65,17,chroma_acts
234,5,30.741333333333333,76.82133333333333,46.08,65,161,96,chroma_acts
234,6,76.82133333333333,89.78133333333332,12.959999999999994,161,188,27,chroma_acts
234,7,89.78133333333332,102.26133333333333,12.480000000000004,188,214,26,chroma_acts
234,8,102.26133333333333,107.06133333333332,4.799999999999997,214,224,10,chroma_acts
234,9,107.06133333333332,137.896,30.834666666666664,224,287,63,chroma_acts
234,1,0.0,13.461333333333332,13.461333333333332,0,29,29,chroma_acts_smoothed
234,2,13.461333333333332,15.861333333333333,2.4000000000000004,29,34,5,chroma_acts_smoothed
234,3,15.861333333333333,25.941333333333333,10.08,34,55,21,chroma_acts_smoothed
234,4,25.941333333333333,31.701333333333334,5.760000000000002,55,67,12,chroma_acts_smoothed
234,5,31.701333333333334,76.82133333333333,45.11999999999999,67,161,94,chroma_acts_smoothed
234,6,76.82133333333333,89.78133333333332,12.959999999999994,161,188,27,chroma_acts_smoothed
234,7,89.78133333333332,98.90133333333333,9.120000000000005,188,207,19,chroma_acts_smoothed
234,8,98.90133333333333,107.54133333333333,8.64,207,225,18,chroma_acts_smoothed
234,9,107.54133333333333,137.896,30.35466666666666,225,287,62,chroma_acts_smoothed
234,1,0.0,13.461333333333332,13.461333333333332,0,29,29,ki_chroma
234,2,13.461333333333332,30.741333333333333,17.28,29,65,36,ki_chroma
234,3,30.741333333333333,75.86133333333333,45.120000000000005,65,159,94,ki_chroma
234,4,75.86133333333333,89.78133333333332,13.919999999999987,159,188,29,ki_chroma
234,5,89.78133333333332,102.26133333333333,12.480000000000004,188,214,26,ki_chroma
234,6,102.26133333333333,107.06133333333332,4.799999999999997,214,224,10,ki_chroma
234,7,107.06133333333332,137.896,30.834666666666664,224,287,63,ki_chroma
234,1,0.0,13.461333333333332,13.461333333333332,0,29,29,ki_chroma_acts
234,2,13.461333333333332,15.861333333333333,2.4000000000000004,29,34,5,ki_chroma_acts
234,3,15.861333333333333,22.581333333333333,6.720000000000001,34,48,14,ki_chroma_acts
234,4,22.581333333333333,30.741333333333333,8.16,48,65,17,ki_chroma_acts
234,5,30.741333333333333,76.82133333333333,46.08,65,161,96,ki_chroma_acts
234,6,76.82133333333333,89.78133333333332,12.959999999999994,161,188,27,ki_chroma_acts
234,7,89.78133333333332,102.26133333333333,12.480000000000004,188,214,26,ki_chroma_acts
234,8,102.26133333333333,107.06133333333332,4.799999999999997,214,224,10,ki_chroma_acts
234,9,107.06133333333332,137.896,30.834666666666664,224,287,63,ki_chroma_acts
234,1,0.0,13.461333333333332,13.461333333333332,0,29,29,ki_chroma_acts_smoothed
234,2,13.461333333333332,15.861333333333333,2.4000000000000004,29,34,5,ki_chroma_acts_smoothed
234,3,15.861333333333333,25.941333333333333,10.08,34,55,21,ki_chroma_acts_smoothed
234,4,25.941333333333333,31.701333333333334,5.760000000000002,55,67,12,ki_chroma_acts_smoothed
234,5,31.701333333333334,76.82133333333333,45.11999999999999,67,161,94,ki_chroma_acts_smoothed
234,6,76.82133333333333,89.78133333333332,12.959999999999994,161,188,27,ki_chroma_acts_smoothed
234,7,89.78133333333332,98.90133333333333,9.120000000000005,188,207,19,ki_chroma_acts_smoothed
234,8,98.90133333333333,107.54133333333333,8.64,207,225,18,ki_chroma_acts_smoothed
234,9,107.54133333333333,137.896,30.35466666666666,225,287,62,ki_chroma_acts_smoothed
235,1,0.0,43.46666666666667,43.46666666666667,0,93,93,chromagram
235,2,43.46666666666667,60.36266666666666,16.895999999999994,93,129,36,chromagram
235,3,60.36266666666666,90.4,30.037333333333343,129,193,64,chromagram
235,4,90.4,104.01066666666665,13.610666666666646,193,222,29,chromagram
235,5,104.01066666666665,165.96266666666665,61.952,222,354,132,chromagram
235,6,165.96266666666665,173.94133333333332,7.978666666666669,354,371,17,chromagram
235,7,173.94133333333332,187.08266666666665,13.141333333333336,371,399,28,chromagram
235,8,187.08266666666665,218.99733333333333,31.914666666666676,399,467,68,chromagram
235,9,218.99733333333333,236.112,17.114666666666665,467,502,35,chromagram
235,1,0.0,43.46666666666667,43.46666666666667,0,93,93,chroma_acts
235,2,43.46666666666667,90.4,46.93333333333334,93,193,100,chroma_acts
235,3,90.4,104.01066666666665,13.610666666666646,193,222,29,chroma_acts
235,4,104.01066666666665,150.944,46.93333333333334,222,322,100,chroma_acts
235,5,150.944,165.96266666666665,15.018666666666661,322,354,32,chroma_acts
235,6,165.96266666666665,173.94133333333332,7.978666666666669,354,371,17,chroma_acts
235,7,173.94133333333332,187.08266666666665,13.141333333333336,371,399,28,chroma_acts
235,8,187.08266666666665,218.99733333333333,31.914666666666676,399,467,68,chroma_acts
235,9,218.99733333333333,236.112,17.114666666666665,467,502,35,chroma_acts
235,1,0.0,43.46666666666667,43.46666666666667,0,93,93,chroma_acts_smoothed
235,2,43.46666666666667,90.4,46.93333333333334,93,193,100,chroma_acts_smoothed
235,3,90.4,104.01066666666665,13.610666666666646,193,222,29,chroma_acts_smoothed
235,4,104.01066666666665,150.944,46.93333333333334,222,322,100,chroma_acts_smoothed
235,5,150.944,165.96266666666665,15.018666666666661,322,354,32,chroma_acts_smoothed
235,6,165.96266666666665,173.94133333333332,7.978666666666669,354,371,17,chroma_acts_smoothed
235,7,173.94133333333332,187.08266666666665,13.141333333333336,371,399,28,chroma_acts_smoothed
235,8,187.08266666666665,218.99733333333333,31.914666666666676,399,467,68,chroma_acts_smoothed
235,9,218.99733333333333,236.112,17.114666666666665,467,502,35,chroma_acts_smoothed
235,1,0.0,43.46666666666667,43.46666666666667,0,93,93,ki_chroma
235,2,43.46666666666667,60.36266666666666,16.895999999999994,93,129,36,ki_chroma
235,3,60.36266666666666,90.4,30.037333333333343,129,193,64,ki_chroma
235,4,90.4,104.01066666666665,13.610666666666646,193,222,29,ki_chroma
235,5,104.01066666666665,165.96266666666665,61.952,222,354,132,ki_chroma
235,6,165.96266666666665,173.94133333333332,7.978666666666669,354,371,17,ki_chroma
235,7,173.94133333333332,187.08266666666665,13.141333333333336,371,399,28,ki_chroma
235,8,187.08266666666665,218.99733333333333,31.914666666666676,399,467,68,ki_chroma
235,9,218.99733333333333,236.112,17.114666666666665,467,502,35,ki_chroma
235,1,0.0,43.46666666666667,43.46666666666667,0,93,93,ki_chroma_acts
235,2,43.46666666666667,90.4,46.93333333333334,93,193,100,ki_chroma_acts
235,3,90.4,104.01066666666665,13.610666666666646,193,222,29,ki_chroma_acts
235,4,104.01066666666665,150.944,46.93333333333334,222,322,100,ki_chroma_acts
235,5,150.944,165.96266666666665,15.018666666666661,322,354,32,ki_chroma_acts
235,6,165.96266666666665,173.94133333333332,7.978666666666669,354,371,17,ki_chroma_acts
235,7,173.94133333333332,187.08266666666665,13.141333333333336,371,399,28,ki_chroma_acts
235,8,187.08266666666665,218.99733333333333,31.914666666666676,399,467,68,ki_chroma_acts
235,9,218.99733333333333,236.112,17.114666666666665,467,502,35,ki_chroma_acts
235,1,0.0,43.46666666666667,43.46666666666667,0,93,93,ki_chroma_acts_smoothed
235,2,43.46666666666667,90.4,46.93333333333334,93,193,100,ki_chroma_acts_smoothed
235,3,90.4,104.01066666666665,13.610666666666646,193,222,29,ki_chroma_acts_smoothed
235,4,104.01066666666665,150.944,46.93333333333334,222,322,100,ki_chroma_acts_smoothed
235,5,150.944,165.96266666666665,15.018666666666661,322,354,32,ki_chroma_acts_smoothed
235,6,165.96266666666665,173.94133333333332,7.978666666666669,354,371,17,ki_chroma_acts_smoothed
235,7,173.94133333333332,187.08266666666665,13.141333333333336,371,399,28,ki_chroma_acts_smoothed
235,8,187.08266666666665,218.99733333333333,31.914666666666676,399,467,68,ki_chroma_acts_smoothed
235,9,218.99733333333333,236.112,17.114666666666665,467,502,35,ki_chroma_acts_smoothed
236,1,0.0,14.346666666666668,14.346666666666668,0,33,33,chromagram
236,2,14.346666666666668,41.674666666666674,27.328000000000007,33,94,61,chromagram
236,3,41.674666666666674,85.13066666666668,43.45600000000001,94,191,97,chromagram
236,4,85.13066666666668,91.85066666666668,6.719999999999999,191,206,15,chromagram
236,5,91.85066666666668,99.01866666666668,7.167999999999992,206,222,16,chromagram
236,6,99.01866666666668,141.5786666666667,42.56000000000002,222,317,95,chromagram
236,7,141.5786666666667,169.80266666666668,28.22399999999999,317,380,63,chromagram
236,8,169.80266666666668,240.5866666666667,70.78400000000002,380,538,158,chromagram
236,9,240.5866666666667,269.123,28.53633333333329,538,600,62,chromagram
236,1,0.0,14.346666666666668,14.346666666666668,0,33,33,chroma_acts
236,2,14.346666666666668,41.674666666666674,27.328000000000007,33,94,61,chroma_acts
236,3,41.674666666666674,85.13066666666668,43.45600000000001,94,191,97,chroma_acts
236,4,85.13066666666668,91.85066666666668,6.719999999999999,191,206,15,chroma_acts
236,5,91.85066666666668,99.01866666666668,7.167999999999992,206,222,16,chroma_acts
236,6,99.01866666666668,141.5786666666667,42.56000000000002,222,317,95,chroma_acts
236,7,141.5786666666667,169.80266666666668,28.22399999999999,317,380,63,chroma_acts
236,8,169.80266666666668,244.1706666666667,74.36800000000002,380,546,166,chroma_acts
236,9,244.1706666666667,269.123,24.952333333333286,546,600,54,chroma_acts
236,1,0.0,14.794666666666668,14.794666666666668,0,34,34,chroma_acts_smoothed
236,2,14.794666666666668,41.674666666666674,26.880000000000006,34,94,60,chroma_acts_smoothed
236,3,41.674666666666674,85.57866666666668,43.904,94,192,98,chroma_acts_smoothed
236,4,85.57866666666668,91.40266666666668,5.823999999999998,192,205,13,chroma_acts_smoothed
236,5,91.40266666666668,99.01866666666668,7.616,205,222,17,chroma_acts_smoothed
236,6,99.01866666666668,142.0266666666667,43.008000000000024,222,318,96,chroma_acts_smoothed
236,7,142.0266666666667,169.80266666666668,27.775999999999982,318,380,62,chroma_acts_smoothed
236,8,169.80266666666668,239.69066666666671,69.88800000000003,380,536,156,chroma_acts_smoothed
236,9,239.69066666666671,269.123,29.432333333333276,536,600,64,chroma_acts_smoothed
236,1,0.0,14.346666666666668,14.346666666666668,0,33,33,ki_chroma
236,2,14.346666666666668,41.674666666666674,27.328000000000007,33,94,61,ki_chroma
236,3,41.674666666666674,85.13066666666668,43.45600000000001,94,191,97,ki_chroma
236,4,85.13066666666668,91.85066666666668,6.719999999999999,191,206,15,ki_chroma
236,5,91.85066666666668,99.01866666666668,7.167999999999992,206,222,16,ki_chroma
236,6,99.01866666666668,141.5786666666667,42.56000000000002,222,317,95,ki_chroma
236,7,141.5786666666667,169.80266666666668,28.22399999999999,317,380,63,ki_chroma
236,8,169.80266666666668,240.5866666666667,70.78400000000002,380,538,158,ki_chroma
236,9,240.5866666666667,269.123,28.53633333333329,538,600,62,ki_chroma
236,1,0.0,14.346666666666668,14.346666666666668,0,33,33,ki_chroma_acts
236,2,14.346666666666668,41.674666666666674,27.328000000000007,33,94,61,ki_chroma_acts
236,3,41.674666666666674,85.13066666666668,43.45600000000001,94,191,97,ki_chroma_acts
236,4,85.13066666666668,91.85066666666668,6.719999999999999,191,206,15,ki_chroma_acts
236,5,91.85066666666668,99.01866666666668,7.167999999999992,206,222,16,ki_chroma_acts
236,6,99.01866666666668,141.5786666666667,42.56000000000002,222,317,95,ki_chroma_acts
236,7,141.5786666666667,169.80266666666668,28.22399999999999,317,380,63,ki_chroma_acts
236,8,169.80266666666668,244.1706666666667,74.36800000000002,380,546,166,ki_chroma_acts
236,9,244.1706666666667,269.123,24.952333333333286,546,600,54,ki_chroma_acts
236,1,0.0,14.794666666666668,14.794666666666668,0,34,34,ki_chroma_acts_smoothed
236,2,14.794666666666668,41.674666666666674,26.880000000000006,34,94,60,ki_chroma_acts_smoothed
236,3,41.674666666666674,85.57866666666668,43.904,94,192,98,ki_chroma_acts_smoothed
236,4,85.57866666666668,91.40266666666668,5.823999999999998,192,205,13,ki_chroma_acts_smoothed
236,5,91.40266666666668,99.01866666666668,7.616,205,222,17,ki_chroma_acts_smoothed
236,6,99.01866666666668,142.0266666666667,43.008000000000024,222,318,96,ki_chroma_acts_smoothed
236,7,142.0266666666667,169.80266666666668,27.775999999999982,318,380,62,ki_chroma_acts_smoothed
236,8,169.80266666666668,239.69066666666671,69.88800000000003,380,536,156,ki_chroma_acts_smoothed
236,9,239.69066666666671,269.123,29.432333333333276,536,600,64,ki_chroma_acts_smoothed
239,1,0.0,19.082666666666668,19.082666666666668,0,48,48,chromagram
239,2,19.082666666666668,64.07466666666667,44.992000000000004,48,159,111,chromagram
239,3,64.07466666666667,71.37066666666666,7.295999999999992,159,177,18,chromagram
239,4,71.37066666666666,92.85333333333334,21.482666666666674,177,230,53,chromagram
239,5,92.85333333333334,96.90666666666667,4.0533333333333275,230,240,10,chromagram
239,6,96.90666666666667,121.632,24.72533333333334,240,301,61,chromagram
239,7,121.632,129.33333333333334,7.701333333333338,301,320,19,chromagram
239,8,129.33333333333334,155.2746666666667,25.941333333333347,320,384,64,chromagram
239,9,155.2746666666667,164.541,9.266333333333307,384,405,21,chromagram
239,1,0.0,19.082666666666668,19.082666666666668,0,48,48,chroma_acts
239,2,19.082666666666668,64.07466666666667,44.992000000000004,48,159,111,chroma_acts
239,3,64.07466666666667,71.37066666666666,7.295999999999992,159,177,18,chroma_acts
239,4,71.37066666666666,79.88266666666667,8.512,177,198,21,chroma_acts
239,5,79.88266666666667,92.85333333333334,12.970666666666673,198,230,32,chroma_acts
239,6,92.85333333333334,121.632,28.778666666666666,230,301,71,chroma_acts
239,7,121.632,128.11733333333333,6.48533333333333,301,317,16,chroma_acts
239,8,128.11733333333333,155.2746666666667,27.157333333333355,317,384,67,chroma_acts
239,9,155.2746666666667,164.541,9.266333333333307,384,405,21,chroma_acts
239,1,0.0,19.082666666666668,19.082666666666668,0,48,48,chroma_acts_smoothed
239,2,19.082666666666668,64.07466666666667,44.992000000000004,48,159,111,chroma_acts_smoothed
239,3,64.07466666666667,71.37066666666666,7.295999999999992,159,177,18,chroma_acts_smoothed
239,4,71.37066666666666,84.34133333333334,12.970666666666673,177,209,32,chroma_acts_smoothed
239,5,84.34133333333334,92.85333333333334,8.512,209,230,21,chroma_acts_smoothed
239,6,92.85333333333334,121.632,28.778666666666666,230,301,71,chroma_acts_smoothed
239,7,121.632,128.11733333333333,6.48533333333333,301,317,16,chroma_acts_smoothed
239,8,128.11733333333333,155.2746666666667,27.157333333333355,317,384,67,chroma_acts_smoothed
239,9,155.2746666666667,164.541,9.266333333333307,384,405,21,chroma_acts_smoothed
239,1,0.0,19.082666666666668,19.082666666666668,0,48,48,ki_chroma
239,2,19.082666666666668,64.07466666666667,44.992000000000004,48,159,111,ki_chroma
239,3,64.07466666666667,71.37066666666666,7.295999999999992,159,177,18,ki_chroma
239,4,71.37066666666666,92.85333333333334,21.482666666666674,177,230,53,ki_chroma
239,5,92.85333333333334,96.90666666666667,4.0533333333333275,230,240,10,ki_chroma
239,6,96.90666666666667,121.632,24.72533333333334,240,301,61,ki_chroma
239,7,121.632,129.33333333333334,7.701333333333338,301,320,19,ki_chroma
239,8,129.33333333333334,155.2746666666667,25.941333333333347,320,384,64,ki_chroma
239,9,155.2746666666667,164.541,9.266333333333307,384,405,21,ki_chroma
239,1,0.0,19.082666666666668,19.082666666666668,0,48,48,ki_chroma_acts
239,2,19.082666666666668,64.07466666666667,44.992000000000004,48,159,111,ki_chroma_acts
239,3,64.07466666666667,71.37066666666666,7.295999999999992,159,177,18,ki_chroma_acts
239,4,71.37066666666666,79.88266666666667,8.512,177,198,21,ki_chroma_acts
239,5,79.88266666666667,92.85333333333334,12.970666666666673,198,230,32,ki_chroma_acts
239,6,92.85333333333334,121.632,28.778666666666666,230,301,71,ki_chroma_acts
239,7,121.632,128.11733333333333,6.48533333333333,301,317,16,ki_chroma_acts
239,8,128.11733333333333,155.2746666666667,27.157333333333355,317,384,67,ki_chroma_acts
239,9,155.2746666666667,164.541,9.266333333333307,384,405,21,ki_chroma_acts
239,1,0.0,19.082666666666668,19.082666666666668,0,48,48,ki_chroma_acts_smoothed
239,2,19.082666666666668,64.07466666666667,44.992000000000004,48,159,111,ki_chroma_acts_smoothed
239,3,64.07466666666667,71.37066666666666,7.295999999999992,159,177,18,ki_chroma_acts_smoothed
239,4,71.37066666666666,84.34133333333334,12.970666666666673,177,209,32,ki_chroma_acts_smoothed
239,5,84.34133333333334,92.85333333333334,8.512,209,230,21,ki_chroma_acts_smoothed
239,6,92.85333333333334,121.632,28.778666666666666,230,301,71,ki_chroma_acts_smoothed
239,7,121.632,128.11733333333333,6.48533333333333,301,317,16,ki_chroma_acts_smoothed
239,8,128.11733333333333,155.2746666666667,27.157333333333355,317,384,67,ki_chroma_acts_smoothed
239,9,155.2746666666667,164.541,9.266333333333307,384,405,21,ki_chroma_acts_smoothed
240,1,0.0,32.192,32.192,0,68,68,chromagram
240,2,32.192,78.27199999999999,46.07999999999999,68,164,96,chromagram
240,3,78.27199999999999,81.63199999999999,3.3599999999999994,164,171,7,chromagram
240,4,81.63199999999999,84.512,2.8800000000000097,171,177,6,chromagram
240,5,84.512,89.312,4.799999999999997,177,187,10,chromagram
240,6,89.312,92.192,2.8799999999999955,187,193,6,chromagram
240,7,92.192,97.472,5.280000000000001,193,204,11,chromagram
240,8,97.472,106.592,9.120000000000005,204,223,19,chromagram
240,9,106.592,156.51,49.91799999999999,223,325,102,chromagram
240,1,0.0,32.192,32.192,0,68,68,chroma_acts
240,2,32.192,78.27199999999999,46.07999999999999,68,164,96,chroma_acts
240,3,78.27199999999999,81.63199999999999,3.3599999999999994,164,171,7,chroma_acts
240,4,81.63199999999999,84.512,2.8800000000000097,171,177,6,chroma_acts
240,5,84.512,89.312,4.799999999999997,177,187,10,chroma_acts
240,6,89.312,92.192,2.8799999999999955,187,193,6,chroma_acts
240,7,92.192,108.512,16.320000000000007,193,227,34,chroma_acts
240,8,108.512,141.152,32.639999999999986,227,295,68,chroma_acts
240,9,141.152,156.51,15.358000000000004,295,325,30,chroma_acts
240,1,0.0,24.512,24.512,0,52,52,chroma_acts_smoothed
240,2,24.512,32.192,7.68,52,68,16,chroma_acts_smoothed
240,3,32.192,81.63199999999999,49.43999999999999,68,171,103,chroma_acts_smoothed
240,4,81.63199999999999,84.512,2.8800000000000097,171,177,6,chroma_acts_smoothed
240,5,84.512,89.312,4.799999999999997,177,187,10,chroma_acts_smoothed
240,6,89.312,92.192,2.8799999999999955,187,193,6,chroma_acts_smoothed
240,7,92.192,108.512,16.320000000000007,193,227,34,chroma_acts_smoothed
240,8,108.512,141.152,32.639999999999986,227,295,68,chroma_acts_smoothed
240,9,141.152,156.51,15.358000000000004,295,325,30,chroma_acts_smoothed
240,1,0.0,32.192,32.192,0,68,68,ki_chroma
240,2,32.192,78.27199999999999,46.07999999999999,68,164,96,ki_chroma
240,3,78.27199999999999,81.63199999999999,3.3599999999999994,164,171,7,ki_chroma
240,4,81.63199999999999,84.512,2.8800000000000097,171,177,6,ki_chroma
240,5,84.512,89.312,4.799999999999997,177,187,10,ki_chroma
240,6,89.312,92.192,2.8799999999999955,187,193,6,ki_chroma
240,7,92.192,97.472,5.280000000000001,193,204,11,ki_chroma
240,8,97.472,106.592,9.120000000000005,204,223,19,ki_chroma
240,9,106.592,156.51,49.91799999999999,223,325,102,ki_chroma
240,1,0.0,32.192,32.192,0,68,68,ki_chroma_acts
240,2,32.192,78.27199999999999,46.07999999999999,68,164,96,ki_chroma_acts
240,3,78.27199999999999,81.63199999999999,3.3599999999999994,164,171,7,ki_chroma_acts
240,4,81.63199999999999,84.512,2.8800000000000097,171,177,6,ki_chroma_acts
240,5,84.512,89.312,4.799999999999997,177,187,10,ki_chroma_acts
240,6,89.312,92.192,2.8799999999999955,187,193,6,ki_chroma_acts
240,7,92.192,108.512,16.320000000000007,193,227,34,ki_chroma_acts
240,8,108.512,141.152,32.639999999999986,227,295,68,ki_chroma_acts
240,9,141.152,156.51,15.358000000000004,295,325,30,ki_chroma_acts
240,1,0.0,24.512,24.512,0,52,52,ki_chroma_acts_smoothed
240,2,24.512,32.192,7.68,52,68,16,ki_chroma_acts_smoothed
240,3,32.192,81.63199999999999,49.43999999999999,68,171,103,ki_chroma_acts_smoothed
240,4,81.63199999999999,84.512,2.8800000000000097,171,177,6,ki_chroma_acts_smoothed
240,5,84.512,89.312,4.799999999999997,177,187,10,ki_chroma_acts_smoothed
240,6,89.312,92.192,2.8799999999999955,187,193,6,ki_chroma_acts_smoothed
240,7,92.192,108.512,16.320000000000007,193,227,34,ki_chroma_acts_smoothed
240,8,108.512,141.152,32.639999999999986,227,295,68,ki_chroma_acts_smoothed
240,9,141.152,156.51,15.358000000000004,295,325,30,ki_chroma_acts_smoothed
241,1,0.0,15.274666666666667,15.274666666666667,0,33,33,chromagram
241,2,15.274666666666667,28.416,13.141333333333334,33,61,28,chromagram
241,3,28.416,45.312,16.895999999999997,61,97,36,chromagram
241,4,45.312,90.368,45.056,97,193,96,chromagram
241,5,90.368,112.42666666666666,22.058666666666667,193,240,47,chromagram
241,6,112.42666666666666,124.16,11.733333333333334,240,265,25,chromagram
241,7,124.16,145.28,21.120000000000005,265,310,45,chromagram
241,8,145.28,157.48266666666666,12.202666666666659,310,336,26,chromagram
241,9,157.48266666666666,233.195,75.71233333333333,336,496,160,chromagram
241,1,0.0,15.274666666666667,15.274666666666667,0,33,33,chroma_acts
241,2,15.274666666666667,28.416,13.141333333333334,33,61,28,chroma_acts
241,3,28.416,45.312,16.895999999999997,61,97,36,chroma_acts
241,4,45.312,90.368,45.056,97,193,96,chroma_acts
241,5,90.368,112.42666666666666,22.058666666666667,193,240,47,chroma_acts
241,6,112.42666666666666,124.16,11.733333333333334,240,265,25,chroma_acts
241,7,124.16,145.28,21.120000000000005,265,310,45,chroma_acts
241,8,145.28,157.48266666666666,12.202666666666659,310,336,26,chroma_acts
241,9,157.48266666666666,233.195,75.71233333333333,336,496,160,chroma_acts
241,1,0.0,15.274666666666667,15.274666666666667,0,33,33,chroma_acts_smoothed
241,2,15.274666666666667,28.88533333333333,13.610666666666665,33,62,29,chroma_acts_smoothed
241,3,28.88533333333333,45.312,16.426666666666666,62,97,35,chroma_acts_smoothed
241,4,45.312,90.368,45.056,97,193,96,chroma_acts_smoothed
241,5,90.368,112.42666666666666,22.058666666666667,193,240,47,chroma_acts_smoothed
241,6,112.42666666666666,124.16,11.733333333333334,240,265,25,chroma_acts_smoothed
241,7,124.16,145.74933333333334,21.589333333333343,265,311,46,chroma_acts_smoothed
241,8,145.74933333333334,157.48266666666666,11.73333333333332,311,336,25,chroma_acts_smoothed
241,9,157.48266666666666,233.195,75.71233333333333,336,496,160,chroma_acts_smoothed
241,1,0.0,15.274666666666667,15.274666666666667,0,33,33,ki_chroma
241,2,15.274666666666667,28.416,13.141333333333334,33,61,28,ki_chroma
241,3,28.416,45.312,16.895999999999997,61,97,36,ki_chroma
241,4,45.312,90.368,45.056,97,193,96,ki_chroma
241,5,90.368,112.42666666666666,22.058666666666667,193,240,47,ki_chroma
241,6,112.42666666666666,124.16,11.733333333333334,240,265,25,ki_chroma
241,7,124.16,145.28,21.120000000000005,265,310,45,ki_chroma
241,8,145.28,157.48266666666666,12.202666666666659,310,336,26,ki_chroma
241,9,157.48266666666666,233.195,75.71233333333333,336,496,160,ki_chroma
241,1,0.0,15.274666666666667,15.274666666666667,0,33,33,ki_chroma_acts
241,2,15.274666666666667,28.416,13.141333333333334,33,61,28,ki_chroma_acts
241,3,28.416,45.312,16.895999999999997,61,97,36,ki_chroma_acts
241,4,45.312,90.368,45.056,97,193,96,ki_chroma_acts
241,5,90.368,112.42666666666666,22.058666666666667,193,240,47,ki_chroma_acts
241,6,112.42666666666666,124.16,11.733333333333334,240,265,25,ki_chroma_acts
241,7,124.16,145.28,21.120000000000005,265,310,45,ki_chroma_acts
241,8,145.28,157.48266666666666,12.202666666666659,310,336,26,ki_chroma_acts
241,9,157.48266666666666,233.195,75.71233333333333,336,496,160,ki_chroma_acts
241,1,0.0,15.274666666666667,15.274666666666667,0,33,33,ki_chroma_acts_smoothed
241,2,15.274666666666667,28.88533333333333,13.610666666666665,33,62,29,ki_chroma_acts_smoothed
241,3,28.88533333333333,45.312,16.426666666666666,62,97,35,ki_chroma_acts_smoothed
241,4,45.312,90.368,45.056,97,193,96,ki_chroma_acts_smoothed
241,5,90.368,112.42666666666666,22.058666666666667,193,240,47,ki_chroma_acts_smoothed
241,6,112.42666666666666,124.16,11.733333333333334,240,265,25,ki_chroma_acts_smoothed
241,7,124.16,145.74933333333334,21.589333333333343,265,311,46,ki_chroma_acts_smoothed
241,8,145.74933333333334,157.48266666666666,11.73333333333332,311,336,25,ki_chroma_acts_smoothed
241,9,157.48266666666666,233.195,75.71233333333333,336,496,160,ki_chroma_acts_smoothed
242,1,0.0,32.42666666666667,32.42666666666667,0,67,67,chromagram
242,2,32.42666666666667,39.296,6.86933333333333,67,81,14,chromagram
242,3,39.296,44.202666666666666,4.906666666666666,81,91,10,chromagram
242,4,44.202666666666666,54.99733333333333,10.794666666666664,91,113,22,chromagram
242,5,54.99733333333333,59.904,4.906666666666673,113,123,10,chromagram
242,6,59.904,117.31200000000001,57.40800000000001,123,240,117,chromagram
242,7,117.31200000000001,122.21866666666668,4.906666666666666,240,250,10,chromagram
242,8,122.21866666666668,133.01333333333335,10.794666666666672,250,272,22,chromagram
242,9,133.01333333333335,159.25,26.23666666666665,272,324,52,chromagram
242,1,0.0,39.296,39.296,0,81,81,chroma_acts
242,2,39.296,43.711999999999996,4.415999999999997,81,90,9,chroma_acts
242,3,43.711999999999996,54.99733333333333,11.285333333333334,90,113,23,chroma_acts
242,4,54.99733333333333,59.413333333333334,4.416000000000004,113,122,9,chroma_acts
242,5,59.413333333333334,117.31200000000001,57.89866666666668,122,240,118,chroma_acts
242,6,117.31200000000001,122.21866666666668,4.906666666666666,240,250,10,chroma_acts
242,7,122.21866666666668,133.01333333333335,10.794666666666672,250,272,22,chroma_acts
242,8,133.01333333333335,137.42933333333335,4.415999999999997,272,281,9,chroma_acts
242,9,137.42933333333335,159.25,21.820666666666654,281,324,43,chroma_acts
242,1,0.0,31.445333333333334,31.445333333333334,0,65,65,chroma_acts_smoothed
242,2,31.445333333333334,39.296,7.850666666666665,65,81,16,chroma_acts_smoothed
242,3,39.296,44.202666666666666,4.906666666666666,81,91,10,chroma_acts_smoothed
242,4,44.202666666666666,54.99733333333333,10.794666666666664,91,113,22,chroma_acts_smoothed
242,5,54.99733333333333,117.31200000000001,62.31466666666668,113,240,127,chroma_acts_smoothed
242,6,117.31200000000001,122.21866666666668,4.906666666666666,240,250,10,chroma_acts_smoothed
242,7,122.21866666666668,133.01333333333335,10.794666666666672,250,272,22,chroma_acts_smoothed
242,8,133.01333333333335,137.92000000000002,4.906666666666666,272,282,10,chroma_acts_smoothed
242,9,137.92000000000002,159.25,21.329999999999984,282,324,42,chroma_acts_smoothed
242,1,0.0,32.42666666666667,32.42666666666667,0,67,67,ki_chroma
242,2,32.42666666666667,39.296,6.86933333333333,67,81,14,ki_chroma
242,3,39.296,44.202666666666666,4.906666666666666,81,91,10,ki_chroma
242,4,44.202666666666666,54.99733333333333,10.794666666666664,91,113,22,ki_chroma
242,5,54.99733333333333,59.904,4.906666666666673,113,123,10,ki_chroma
242,6,59.904,117.31200000000001,57.40800000000001,123,240,117,ki_chroma
242,7,117.31200000000001,122.21866666666668,4.906666666666666,240,250,10,ki_chroma
242,8,122.21866666666668,133.01333333333335,10.794666666666672,250,272,22,ki_chroma
242,9,133.01333333333335,159.25,26.23666666666665,272,324,52,ki_chroma
242,1,0.0,39.296,39.296,0,81,81,ki_chroma_acts
242,2,39.296,43.711999999999996,4.415999999999997,81,90,9,ki_chroma_acts
242,3,43.711999999999996,54.99733333333333,11.285333333333334,90,113,23,ki_chroma_acts
242,4,54.99733333333333,59.413333333333334,4.416000000000004,113,122,9,ki_chroma_acts
242,5,59.413333333333334,117.31200000000001,57.89866666666668,122,240,118,ki_chroma_acts
242,6,117.31200000000001,122.21866666666668,4.906666666666666,240,250,10,ki_chroma_acts
242,7,122.21866666666668,133.01333333333335,10.794666666666672,250,272,22,ki_chroma_acts
242,8,133.01333333333335,137.42933333333335,4.415999999999997,272,281,9,ki_chroma_acts
242,9,137.42933333333335,159.25,21.820666666666654,281,324,43,ki_chroma_acts
242,1,0.0,31.445333333333334,31.445333333333334,0,65,65,ki_chroma_acts_smoothed
242,2,31.445333333333334,39.296,7.850666666666665,65,81,16,ki_chroma_acts_smoothed
242,3,39.296,44.202666666666666,4.906666666666666,81,91,10,ki_chroma_acts_smoothed
242,4,44.202666666666666,54.99733333333333,10.794666666666664,91,113,22,ki_chroma_acts_smoothed
242,5,54.99733333333333,117.31200000000001,62.31466666666668,113,240,127,ki_chroma_acts_smoothed
242,6,117.31200000000001,122.21866666666668,4.906666666666666,240,250,10,ki_chroma_acts_smoothed
242,7,122.21866666666668,133.01333333333335,10.794666666666672,250,272,22,ki_chroma_acts_smoothed
242,8,133.01333333333335,137.92000000000002,4.906666666666666,272,282,10,ki_chroma_acts_smoothed
242,9,137.92000000000002,159.25,21.329999999999984,282,324,42,ki_chroma_acts_smoothed
243,1,0.0,7.658666666666667,7.658666666666667,0,17,17,chromagram
243,2,7.658666666666667,13.290666666666667,5.632,17,29,12,chromagram
243,3,13.290666666666667,52.714666666666666,39.424,29,113,84,chromagram
243,4,52.714666666666666,79.46666666666667,26.752000000000002,113,170,57,chromagram
243,5,79.46666666666667,81.344,1.8773333333333255,170,174,4,chromagram
243,6,81.344,151.2746666666667,69.9306666666667,174,323,149,chromagram
243,7,151.2746666666667,166.29333333333335,15.018666666666661,323,355,32,chromagram
243,8,166.29333333333335,178.02666666666667,11.73333333333332,355,380,25,chromagram
243,9,178.02666666666667,197.583,19.556333333333328,380,420,40,chromagram
243,1,0.0,52.714666666666666,52.714666666666666,0,113,113,chroma_acts
243,2,52.714666666666666,66.32533333333333,13.610666666666667,113,142,29,chroma_acts
243,3,66.32533333333333,79.46666666666667,13.141333333333336,142,170,28,chroma_acts
243,4,79.46666666666667,81.344,1.8773333333333255,170,174,4,chroma_acts
243,5,81.344,151.2746666666667,69.9306666666667,174,323,149,chroma_acts
243,6,151.2746666666667,164.416,13.141333333333307,323,351,28,chroma_acts
243,7,164.416,166.29333333333335,1.877333333333354,351,355,4,chroma_acts
243,8,166.29333333333335,178.02666666666667,11.73333333333332,355,380,25,chroma_acts
243,9,178.02666666666667,197.583,19.556333333333328,380,420,40,chroma_acts
243,1,0.0,7.658666666666667,7.658666666666667,0,17,17,chroma_acts_smoothed
243,2,7.658666666666667,20.8,13.141333333333334,17,45,28,chroma_acts_smoothed
243,3,20.8,52.714666666666666,31.914666666666665,45,113,68,chroma_acts_smoothed
243,4,52.714666666666666,79.46666666666667,26.752000000000002,113,170,57,chroma_acts_smoothed
243,5,79.46666666666667,107.62666666666667,28.159999999999997,170,230,60,chroma_acts_smoothed
243,6,107.62666666666667,151.2746666666667,43.648000000000025,230,323,93,chroma_acts_smoothed
243,7,151.2746666666667,166.29333333333335,15.018666666666661,323,355,32,chroma_acts_smoothed
243,8,166.29333333333335,178.02666666666667,11.73333333333332,355,380,25,chroma_acts_smoothed
243,9,178.02666666666667,197.583,19.556333333333328,380,420,40,chroma_acts_smoothed
243,1,0.0,7.658666666666667,7.658666666666667,0,17,17,ki_chroma
243,2,7.658666666666667,13.290666666666667,5.632,17,29,12,ki_chroma
243,3,13.290666666666667,52.714666666666666,39.424,29,113,84,ki_chroma
243,4,52.714666666666666,79.46666666666667,26.752000000000002,113,170,57,ki_chroma
243,5,79.46666666666667,81.344,1.8773333333333255,170,174,4,ki_chroma
243,6,81.344,151.2746666666667,69.9306666666667,174,323,149,ki_chroma
243,7,151.2746666666667,166.29333333333335,15.018666666666661,323,355,32,ki_chroma
243,8,166.29333333333335,178.02666666666667,11.73333333333332,355,380,25,ki_chroma
243,9,178.02666666666667,197.583,19.556333333333328,380,420,40,ki_chroma
243,1,0.0,52.714666666666666,52.714666666666666,0,113,113,ki_chroma_acts
243,2,52.714666666666666,66.32533333333333,13.610666666666667,113,142,29,ki_chroma_acts
243,3,66.32533333333333,79.46666666666667,13.141333333333336,142,170,28,ki_chroma_acts
243,4,79.46666666666667,81.344,1.8773333333333255,170,174,4,ki_chroma_acts
243,5,81.344,151.2746666666667,69.9306666666667,174,323,149,ki_chroma_acts
243,6,151.2746666666667,164.416,13.141333333333307,323,351,28,ki_chroma_acts
243,7,164.416,166.29333333333335,1.877333333333354,351,355,4,ki_chroma_acts
243,8,166.29333333333335,178.02666666666667,11.73333333333332,355,380,25,ki_chroma_acts
243,9,178.02666666666667,197.583,19.556333333333328,380,420,40,ki_chroma_acts
243,1,0.0,7.658666666666667,7.658666666666667,0,17,17,ki_chroma_acts_smoothed
243,2,7.658666666666667,20.8,13.141333333333334,17,45,28,ki_chroma_acts_smoothed
243,3,20.8,52.714666666666666,31.914666666666665,45,113,68,ki_chroma_acts_smoothed
243,4,52.714666666666666,79.46666666666667,26.752000000000002,113,170,57,ki_chroma_acts_smoothed
243,5,79.46666666666667,107.62666666666667,28.159999999999997,170,230,60,ki_chroma_acts_smoothed
243,6,107.62666666666667,151.2746666666667,43.648000000000025,230,323,93,ki_chroma_acts_smoothed
243,7,151.2746666666667,166.29333333333335,15.018666666666661,323,355,32,ki_chroma_acts_smoothed
243,8,166.29333333333335,178.02666666666667,11.73333333333332,355,380,25,ki_chroma_acts_smoothed
243,9,178.02666666666667,197.583,19.556333333333328,380,420,40,ki_chroma_acts_smoothed
249,1,0.0,51.11466666666666,51.11466666666666,0,112,112,chromagram
249,2,51.11466666666666,78.176,27.061333333333344,112,171,59,chromagram
249,3,78.176,93.77066666666666,15.594666666666654,171,205,34,chromagram
249,4,93.77066666666666,110.74133333333333,16.970666666666673,205,242,37,chromagram
249,5,110.74133333333333,123.58399999999999,12.84266666666666,242,270,28,chromagram
249,6,123.58399999999999,127.25333333333333,3.6693333333333413,270,278,8,chromagram
249,7,127.25333333333333,151.10399999999998,23.850666666666655,278,330,52,chromagram
249,8,151.10399999999998,153.3973333333333,2.2933333333333223,330,335,5,chromagram
249,9,153.3973333333333,182.962,29.56466666666668,335,398,63,chromagram
249,1,0.0,51.11466666666666,51.11466666666666,0,112,112,chroma_acts
249,2,51.11466666666666,78.176,27.061333333333344,112,171,59,chroma_acts
249,3,78.176,93.77066666666666,15.594666666666654,171,205,34,chroma_acts
249,4,93.77066666666666,106.15466666666666,12.384,205,232,27,chroma_acts
249,5,106.15466666666666,111.19999999999999,5.045333333333332,232,243,11,chroma_acts
249,6,111.19999999999999,123.58399999999999,12.384,243,270,27,chroma_acts
249,7,123.58399999999999,151.10399999999998,27.519999999999996,270,330,60,chroma_acts
249,8,151.10399999999998,153.3973333333333,2.2933333333333223,330,335,5,chroma_acts
249,9,153.3973333333333,182.962,29.56466666666668,335,398,63,chroma_acts
249,1,0.0,51.11466666666666,51.11466666666666,0,112,112,chroma_acts_smoothed
249,2,51.11466666666666,77.71733333333333,26.60266666666667,112,170,58,chroma_acts_smoothed
249,3,77.71733333333333,93.77066666666666,16.053333333333327,170,205,35,chroma_acts_smoothed
249,4,93.77066666666666,106.15466666666666,12.384,205,232,27,chroma_acts_smoothed
249,5,106.15466666666666,111.19999999999999,5.045333333333332,232,243,11,chroma_acts_smoothed
249,6,111.19999999999999,123.12533333333333,11.925333333333342,243,269,26,chroma_acts_smoothed
249,7,123.12533333333333,151.10399999999998,27.978666666666655,269,330,61,chroma_acts_smoothed
249,8,151.10399999999998,152.93866666666665,1.8346666666666636,330,334,4,chroma_acts_smoothed
249,9,152.93866666666665,182.962,30.02333333333334,334,398,64,chroma_acts_smoothed
249,1,0.0,51.11466666666666,51.11466666666666,0,112,112,ki_chroma
249,2,51.11466666666666,78.176,27.061333333333344,112,171,59,ki_chroma
249,3,78.176,93.77066666666666,15.594666666666654,171,205,34,ki_chroma
249,4,93.77066666666666,110.74133333333333,16.970666666666673,205,242,37,ki_chroma
249,5,110.74133333333333,123.58399999999999,12.84266666666666,242,270,28,ki_chroma
249,6,123.58399999999999,127.25333333333333,3.6693333333333413,270,278,8,ki_chroma
249,7,127.25333333333333,151.10399999999998,23.850666666666655,278,330,52,ki_chroma
249,8,151.10399999999998,153.3973333333333,2.2933333333333223,330,335,5,ki_chroma
249,9,153.3973333333333,182.962,29.56466666666668,335,398,63,ki_chroma
249,1,0.0,51.11466666666666,51.11466666666666,0,112,112,ki_chroma_acts
249,2,51.11466666666666,78.176,27.061333333333344,112,171,59,ki_chroma_acts
249,3,78.176,93.77066666666666,15.594666666666654,171,205,34,ki_chroma_acts
249,4,93.77066666666666,106.15466666666666,12.384,205,232,27,ki_chroma_acts
249,5,106.15466666666666,111.19999999999999,5.045333333333332,232,243,11,ki_chroma_acts
249,6,111.19999999999999,123.58399999999999,12.384,243,270,27,ki_chroma_acts
249,7,123.58399999999999,151.10399999999998,27.519999999999996,270,330,60,ki_chroma_acts
249,8,151.10399999999998,153.3973333333333,2.2933333333333223,330,335,5,ki_chroma_acts
249,9,153.3973333333333,182.962,29.56466666666668,335,398,63,ki_chroma_acts
249,1,0.0,51.11466666666666,51.11466666666666,0,112,112,ki_chroma_acts_smoothed
249,2,51.11466666666666,77.71733333333333,26.60266666666667,112,170,58,ki_chroma_acts_smoothed
249,3,77.71733333333333,93.77066666666666,16.053333333333327,170,205,35,ki_chroma_acts_smoothed
249,4,93.77066666666666,106.15466666666666,12.384,205,232,27,ki_chroma_acts_smoothed
249,5,106.15466666666666,111.19999999999999,5.045333333333332,232,243,11,ki_chroma_acts_smoothed
249,6,111.19999999999999,123.12533333333333,11.925333333333342,243,269,26,ki_chroma_acts_smoothed
249,7,123.12533333333333,151.10399999999998,27.978666666666655,269,330,61,ki_chroma_acts_smoothed
249,8,151.10399999999998,152.93866666666665,1.8346666666666636,330,334,4,ki_chroma_acts_smoothed
249,9,152.93866666666665,182.962,30.02333333333334,334,398,64,ki_chroma_acts_smoothed
250,1,0.0,13.642666666666667,13.642666666666667,0,29,29,chromagram
250,2,13.642666666666667,59.242666666666665,45.599999999999994,29,124,95,chromagram
250,3,59.242666666666665,60.68266666666666,1.4399999999999977,124,127,3,chromagram
250,4,60.68266666666666,89.48266666666667,28.80000000000001,127,187,60,chromagram
250,5,89.48266666666667,104.84266666666667,15.36,187,219,32,chromagram
250,6,104.84266666666667,135.08266666666665,30.23999999999998,219,282,63,chromagram
250,7,135.08266666666665,137.00266666666664,1.9199999999999875,282,286,4,chromagram
250,8,137.00266666666664,149.48266666666666,12.480000000000018,286,312,26,chromagram
250,9,149.48266666666666,185.616,36.133333333333354,312,386,74,chromagram
250,1,0.0,13.642666666666667,13.642666666666667,0,29,29,chroma_acts
250,2,13.642666666666667,43.882666666666665,30.24,29,92,63,chroma_acts
250,3,43.882666666666665,45.80266666666667,1.9200000000000017,92,96,4,chroma_acts
250,4,45.80266666666667,59.242666666666665,13.439999999999998,96,124,28,chroma_acts
250,5,59.242666666666665,104.84266666666667,45.60000000000001,124,219,95,chroma_acts
250,6,104.84266666666667,135.08266666666665,30.23999999999998,219,282,63,chroma_acts
250,7,135.08266666666665,137.00266666666664,1.9199999999999875,282,286,4,chroma_acts
250,8,137.00266666666664,149.48266666666666,12.480000000000018,286,312,26,chroma_acts
250,9,149.48266666666666,185.616,36.133333333333354,312,386,74,chroma_acts
250,1,0.0,13.642666666666667,13.642666666666667,0,29,29,chroma_acts_smoothed
250,2,13.642666666666667,59.242666666666665,45.599999999999994,29,124,95,chroma_acts_smoothed
250,3,59.242666666666665,89.48266666666667,30.24000000000001,124,187,63,chroma_acts_smoothed
250,4,89.48266666666667,104.84266666666667,15.36,187,219,32,chroma_acts_smoothed
250,5,104.84266666666667,135.08266666666665,30.23999999999998,219,282,63,chroma_acts_smoothed
250,6,135.08266666666665,137.48266666666666,2.4000000000000057,282,287,5,chroma_acts_smoothed
250,7,137.48266666666666,149.96266666666665,12.47999999999999,287,313,26,chroma_acts_smoothed
250,8,149.96266666666665,152.84266666666664,2.8799999999999955,313,319,6,chroma_acts_smoothed
250,9,152.84266666666664,185.616,32.77333333333337,319,386,67,chroma_acts_smoothed
250,1,0.0,13.642666666666667,13.642666666666667,0,29,29,ki_chroma
250,2,13.642666666666667,59.242666666666665,45.599999999999994,29,124,95,ki_chroma
250,3,59.242666666666665,60.68266666666666,1.4399999999999977,124,127,3,ki_chroma
250,4,60.68266666666666,89.48266666666667,28.80000000000001,127,187,60,ki_chroma
250,5,89.48266666666667,104.84266666666667,15.36,187,219,32,ki_chroma
250,6,104.84266666666667,135.08266666666665,30.23999999999998,219,282,63,ki_chroma
250,7,135.08266666666665,137.00266666666664,1.9199999999999875,282,286,4,ki_chroma
250,8,137.00266666666664,149.48266666666666,12.480000000000018,286,312,26,ki_chroma
250,9,149.48266666666666,185.616,36.133333333333354,312,386,74,ki_chroma
250,1,0.0,13.642666666666667,13.642666666666667,0,29,29,ki_chroma_acts
250,2,13.642666666666667,43.882666666666665,30.24,29,92,63,ki_chroma_acts
250,3,43.882666666666665,45.80266666666667,1.9200000000000017,92,96,4,ki_chroma_acts
250,4,45.80266666666667,59.242666666666665,13.439999999999998,96,124,28,ki_chroma_acts
250,5,59.242666666666665,104.84266666666667,45.60000000000001,124,219,95,ki_chroma_acts
250,6,104.84266666666667,135.08266666666665,30.23999999999998,219,282,63,ki_chroma_acts
250,7,135.08266666666665,137.00266666666664,1.9199999999999875,282,286,4,ki_chroma_acts
250,8,137.00266666666664,149.48266666666666,12.480000000000018,286,312,26,ki_chroma_acts
250,9,149.48266666666666,185.616,36.133333333333354,312,386,74,ki_chroma_acts
250,1,0.0,13.642666666666667,13.642666666666667,0,29,29,ki_chroma_acts_smoothed
250,2,13.642666666666667,59.242666666666665,45.599999999999994,29,124,95,ki_chroma_acts_smoothed
250,3,59.242666666666665,89.48266666666667,30.24000000000001,124,187,63,ki_chroma_acts_smoothed
250,4,89.48266666666667,104.84266666666667,15.36,187,219,32,ki_chroma_acts_smoothed
250,5,104.84266666666667,135.08266666666665,30.23999999999998,219,282,63,ki_chroma_acts_smoothed
250,6,135.08266666666665,137.48266666666666,2.4000000000000057,282,287,5,ki_chroma_acts_smoothed
250,7,137.48266666666666,149.96266666666665,12.47999999999999,287,313,26,ki_chroma_acts_smoothed
250,8,149.96266666666665,152.84266666666664,2.8799999999999955,313,319,6,ki_chroma_acts_smoothed
250,9,152.84266666666664,185.616,32.77333333333337,319,386,67,ki_chroma_acts_smoothed
252,1,0.0,7.754666666666666,7.754666666666666,0,17,17,chromagram
252,2,7.754666666666666,22.154666666666664,14.399999999999999,17,47,30,chromagram
252,3,22.154666666666664,38.47466666666667,16.320000000000007,47,81,34,chromagram
252,4,38.47466666666667,68.71466666666666,30.239999999999988,81,144,63,chromagram
252,5,68.71466666666666,106.63466666666666,37.92,144,223,79,chromagram
252,6,106.63466666666666,138.31466666666665,31.679999999999993,223,289,66,chromagram
252,7,138.31466666666665,160.87466666666666,22.560000000000002,289,336,47,chromagram
252,8,160.87466666666666,171.91466666666665,11.039999999999992,336,359,23,chromagram
252,9,171.91466666666665,203.897,31.982333333333344,359,424,65,chromagram
252,1,0.0,37.51466666666667,37.51466666666667,0,79,79,chroma_acts
252,2,37.51466666666667,68.71466666666666,31.19999999999999,79,144,65,chroma_acts
252,3,68.71466666666666,99.91466666666666,31.200000000000003,144,209,65,chroma_acts
252,4,99.91466666666666,106.63466666666666,6.719999999999999,209,223,14,chroma_acts
252,5,106.63466666666666,138.31466666666665,31.679999999999993,223,289,66,chroma_acts
252,6,138.31466666666665,160.39466666666667,22.080000000000013,289,335,46,chroma_acts
252,7,160.39466666666667,172.87466666666666,12.47999999999999,335,361,26,chroma_acts
252,8,172.87466666666666,203.897,31.022333333333336,361,424,63,chroma_acts
252,1,0.0,29.354666666666663,29.354666666666663,0,62,62,chroma_acts_smoothed
252,2,29.354666666666663,68.71466666666666,39.36,62,144,82,chroma_acts_smoothed
252,3,68.71466666666666,100.39466666666667,31.680000000000007,144,210,66,chroma_acts_smoothed
252,4,100.39466666666667,106.63466666666666,6.239999999999995,210,223,13,chroma_acts_smoothed
252,5,106.63466666666666,137.83466666666666,31.200000000000003,223,288,65,chroma_acts_smoothed
252,6,137.83466666666666,160.39466666666667,22.560000000000002,288,335,47,chroma_acts_smoothed
252,7,160.39466666666667,172.87466666666666,12.47999999999999,335,361,26,chroma_acts_smoothed
252,8,172.87466666666666,203.897,31.022333333333336,361,424,63,chroma_acts_smoothed
252,1,0.0,7.754666666666666,7.754666666666666,0,17,17,ki_chroma
252,2,7.754666666666666,22.154666666666664,14.399999999999999,17,47,30,ki_chroma
252,3,22.154666666666664,38.47466666666667,16.320000000000007,47,81,34,ki_chroma
252,4,38.47466666666667,68.71466666666666,30.239999999999988,81,144,63,ki_chroma
252,5,68.71466666666666,106.63466666666666,37.92,144,223,79,ki_chroma
252,6,106.63466666666666,138.31466666666665,31.679999999999993,223,289,66,ki_chroma
252,7,138.31466666666665,160.87466666666666,22.560000000000002,289,336,47,ki_chroma
252,8,160.87466666666666,171.91466666666665,11.039999999999992,336,359,23,ki_chroma
252,9,171.91466666666665,203.897,31.982333333333344,359,424,65,ki_chroma
252,1,0.0,37.51466666666667,37.51466666666667,0,79,79,ki_chroma_acts
252,2,37.51466666666667,68.71466666666666,31.19999999999999,79,144,65,ki_chroma_acts
252,3,68.71466666666666,99.91466666666666,31.200000000000003,144,209,65,ki_chroma_acts
252,4,99.91466666666666,106.63466666666666,6.719999999999999,209,223,14,ki_chroma_acts
252,5,106.63466666666666,138.31466666666665,31.679999999999993,223,289,66,ki_chroma_acts
252,6,138.31466666666665,160.39466666666667,22.080000000000013,289,335,46,ki_chroma_acts
252,7,160.39466666666667,172.87466666666666,12.47999999999999,335,361,26,ki_chroma_acts
252,8,172.87466666666666,203.897,31.022333333333336,361,424,63,ki_chroma_acts
252,1,0.0,29.354666666666663,29.354666666666663,0,62,62,ki_chroma_acts_smoothed
252,2,29.354666666666663,68.71466666666666,39.36,62,144,82,ki_chroma_acts_smoothed
252,3,68.71466666666666,100.39466666666667,31.680000000000007,144,210,66,ki_chroma_acts_smoothed
252,4,100.39466666666667,106.63466666666666,6.239999999999995,210,223,13,ki_chroma_acts_smoothed
252,5,106.63466666666666,137.83466666666666,31.200000000000003,223,288,65,ki_chroma_acts_smoothed
252,6,137.83466666666666,160.39466666666667,22.560000000000002,288,335,47,ki_chroma_acts_smoothed
252,7,160.39466666666667,172.87466666666666,12.47999999999999,335,361,26,ki_chroma_acts_smoothed
252,8,172.87466666666666,203.897,31.022333333333336,361,424,63,ki_chroma_acts_smoothed
254,1,0.0,30.314666666666668,30.314666666666668,0,65,65,chromagram
254,2,30.314666666666668,58.00533333333333,27.690666666666665,65,124,59,chromagram
254,3,58.00533333333333,88.98133333333332,30.975999999999992,124,190,66,chromagram
254,4,88.98133333333332,121.36533333333333,32.384,190,259,69,chromagram
254,5,121.36533333333333,144.36266666666666,22.99733333333333,259,308,49,chromagram
254,6,144.36266666666666,169.70666666666665,25.343999999999994,308,362,54,chromagram
254,7,169.70666666666665,173.93066666666667,4.224000000000018,362,371,9,chromagram
254,8,173.93066666666667,204.667,30.736333333333334,371,435,64,chromagram
254,1,0.0,28.437333333333335,28.437333333333335,0,61,61,chroma_acts
254,2,28.437333333333335,30.314666666666668,1.8773333333333326,61,65,4,chroma_acts
254,3,30.314666666666668,58.00533333333333,27.690666666666665,65,124,59,chroma_acts
254,4,58.00533333333333,88.98133333333332,30.975999999999992,124,190,66,chroma_acts
254,5,88.98133333333332,121.36533333333333,32.384,190,259,69,chroma_acts
254,6,121.36533333333333,142.016,20.650666666666666,259,303,44,chroma_acts
254,7,142.016,173.93066666666667,31.914666666666676,303,371,68,chroma_acts
254,8,173.93066666666667,204.667,30.736333333333334,371,435,64,chroma_acts
254,1,0.0,28.437333333333335,28.437333333333335,0,61,61,chroma_acts_smoothed
254,2,28.437333333333335,30.314666666666668,1.8773333333333326,61,65,4,chroma_acts_smoothed
254,3,30.314666666666668,58.474666666666664,28.159999999999997,65,125,60,chroma_acts_smoothed
254,4,58.474666666666664,88.98133333333332,30.50666666666666,125,190,65,chroma_acts_smoothed
254,5,88.98133333333332,121.36533333333333,32.384,190,259,69,chroma_acts_smoothed
254,6,121.36533333333333,144.36266666666666,22.99733333333333,259,308,49,chroma_acts_smoothed
254,7,144.36266666666666,173.93066666666667,29.568000000000012,308,371,63,chroma_acts_smoothed
254,8,173.93066666666667,204.667,30.736333333333334,371,435,64,chroma_acts_smoothed
254,1,0.0,30.314666666666668,30.314666666666668,0,65,65,ki_chroma
254,2,30.314666666666668,58.00533333333333,27.690666666666665,65,124,59,ki_chroma
254,3,58.00533333333333,88.98133333333332,30.975999999999992,124,190,66,ki_chroma
254,4,88.98133333333332,121.36533333333333,32.384,190,259,69,ki_chroma
254,5,121.36533333333333,144.36266666666666,22.99733333333333,259,308,49,ki_chroma
254,6,144.36266666666666,169.70666666666665,25.343999999999994,308,362,54,ki_chroma
254,7,169.70666666666665,173.93066666666667,4.224000000000018,362,371,9,ki_chroma
254,8,173.93066666666667,204.667,30.736333333333334,371,435,64,ki_chroma
254,1,0.0,28.437333333333335,28.437333333333335,0,61,61,ki_chroma_acts
254,2,28.437333333333335,30.314666666666668,1.8773333333333326,61,65,4,ki_chroma_acts
254,3,30.314666666666668,58.00533333333333,27.690666666666665,65,124,59,ki_chroma_acts
254,4,58.00533333333333,88.98133333333332,30.975999999999992,124,190,66,ki_chroma_acts
254,5,88.98133333333332,121.36533333333333,32.384,190,259,69,ki_chroma_acts
254,6,121.36533333333333,142.016,20.650666666666666,259,303,44,ki_chroma_acts
254,7,142.016,173.93066666666667,31.914666666666676,303,371,68,ki_chroma_acts
254,8,173.93066666666667,204.667,30.736333333333334,371,435,64,ki_chroma_acts
254,1,0.0,28.437333333333335,28.437333333333335,0,61,61,ki_chroma_acts_smoothed
254,2,28.437333333333335,30.314666666666668,1.8773333333333326,61,65,4,ki_chroma_acts_smoothed
254,3,30.314666666666668,58.474666666666664,28.159999999999997,65,125,60,ki_chroma_acts_smoothed
254,4,58.474666666666664,88.98133333333332,30.50666666666666,125,190,65,ki_chroma_acts_smoothed
254,5,88.98133333333332,121.36533333333333,32.384,190,259,69,ki_chroma_acts_smoothed
254,6,121.36533333333333,144.36266666666666,22.99733333333333,259,308,49,ki_chroma_acts_smoothed
254,7,144.36266666666666,173.93066666666667,29.568000000000012,308,371,63,ki_chroma_acts_smoothed
254,8,173.93066666666667,204.667,30.736333333333334,371,435,64,ki_chroma_acts_smoothed
255,1,0.0,30.304,30.304,0,65,65,chromagram
255,2,30.304,76.768,46.464,65,164,99,chromagram
255,3,76.768,105.39733333333334,28.629333333333335,164,225,61,chromagram
255,4,105.39733333333334,106.80533333333334,1.4080000000000013,225,228,3,chromagram
255,5,106.80533333333334,122.29333333333334,15.488,228,261,33,chromagram
255,6,122.29333333333334,156.08533333333335,33.792000000000016,261,333,72,chromagram
255,7,156.08533333333335,159.37066666666666,3.2853333333333126,333,340,7,chromagram
255,8,159.37066666666666,190.727,31.35633333333334,340,405,65,chromagram
255,1,0.0,30.304,30.304,0,65,65,chroma_acts
255,2,30.304,71.60533333333333,41.30133333333333,65,153,88,chroma_acts
255,3,71.60533333333333,76.768,5.1626666666666665,153,164,11,chroma_acts
255,4,76.768,105.39733333333334,28.629333333333335,164,225,61,chroma_acts
255,5,105.39733333333334,106.80533333333334,1.4080000000000013,225,228,3,chroma_acts
255,6,106.80533333333334,122.29333333333334,15.488,228,261,33,chroma_acts
255,7,122.29333333333334,154.67733333333334,32.384,261,330,69,chroma_acts
255,8,154.67733333333334,190.727,36.04966666666667,330,405,75,chroma_acts
255,1,0.0,25.141333333333332,25.141333333333332,0,54,54,chroma_acts_smoothed
255,2,25.141333333333332,32.650666666666666,7.509333333333334,54,70,16,chroma_acts_smoothed
255,3,32.650666666666666,60.34133333333333,27.690666666666665,70,129,59,chroma_acts_smoothed
255,4,60.34133333333333,76.768,16.42666666666667,129,164,35,chroma_acts_smoothed
255,5,76.768,107.27466666666666,30.50666666666666,164,229,65,chroma_acts_smoothed
255,6,107.27466666666666,122.29333333333334,15.018666666666675,229,261,32,chroma_acts_smoothed
255,7,122.29333333333334,154.67733333333334,32.384,261,330,69,chroma_acts_smoothed
255,8,154.67733333333334,190.727,36.04966666666667,330,405,75,chroma_acts_smoothed
255,1,0.0,30.304,30.304,0,65,65,ki_chroma
255,2,30.304,76.768,46.464,65,164,99,ki_chroma
255,3,76.768,105.39733333333334,28.629333333333335,164,225,61,ki_chroma
255,4,105.39733333333334,106.80533333333334,1.4080000000000013,225,228,3,ki_chroma
255,5,106.80533333333334,122.29333333333334,15.488,228,261,33,ki_chroma
255,6,122.29333333333334,156.08533333333335,33.792000000000016,261,333,72,ki_chroma
255,7,156.08533333333335,159.37066666666666,3.2853333333333126,333,340,7,ki_chroma
255,8,159.37066666666666,190.727,31.35633333333334,340,405,65,ki_chroma
255,1,0.0,30.304,30.304,0,65,65,ki_chroma_acts
255,2,30.304,71.60533333333333,41.30133333333333,65,153,88,ki_chroma_acts
255,3,71.60533333333333,76.768,5.1626666666666665,153,164,11,ki_chroma_acts
255,4,76.768,105.39733333333334,28.629333333333335,164,225,61,ki_chroma_acts
255,5,105.39733333333334,106.80533333333334,1.4080000000000013,225,228,3,ki_chroma_acts
255,6,106.80533333333334,122.29333333333334,15.488,228,261,33,ki_chroma_acts
255,7,122.29333333333334,154.67733333333334,32.384,261,330,69,ki_chroma_acts
255,8,154.67733333333334,190.727,36.04966666666667,330,405,75,ki_chroma_acts
255,1,0.0,25.141333333333332,25.141333333333332,0,54,54,ki_chroma_acts_smoothed
255,2,25.141333333333332,32.650666666666666,7.509333333333334,54,70,16,ki_chroma_acts_smoothed
255,3,32.650666666666666,60.34133333333333,27.690666666666665,70,129,59,ki_chroma_acts_smoothed
255,4,60.34133333333333,76.768,16.42666666666667,129,164,35,ki_chroma_acts_smoothed
255,5,76.768,107.27466666666666,30.50666666666666,164,229,65,ki_chroma_acts_smoothed
255,6,107.27466666666666,122.29333333333334,15.018666666666675,229,261,32,ki_chroma_acts_smoothed
255,7,122.29333333333334,154.67733333333334,32.384,261,330,69,ki_chroma_acts_smoothed
255,8,154.67733333333334,190.727,36.04966666666667,330,405,75,ki_chroma_acts_smoothed
256,1,0.0,14.186666666666666,14.186666666666666,0,30,30,chromagram
256,2,14.186666666666666,23.78666666666667,9.600000000000003,30,50,20,chromagram
256,3,23.78666666666667,30.986666666666665,7.199999999999996,50,65,15,chromagram
256,4,30.986666666666665,61.70666666666666,30.72,65,129,64,chromagram
256,5,61.70666666666666,91.46666666666665,29.75999999999999,129,191,62,chromagram
256,6,91.46666666666665,138.02666666666667,46.56000000000002,191,288,97,chromagram
256,7,138.02666666666667,166.34666666666666,28.319999999999993,288,347,59,chromagram
256,8,166.34666666666666,200.873,34.526333333333326,347,417,70,chromagram
256,1,0.0,25.226666666666667,25.226666666666667,0,53,53,chroma_acts
256,2,25.226666666666667,30.506666666666668,5.280000000000001,53,64,11,chroma_acts
256,3,30.506666666666668,61.70666666666666,31.199999999999996,64,129,65,chroma_acts
256,4,61.70666666666666,91.46666666666665,29.75999999999999,129,191,62,chroma_acts
256,5,91.46666666666665,138.02666666666667,46.56000000000002,191,288,97,chroma_acts
256,6,138.02666666666667,161.06666666666666,23.039999999999992,288,336,48,chroma_acts
256,7,161.06666666666666,166.34666666666666,5.280000000000001,336,347,11,chroma_acts
256,8,166.34666666666666,200.873,34.526333333333326,347,417,70,chroma_acts
256,1,0.0,23.78666666666667,23.78666666666667,0,50,50,chroma_acts_smoothed
256,2,23.78666666666667,30.986666666666665,7.199999999999996,50,65,15,chroma_acts_smoothed
256,3,30.986666666666665,62.666666666666664,31.68,65,131,66,chroma_acts_smoothed
256,4,62.666666666666664,91.46666666666665,28.79999999999999,131,191,60,chroma_acts_smoothed
256,5,91.46666666666665,138.02666666666667,46.56000000000002,191,288,97,chroma_acts_smoothed
256,6,138.02666666666667,161.54666666666668,23.52000000000001,288,337,49,chroma_acts_smoothed
256,7,161.54666666666668,166.34666666666666,4.799999999999983,337,347,10,chroma_acts_smoothed
256,8,166.34666666666666,200.873,34.526333333333326,347,417,70,chroma_acts_smoothed
256,1,0.0,14.186666666666666,14.186666666666666,0,30,30,ki_chroma
256,2,14.186666666666666,23.78666666666667,9.600000000000003,30,50,20,ki_chroma
256,3,23.78666666666667,30.986666666666665,7.199999999999996,50,65,15,ki_chroma
256,4,30.986666666666665,61.70666666666666,30.72,65,129,64,ki_chroma
256,5,61.70666666666666,91.46666666666665,29.75999999999999,129,191,62,ki_chroma
256,6,91.46666666666665,138.02666666666667,46.56000000000002,191,288,97,ki_chroma
256,7,138.02666666666667,166.34666666666666,28.319999999999993,288,347,59,ki_chroma
256,8,166.34666666666666,200.873,34.526333333333326,347,417,70,ki_chroma
256,1,0.0,25.226666666666667,25.226666666666667,0,53,53,ki_chroma_acts
256,2,25.226666666666667,30.506666666666668,5.280000000000001,53,64,11,ki_chroma_acts
256,3,30.506666666666668,61.70666666666666,31.199999999999996,64,129,65,ki_chroma_acts
256,4,61.70666666666666,91.46666666666665,29.75999999999999,129,191,62,ki_chroma_acts
256,5,91.46666666666665,138.02666666666667,46.56000000000002,191,288,97,ki_chroma_acts
256,6,138.02666666666667,161.06666666666666,23.039999999999992,288,336,48,ki_chroma_acts
256,7,161.06666666666666,166.34666666666666,5.280000000000001,336,347,11,ki_chroma_acts
256,8,166.34666666666666,200.873,34.526333333333326,347,417,70,ki_chroma_acts
256,1,0.0,23.78666666666667,23.78666666666667,0,50,50,ki_chroma_acts_smoothed
256,2,23.78666666666667,30.986666666666665,7.199999999999996,50,65,15,ki_chroma_acts_smoothed
256,3,30.986666666666665,62.666666666666664,31.68,65,131,66,ki_chroma_acts_smoothed
256,4,62.666666666666664,91.46666666666665,28.79999999999999,131,191,60,ki_chroma_acts_smoothed
256,5,91.46666666666665,138.02666666666667,46.56000000000002,191,288,97,ki_chroma_acts_smoothed
256,6,138.02666666666667,161.54666666666668,23.52000000000001,288,337,49,ki_chroma_acts_smoothed
256,7,161.54666666666668,166.34666666666666,4.799999999999983,337,347,10,ki_chroma_acts_smoothed
256,8,166.34666666666666,200.873,34.526333333333326,347,417,70,ki_chroma_acts_smoothed
257,1,0.0,13.066666666666666,13.066666666666666,0,28,28,chromagram
257,2,13.066666666666666,14.986666666666666,1.92,28,32,4,chromagram
257,3,14.986666666666666,57.22666666666667,42.24,32,120,88,chromagram
257,4,57.22666666666667,61.06666666666667,3.8400000000000034,120,128,8,chromagram
257,5,61.06666666666667,71.62666666666667,10.559999999999995,128,150,22,chromagram
257,6,71.62666666666667,75.94666666666667,4.320000000000007,150,159,9,chromagram
257,7,75.94666666666667,86.98666666666666,11.039999999999992,159,182,23,chromagram
257,8,86.98666666666666,100.90666666666667,13.920000000000002,182,211,29,chromagram
257,9,100.90666666666667,135.54,34.633333333333326,211,282,71,chromagram
257,1,0.0,14.986666666666666,14.986666666666666,0,32,32,chroma_acts
257,2,14.986666666666666,24.586666666666666,9.6,32,52,20,chroma_acts
257,3,24.586666666666666,26.506666666666664,1.9199999999999982,52,56,4,chroma_acts
257,4,26.506666666666664,57.22666666666667,30.720000000000002,56,120,64,chroma_acts
257,5,57.22666666666667,75.94666666666667,18.720000000000006,120,159,39,chroma_acts
257,6,75.94666666666667,100.90666666666667,24.959999999999994,159,211,52,chroma_acts
257,7,100.90666666666667,116.26666666666667,15.36,211,243,32,chroma_acts
257,8,116.26666666666667,120.10666666666667,3.8400000000000034,243,251,8,chroma_acts
257,9,120.10666666666667,135.54,15.433333333333323,251,282,31,chroma_acts
257,1,0.0,15.466666666666667,15.466666666666667,0,33,33,chroma_acts_smoothed
257,2,15.466666666666667,38.02666666666667,22.560000000000002,33,80,47,chroma_acts_smoothed
257,3,38.02666666666667,57.22666666666667,19.199999999999996,80,120,40,chroma_acts_smoothed
257,4,57.22666666666667,62.986666666666665,5.759999999999998,120,132,12,chroma_acts_smoothed
257,5,62.986666666666665,75.94666666666667,12.960000000000008,132,159,27,chroma_acts_smoothed
257,6,75.94666666666667,100.90666666666667,24.959999999999994,159,211,52,chroma_acts_smoothed
257,7,100.90666666666667,116.26666666666667,15.36,211,243,32,chroma_acts_smoothed
257,8,116.26666666666667,120.58666666666666,4.319999999999993,243,252,9,chroma_acts_smoothed
257,9,120.58666666666666,135.54,14.953333333333333,252,282,30,chroma_acts_smoothed
257,1,0.0,13.066666666666666,13.066666666666666,0,28,28,ki_chroma
257,2,13.066666666666666,14.986666666666666,1.92,28,32,4,ki_chroma
257,3,14.986666666666666,57.22666666666667,42.24,32,120,88,ki_chroma
257,4,57.22666666666667,61.06666666666667,3.8400000000000034,120,128,8,ki_chroma
257,5,61.06666666666667,71.62666666666667,10.559999999999995,128,150,22,ki_chroma
257,6,71.62666666666667,75.94666666666667,4.320000000000007,150,159,9,ki_chroma
257,7,75.94666666666667,86.98666666666666,11.039999999999992,159,182,23,ki_chroma
257,8,86.98666666666666,100.90666666666667,13.920000000000002,182,211,29,ki_chroma
257,9,100.90666666666667,135.54,34.633333333333326,211,282,71,ki_chroma
257,1,0.0,14.986666666666666,14.986666666666666,0,32,32,ki_chroma_acts
257,2,14.986666666666666,24.586666666666666,9.6,32,52,20,ki_chroma_acts
257,3,24.586666666666666,26.506666666666664,1.9199999999999982,52,56,4,ki_chroma_acts
257,4,26.506666666666664,57.22666666666667,30.720000000000002,56,120,64,ki_chroma_acts
257,5,57.22666666666667,75.94666666666667,18.720000000000006,120,159,39,ki_chroma_acts
257,6,75.94666666666667,100.90666666666667,24.959999999999994,159,211,52,ki_chroma_acts
257,7,100.90666666666667,116.26666666666667,15.36,211,243,32,ki_chroma_acts
257,8,116.26666666666667,120.10666666666667,3.8400000000000034,243,251,8,ki_chroma_acts
257,9,120.10666666666667,135.54,15.433333333333323,251,282,31,ki_chroma_acts
257,1,0.0,15.466666666666667,15.466666666666667,0,33,33,ki_chroma_acts_smoothed
257,2,15.466666666666667,38.02666666666667,22.560000000000002,33,80,47,ki_chroma_acts_smoothed
257,3,38.02666666666667,57.22666666666667,19.199999999999996,80,120,40,ki_chroma_acts_smoothed
257,4,57.22666666666667,62.986666666666665,5.759999999999998,120,132,12,ki_chroma_acts_smoothed
257,5,62.986666666666665,75.94666666666667,12.960000000000008,132,159,27,ki_chroma_acts_smoothed
257,6,75.94666666666667,100.90666666666667,24.959999999999994,159,211,52,ki_chroma_acts_smoothed
257,7,100.90666666666667,116.26666666666667,15.36,211,243,32,ki_chroma_acts_smoothed
257,8,116.26666666666667,120.58666666666666,4.319999999999993,243,252,9,ki_chroma_acts_smoothed
257,9,120.58666666666666,135.54,14.953333333333333,252,282,30,ki_chroma_acts_smoothed
258,1,0.0,14.186666666666667,14.186666666666667,0,31,31,chromagram
258,2,14.186666666666667,15.125333333333334,0.9386666666666663,31,33,2,chromagram
258,3,15.125333333333334,57.83466666666667,42.70933333333333,33,124,91,chromagram
258,4,57.83466666666667,90.21866666666666,32.38399999999999,124,193,69,chromagram
258,5,90.21866666666666,135.27466666666666,45.056,193,289,96,chromagram
258,6,135.27466666666666,137.152,1.8773333333333255,289,293,4,chromagram
258,7,137.152,149.82399999999998,12.671999999999997,293,320,27,chromagram
258,8,149.82399999999998,196.704,46.880000000000024,320,418,98,chromagram
258,1,0.0,15.125333333333334,15.125333333333334,0,33,33,chroma_acts
258,2,15.125333333333334,59.242666666666665,44.117333333333335,33,127,94,chroma_acts
258,3,59.242666666666665,90.21866666666666,30.976,127,193,66,chroma_acts
258,4,90.21866666666666,135.27466666666666,45.056,193,289,96,chroma_acts
258,5,135.27466666666666,137.152,1.8773333333333255,289,293,4,chroma_acts
258,6,137.152,139.0293333333333,1.8773333333333255,293,297,4,chroma_acts
258,7,139.0293333333333,150.29333333333332,11.26400000000001,297,321,24,chroma_acts
258,8,150.29333333333332,196.704,46.410666666666685,321,418,97,chroma_acts
258,1,0.0,15.594666666666667,15.594666666666667,0,34,34,chroma_acts_smoothed
258,2,15.594666666666667,58.304,42.70933333333333,34,125,91,chroma_acts_smoothed
258,3,58.304,90.21866666666666,31.914666666666662,125,193,68,chroma_acts_smoothed
258,4,90.21866666666666,131.05066666666664,40.83199999999998,193,280,87,chroma_acts_smoothed
258,5,131.05066666666664,135.27466666666666,4.224000000000018,280,289,9,chroma_acts_smoothed
258,6,135.27466666666666,137.152,1.8773333333333255,289,293,4,chroma_acts_smoothed
258,7,137.152,150.29333333333332,13.141333333333336,293,321,28,chroma_acts_smoothed
258,8,150.29333333333332,196.704,46.410666666666685,321,418,97,chroma_acts_smoothed
258,1,0.0,14.186666666666667,14.186666666666667,0,31,31,ki_chroma
258,2,14.186666666666667,15.125333333333334,0.9386666666666663,31,33,2,ki_chroma
258,3,15.125333333333334,57.83466666666667,42.70933333333333,33,124,91,ki_chroma
258,4,57.83466666666667,90.21866666666666,32.38399999999999,124,193,69,ki_chroma
258,5,90.21866666666666,135.27466666666666,45.056,193,289,96,ki_chroma
258,6,135.27466666666666,137.152,1.8773333333333255,289,293,4,ki_chroma
258,7,137.152,149.82399999999998,12.671999999999997,293,320,27,ki_chroma
258,8,149.82399999999998,196.704,46.880000000000024,320,418,98,ki_chroma
258,1,0.0,15.125333333333334,15.125333333333334,0,33,33,ki_chroma_acts
258,2,15.125333333333334,59.242666666666665,44.117333333333335,33,127,94,ki_chroma_acts
258,3,59.242666666666665,90.21866666666666,30.976,127,193,66,ki_chroma_acts
258,4,90.21866666666666,135.27466666666666,45.056,193,289,96,ki_chroma_acts
258,5,135.27466666666666,137.152,1.8773333333333255,289,293,4,ki_chroma_acts
258,6,137.152,139.0293333333333,1.8773333333333255,293,297,4,ki_chroma_acts
258,7,139.0293333333333,150.29333333333332,11.26400000000001,297,321,24,ki_chroma_acts
258,8,150.29333333333332,196.704,46.410666666666685,321,418,97,ki_chroma_acts
258,1,0.0,15.594666666666667,15.594666666666667,0,34,34,ki_chroma_acts_smoothed
258,2,15.594666666666667,58.304,42.70933333333333,34,125,91,ki_chroma_acts_smoothed
258,3,58.304,90.21866666666666,31.914666666666662,125,193,68,ki_chroma_acts_smoothed
258,4,90.21866666666666,131.05066666666664,40.83199999999998,193,280,87,ki_chroma_acts_smoothed
258,5,131.05066666666664,135.27466666666666,4.224000000000018,280,289,9,ki_chroma_acts_smoothed
258,6,135.27466666666666,137.152,1.8773333333333255,289,293,4,ki_chroma_acts_smoothed
258,7,137.152,150.29333333333332,13.141333333333336,293,321,28,ki_chroma_acts_smoothed
258,8,150.29333333333332,196.704,46.410666666666685,321,418,97,ki_chroma_acts_smoothed
259,1,0.0,17.642666666666667,17.642666666666667,0,36,36,chromagram
259,2,17.642666666666667,48.72533333333333,31.082666666666665,36,98,62,chromagram
259,3,48.72533333333333,64.26666666666667,15.541333333333334,98,129,31,chromagram
259,4,64.26666666666667,111.89333333333333,47.626666666666665,129,224,95,chromagram
259,5,111.89333333333333,137.96266666666665,26.06933333333332,224,276,52,chromagram
259,6,137.96266666666665,145.98399999999998,8.021333333333331,276,292,16,chromagram
259,7,145.98399999999998,209.6533333333333,63.66933333333333,292,419,127,chromagram
259,8,209.6533333333333,243.308,33.654666666666685,419,485,66,chromagram
259,1,0.0,17.642666666666667,17.642666666666667,0,36,36,chroma_acts
259,2,17.642666666666667,49.727999999999994,32.085333333333324,36,100,64,chroma_acts
259,3,49.727999999999994,54.239999999999995,4.5120000000000005,100,109,9,chroma_acts
259,4,54.239999999999995,57.749333333333325,3.5093333333333305,109,116,7,chroma_acts
259,5,57.749333333333325,62.261333333333326,4.5120000000000005,116,125,9,chroma_acts
259,6,62.261333333333326,209.6533333333333,147.392,125,419,294,chroma_acts
259,7,209.6533333333333,231.71199999999996,22.058666666666653,419,463,44,chroma_acts
259,8,231.71199999999996,243.308,11.596000000000032,463,485,22,chroma_acts
259,1,0.0,17.642666666666667,17.642666666666667,0,36,36,chroma_acts_smoothed
259,2,17.642666666666667,49.727999999999994,32.085333333333324,36,100,64,chroma_acts_smoothed
259,3,49.727999999999994,54.239999999999995,4.5120000000000005,100,109,9,chroma_acts_smoothed
259,4,54.239999999999995,90.336,36.096000000000004,109,181,72,chroma_acts_smoothed
259,5,90.336,139.968,49.63199999999999,181,280,99,chroma_acts_smoothed
259,6,139.968,210.15466666666666,70.18666666666667,280,420,140,chroma_acts_smoothed
259,7,210.15466666666666,243.308,33.153333333333336,420,485,65,chroma_acts_smoothed
259,1,0.0,17.642666666666667,17.642666666666667,0,36,36,ki_chroma
259,2,17.642666666666667,48.72533333333333,31.082666666666665,36,98,62,ki_chroma
259,3,48.72533333333333,64.26666666666667,15.541333333333334,98,129,31,ki_chroma
259,4,64.26666666666667,111.89333333333333,47.626666666666665,129,224,95,ki_chroma
259,5,111.89333333333333,137.96266666666665,26.06933333333332,224,276,52,ki_chroma
259,6,137.96266666666665,145.98399999999998,8.021333333333331,276,292,16,ki_chroma
259,7,145.98399999999998,209.6533333333333,63.66933333333333,292,419,127,ki_chroma
259,8,209.6533333333333,243.308,33.654666666666685,419,485,66,ki_chroma
259,1,0.0,17.642666666666667,17.642666666666667,0,36,36,ki_chroma_acts
259,2,17.642666666666667,49.727999999999994,32.085333333333324,36,100,64,ki_chroma_acts
259,3,49.727999999999994,54.239999999999995,4.5120000000000005,100,109,9,ki_chroma_acts
259,4,54.239999999999995,57.749333333333325,3.5093333333333305,109,116,7,ki_chroma_acts
259,5,57.749333333333325,62.261333333333326,4.5120000000000005,116,125,9,ki_chroma_acts
259,6,62.261333333333326,209.6533333333333,147.392,125,419,294,ki_chroma_acts
259,7,209.6533333333333,231.71199999999996,22.058666666666653,419,463,44,ki_chroma_acts
259,8,231.71199999999996,243.308,11.596000000000032,463,485,22,ki_chroma_acts
259,1,0.0,17.642666666666667,17.642666666666667,0,36,36,ki_chroma_acts_smoothed
259,2,17.642666666666667,49.727999999999994,32.085333333333324,36,100,64,ki_chroma_acts_smoothed
259,3,49.727999999999994,54.239999999999995,4.5120000000000005,100,109,9,ki_chroma_acts_smoothed
259,4,54.239999999999995,90.336,36.096000000000004,109,181,72,ki_chroma_acts_smoothed
259,5,90.336,139.968,49.63199999999999,181,280,99,ki_chroma_acts_smoothed
259,6,139.968,210.15466666666666,70.18666666666667,280,420,140,ki_chroma_acts_smoothed
259,7,210.15466666666666,243.308,33.153333333333336,420,485,65,ki_chroma_acts_smoothed
260,1,0.0,15.466666666666667,15.466666666666667,0,33,33,chromagram
260,2,15.466666666666667,30.826666666666664,15.359999999999998,33,65,32,chromagram
260,3,30.826666666666664,61.06666666666667,30.240000000000006,65,128,63,chromagram
260,4,61.06666666666667,80.74666666666667,19.68,128,169,41,chromagram
260,5,80.74666666666667,129.70666666666665,48.95999999999998,169,271,102,chromagram
260,6,129.70666666666665,172.90666666666664,43.19999999999999,271,361,90,chromagram
260,7,172.90666666666664,192.10666666666665,19.200000000000017,361,401,40,chromagram
260,8,192.10666666666665,224.929,32.82233333333335,401,468,67,chromagram
260,1,0.0,15.466666666666667,15.466666666666667,0,33,33,chroma_acts
260,2,15.466666666666667,32.74666666666667,17.28,33,69,36,chroma_acts
260,3,32.74666666666667,52.906666666666666,20.159999999999997,69,111,42,chroma_acts
260,4,52.906666666666666,80.74666666666667,27.840000000000003,111,169,58,chroma_acts
260,5,80.74666666666667,129.70666666666665,48.95999999999998,169,271,102,chroma_acts
260,6,129.70666666666665,172.90666666666664,43.19999999999999,271,361,90,chroma_acts
260,7,172.90666666666664,188.26666666666665,15.360000000000014,361,393,32,chroma_acts
260,8,188.26666666666665,192.10666666666665,3.8400000000000034,393,401,8,chroma_acts
260,9,192.10666666666665,224.929,32.82233333333335,401,468,67,chroma_acts
260,1,0.0,15.466666666666667,15.466666666666667,0,33,33,chroma_acts_smoothed
260,2,15.466666666666667,30.826666666666664,15.359999999999998,33,65,32,chroma_acts_smoothed
260,3,30.826666666666664,52.906666666666666,22.080000000000002,65,111,46,chroma_acts_smoothed
260,4,52.906666666666666,80.74666666666667,27.840000000000003,111,169,58,chroma_acts_smoothed
260,5,80.74666666666667,129.70666666666665,48.95999999999998,169,271,102,chroma_acts_smoothed
260,6,129.70666666666665,172.90666666666664,43.19999999999999,271,361,90,chroma_acts_smoothed
260,7,172.90666666666664,188.26666666666665,15.360000000000014,361,393,32,chroma_acts_smoothed
260,8,188.26666666666665,192.10666666666665,3.8400000000000034,393,401,8,chroma_acts_smoothed
260,9,192.10666666666665,224.929,32.82233333333335,401,468,67,chroma_acts_smoothed
260,1,0.0,15.466666666666667,15.466666666666667,0,33,33,ki_chroma
260,2,15.466666666666667,30.826666666666664,15.359999999999998,33,65,32,ki_chroma
260,3,30.826666666666664,61.06666666666667,30.240000000000006,65,128,63,ki_chroma
260,4,61.06666666666667,80.74666666666667,19.68,128,169,41,ki_chroma
260,5,80.74666666666667,129.70666666666665,48.95999999999998,169,271,102,ki_chroma
260,6,129.70666666666665,172.90666666666664,43.19999999999999,271,361,90,ki_chroma
260,7,172.90666666666664,192.10666666666665,19.200000000000017,361,401,40,ki_chroma
260,8,192.10666666666665,224.929,32.82233333333335,401,468,67,ki_chroma
260,1,0.0,15.466666666666667,15.466666666666667,0,33,33,ki_chroma_acts
260,2,15.466666666666667,32.74666666666667,17.28,33,69,36,ki_chroma_acts
260,3,32.74666666666667,52.906666666666666,20.159999999999997,69,111,42,ki_chroma_acts
260,4,52.906666666666666,80.74666666666667,27.840000000000003,111,169,58,ki_chroma_acts
260,5,80.74666666666667,129.70666666666665,48.95999999999998,169,271,102,ki_chroma_acts
260,6,129.70666666666665,172.90666666666664,43.19999999999999,271,361,90,ki_chroma_acts
260,7,172.90666666666664,188.26666666666665,15.360000000000014,361,393,32,ki_chroma_acts
260,8,188.26666666666665,192.10666666666665,3.8400000000000034,393,401,8,ki_chroma_acts
260,9,192.10666666666665,224.929,32.82233333333335,401,468,67,ki_chroma_acts
260,1,0.0,15.466666666666667,15.466666666666667,0,33,33,ki_chroma_acts_smoothed
260,2,15.466666666666667,30.826666666666664,15.359999999999998,33,65,32,ki_chroma_acts_smoothed
260,3,30.826666666666664,52.906666666666666,22.080000000000002,65,111,46,ki_chroma_acts_smoothed
260,4,52.906666666666666,80.74666666666667,27.840000000000003,111,169,58,ki_chroma_acts_smoothed
260,5,80.74666666666667,129.70666666666665,48.95999999999998,169,271,102,ki_chroma_acts_smoothed
260,6,129.70666666666665,172.90666666666664,43.19999999999999,271,361,90,ki_chroma_acts_smoothed
260,7,172.90666666666664,188.26666666666665,15.360000000000014,361,393,32,ki_chroma_acts_smoothed
260,8,188.26666666666665,192.10666666666665,3.8400000000000034,393,401,8,ki_chroma_acts_smoothed
260,9,192.10666666666665,224.929,32.82233333333335,401,468,67,ki_chroma_acts_smoothed
261,1,0.0,34.67733333333334,34.67733333333334,0,71,71,chromagram
261,2,34.67733333333334,63.62666666666667,28.949333333333335,71,130,59,chromagram
261,3,63.62666666666667,122.99733333333334,59.37066666666667,130,251,121,chromagram
261,4,122.99733333333334,142.62400000000002,19.62666666666668,251,291,40,chromagram
261,5,142.62400000000002,186.29333333333335,43.66933333333333,291,380,89,chromagram
261,6,186.29333333333335,190.70933333333335,4.415999999999997,380,389,9,chromagram
261,7,190.70933333333335,206.41066666666669,15.701333333333338,389,421,32,chromagram
261,8,206.41066666666669,224.132,17.72133333333332,421,456,35,chromagram
261,1,0.0,31.733333333333334,31.733333333333334,0,65,65,chroma_acts
261,2,31.733333333333334,35.65866666666667,3.9253333333333345,65,73,8,chroma_acts
261,3,35.65866666666667,39.584,3.9253333333333345,73,81,8,chroma_acts
261,4,39.584,61.664,22.08,81,126,45,chroma_acts
261,5,61.664,124.96000000000001,63.29600000000001,126,255,129,chroma_acts
261,6,124.96000000000001,142.62400000000002,17.664000000000016,255,291,36,chroma_acts
261,7,142.62400000000002,206.41066666666669,63.78666666666666,291,421,130,chroma_acts
261,8,206.41066666666669,224.132,17.72133333333332,421,456,35,chroma_acts
261,1,0.0,31.24266666666667,31.24266666666667,0,64,64,chroma_acts_smoothed
261,2,31.24266666666667,35.65866666666667,4.416,64,73,9,chroma_acts_smoothed
261,3,35.65866666666667,39.093333333333334,3.434666666666665,73,80,7,chroma_acts_smoothed
261,4,39.093333333333334,61.664,22.570666666666668,80,126,46,chroma_acts_smoothed
261,5,61.664,126.43200000000002,64.76800000000001,126,258,132,chroma_acts_smoothed
261,6,126.43200000000002,142.62400000000002,16.192000000000007,258,291,33,chroma_acts_smoothed
261,7,142.62400000000002,206.41066666666669,63.78666666666666,291,421,130,chroma_acts_smoothed
261,8,206.41066666666669,224.132,17.72133333333332,421,456,35,chroma_acts_smoothed
261,1,0.0,34.67733333333334,34.67733333333334,0,71,71,ki_chroma
261,2,34.67733333333334,63.62666666666667,28.949333333333335,71,130,59,ki_chroma
261,3,63.62666666666667,122.99733333333334,59.37066666666667,130,251,121,ki_chroma
261,4,122.99733333333334,142.62400000000002,19.62666666666668,251,291,40,ki_chroma
261,5,142.62400000000002,186.29333333333335,43.66933333333333,291,380,89,ki_chroma
261,6,186.29333333333335,190.70933333333335,4.415999999999997,380,389,9,ki_chroma
261,7,190.70933333333335,206.41066666666669,15.701333333333338,389,421,32,ki_chroma
261,8,206.41066666666669,224.132,17.72133333333332,421,456,35,ki_chroma
261,1,0.0,31.733333333333334,31.733333333333334,0,65,65,ki_chroma_acts
261,2,31.733333333333334,35.65866666666667,3.9253333333333345,65,73,8,ki_chroma_acts
261,3,35.65866666666667,39.584,3.9253333333333345,73,81,8,ki_chroma_acts
261,4,39.584,61.664,22.08,81,126,45,ki_chroma_acts
261,5,61.664,124.96000000000001,63.29600000000001,126,255,129,ki_chroma_acts
261,6,124.96000000000001,142.62400000000002,17.664000000000016,255,291,36,ki_chroma_acts
261,7,142.62400000000002,206.41066666666669,63.78666666666666,291,421,130,ki_chroma_acts
261,8,206.41066666666669,224.132,17.72133333333332,421,456,35,ki_chroma_acts
261,1,0.0,31.24266666666667,31.24266666666667,0,64,64,ki_chroma_acts_smoothed
261,2,31.24266666666667,35.65866666666667,4.416,64,73,9,ki_chroma_acts_smoothed
261,3,35.65866666666667,39.093333333333334,3.434666666666665,73,80,7,ki_chroma_acts_smoothed
261,4,39.093333333333334,61.664,22.570666666666668,80,126,46,ki_chroma_acts_smoothed
261,5,61.664,126.43200000000002,64.76800000000001,126,258,132,ki_chroma_acts_smoothed
261,6,126.43200000000002,142.62400000000002,16.192000000000007,258,291,33,ki_chroma_acts_smoothed
261,7,142.62400000000002,206.41066666666669,63.78666666666666,291,421,130,ki_chroma_acts_smoothed
261,8,206.41066666666669,224.132,17.72133333333332,421,456,35,ki_chroma_acts_smoothed
264,1,0.0,8.746666666666666,8.746666666666666,0,17,17,chromagram
264,2,8.746666666666666,16.906666666666666,8.16,17,32,15,chromagram
264,3,16.906666666666666,30.506666666666668,13.600000000000001,32,57,25,chromagram
264,4,30.506666666666668,52.266666666666666,21.759999999999998,57,97,40,chromagram
264,5,52.266666666666666,69.67466666666668,17.408000000000015,97,129,32,chromagram
264,6,69.67466666666668,88.17066666666668,18.495999999999995,129,163,34,chromagram
264,7,88.17066666666668,101.22666666666667,13.055999999999997,163,187,24,chromagram
264,8,101.22666666666667,140.3946666666667,39.16800000000002,187,259,72,chromagram
264,9,140.3946666666667,174.549,34.15433333333331,259,320,61,chromagram
264,1,0.0,8.746666666666666,8.746666666666666,0,17,17,chroma_acts
264,2,8.746666666666666,30.506666666666668,21.76,17,57,40,chroma_acts
264,3,30.506666666666668,33.77066666666667,3.264000000000003,57,63,6,chroma_acts
264,4,33.77066666666667,52.266666666666666,18.495999999999995,63,97,34,chroma_acts
264,5,52.266666666666666,69.67466666666668,17.408000000000015,97,129,32,chroma_acts
264,6,69.67466666666668,88.17066666666668,18.495999999999995,129,163,34,chroma_acts
264,7,88.17066666666668,101.22666666666667,13.055999999999997,163,187,24,chroma_acts
264,8,101.22666666666667,140.3946666666667,39.16800000000002,187,259,72,chroma_acts
264,9,140.3946666666667,174.549,34.15433333333331,259,320,61,chroma_acts
264,1,0.0,9.290666666666667,9.290666666666667,0,18,18,chroma_acts_smoothed
264,2,9.290666666666667,30.506666666666668,21.216,18,57,39,chroma_acts_smoothed
264,3,30.506666666666668,33.77066666666667,3.264000000000003,57,63,6,chroma_acts_smoothed
264,4,33.77066666666667,52.81066666666667,19.04,63,98,35,chroma_acts_smoothed
264,5,52.81066666666667,69.67466666666668,16.86400000000001,98,129,31,chroma_acts_smoothed
264,6,69.67466666666668,87.62666666666668,17.951999999999998,129,162,33,chroma_acts_smoothed
264,7,87.62666666666668,100.68266666666668,13.055999999999997,162,186,24,chroma_acts_smoothed
264,8,100.68266666666668,139.85066666666668,39.168000000000006,186,258,72,chroma_acts_smoothed
264,9,139.85066666666668,174.549,34.69833333333332,258,320,62,chroma_acts_smoothed
264,1,0.0,8.746666666666666,8.746666666666666,0,17,17,ki_chroma
264,2,8.746666666666666,16.906666666666666,8.16,17,32,15,ki_chroma
264,3,16.906666666666666,30.506666666666668,13.600000000000001,32,57,25,ki_chroma
264,4,30.506666666666668,52.266666666666666,21.759999999999998,57,97,40,ki_chroma
264,5,52.266666666666666,69.67466666666668,17.408000000000015,97,129,32,ki_chroma
264,6,69.67466666666668,88.17066666666668,18.495999999999995,129,163,34,ki_chroma
264,7,88.17066666666668,101.22666666666667,13.055999999999997,163,187,24,ki_chroma
264,8,101.22666666666667,140.3946666666667,39.16800000000002,187,259,72,ki_chroma
264,9,140.3946666666667,174.549,34.15433333333331,259,320,61,ki_chroma
264,1,0.0,8.746666666666666,8.746666666666666,0,17,17,ki_chroma_acts
264,2,8.746666666666666,30.506666666666668,21.76,17,57,40,ki_chroma_acts
264,3,30.506666666666668,33.77066666666667,3.264000000000003,57,63,6,ki_chroma_acts
264,4,33.77066666666667,52.266666666666666,18.495999999999995,63,97,34,ki_chroma_acts
264,5,52.266666666666666,69.67466666666668,17.408000000000015,97,129,32,ki_chroma_acts
264,6,69.67466666666668,88.17066666666668,18.495999999999995,129,163,34,ki_chroma_acts
264,7,88.17066666666668,101.22666666666667,13.055999999999997,163,187,24,ki_chroma_acts
264,8,101.22666666666667,140.3946666666667,39.16800000000002,187,259,72,ki_chroma_acts
264,9,140.3946666666667,174.549,34.15433333333331,259,320,61,ki_chroma_acts
264,1,0.0,9.290666666666667,9.290666666666667,0,18,18,ki_chroma_acts_smoothed
264,2,9.290666666666667,30.506666666666668,21.216,18,57,39,ki_chroma_acts_smoothed
264,3,30.506666666666668,33.77066666666667,3.264000000000003,57,63,6,ki_chroma_acts_smoothed
264,4,33.77066666666667,52.81066666666667,19.04,63,98,35,ki_chroma_acts_smoothed
264,5,52.81066666666667,69.67466666666668,16.86400000000001,98,129,31,ki_chroma_acts_smoothed
264,6,69.67466666666668,87.62666666666668,17.951999999999998,129,162,33,ki_chroma_acts_smoothed
264,7,87.62666666666668,100.68266666666668,13.055999999999997,162,186,24,ki_chroma_acts_smoothed
264,8,100.68266666666668,139.85066666666668,39.168000000000006,186,258,72,ki_chroma_acts_smoothed
264,9,139.85066666666668,174.549,34.69833333333332,258,320,62,ki_chroma_acts_smoothed
265,1,0.0,32.23466666666666,32.23466666666666,0,68,68,chromagram
265,2,32.23466666666666,41.35466666666666,9.119999999999997,68,87,19,chromagram
265,3,41.35466666666666,47.59466666666666,6.240000000000002,87,100,13,chromagram
265,4,47.59466666666666,94.15466666666667,46.56000000000001,100,197,97,chromagram
265,5,94.15466666666667,99.43466666666667,5.280000000000001,197,208,11,chromagram
265,6,99.43466666666667,127.27466666666666,27.83999999999999,208,266,58,chromagram
265,7,127.27466666666666,153.67466666666667,26.400000000000006,266,321,55,chromagram
265,8,153.67466666666667,234.626,80.95133333333334,321,488,167,chromagram
265,1,0.0,32.23466666666666,32.23466666666666,0,68,68,chroma_acts
265,2,32.23466666666666,42.794666666666664,10.560000000000002,68,90,22,chroma_acts
265,3,42.794666666666664,47.59466666666666,4.799999999999997,90,100,10,chroma_acts
265,4,47.59466666666666,95.11466666666666,47.52,100,199,99,chroma_acts
265,5,95.11466666666666,97.51466666666667,2.4000000000000057,199,204,5,chroma_acts
265,6,97.51466666666667,127.75466666666667,30.239999999999995,204,267,63,chroma_acts
265,7,127.75466666666667,153.67466666666667,25.92,267,321,54,chroma_acts
265,8,153.67466666666667,234.626,80.95133333333334,321,488,167,chroma_acts
265,1,0.0,8.234666666666666,8.234666666666666,0,18,18,chroma_acts_smoothed
265,2,8.234666666666666,31.754666666666665,23.52,18,67,49,chroma_acts_smoothed
265,3,31.754666666666665,42.794666666666664,11.04,67,90,23,chroma_acts_smoothed
265,4,42.794666666666664,47.59466666666666,4.799999999999997,90,100,10,chroma_acts_smoothed
265,5,47.59466666666666,95.11466666666666,47.52,100,199,99,chroma_acts_smoothed
265,6,95.11466666666666,99.43466666666667,4.320000000000007,199,208,9,chroma_acts_smoothed
265,7,99.43466666666667,127.75466666666667,28.319999999999993,208,267,59,chroma_acts_smoothed
265,8,127.75466666666667,154.15466666666666,26.39999999999999,267,322,55,chroma_acts_smoothed
265,9,154.15466666666666,234.626,80.47133333333335,322,488,166,chroma_acts_smoothed
265,1,0.0,32.23466666666666,32.23466666666666,0,68,68,ki_chroma
265,2,32.23466666666666,41.35466666666666,9.119999999999997,68,87,19,ki_chroma
265,3,41.35466666666666,47.59466666666666,6.240000000000002,87,100,13,ki_chroma
265,4,47.59466666666666,94.15466666666667,46.56000000000001,100,197,97,ki_chroma
265,5,94.15466666666667,99.43466666666667,5.280000000000001,197,208,11,ki_chroma
265,6,99.43466666666667,127.27466666666666,27.83999999999999,208,266,58,ki_chroma
265,7,127.27466666666666,153.67466666666667,26.400000000000006,266,321,55,ki_chroma
265,8,153.67466666666667,234.626,80.95133333333334,321,488,167,ki_chroma
265,1,0.0,32.23466666666666,32.23466666666666,0,68,68,ki_chroma_acts
265,2,32.23466666666666,42.794666666666664,10.560000000000002,68,90,22,ki_chroma_acts
265,3,42.794666666666664,47.59466666666666,4.799999999999997,90,100,10,ki_chroma_acts
265,4,47.59466666666666,95.11466666666666,47.52,100,199,99,ki_chroma_acts
265,5,95.11466666666666,97.51466666666667,2.4000000000000057,199,204,5,ki_chroma_acts
265,6,97.51466666666667,127.75466666666667,30.239999999999995,204,267,63,ki_chroma_acts
265,7,127.75466666666667,153.67466666666667,25.92,267,321,54,ki_chroma_acts
265,8,153.67466666666667,234.626,80.95133333333334,321,488,167,ki_chroma_acts
265,1,0.0,8.234666666666666,8.234666666666666,0,18,18,ki_chroma_acts_smoothed
265,2,8.234666666666666,31.754666666666665,23.52,18,67,49,ki_chroma_acts_smoothed
265,3,31.754666666666665,42.794666666666664,11.04,67,90,23,ki_chroma_acts_smoothed
265,4,42.794666666666664,47.59466666666666,4.799999999999997,90,100,10,ki_chroma_acts_smoothed
265,5,47.59466666666666,95.11466666666666,47.52,100,199,99,ki_chroma_acts_smoothed
265,6,95.11466666666666,99.43466666666667,4.320000000000007,199,208,9,ki_chroma_acts_smoothed
265,7,99.43466666666667,127.75466666666667,28.319999999999993,208,267,59,ki_chroma_acts_smoothed
265,8,127.75466666666667,154.15466666666666,26.39999999999999,267,322,55,ki_chroma_acts_smoothed
265,9,154.15466666666666,234.626,80.47133333333335,322,488,166,ki_chroma_acts_smoothed
266,1,0.0,15.317333333333336,15.317333333333336,0,32,32,chromagram
266,2,15.317333333333336,41.32266666666667,26.005333333333333,32,85,53,chromagram
266,3,41.32266666666667,51.136,9.813333333333333,85,105,20,chromagram
266,4,51.136,110.016,58.88,105,225,120,chromagram
266,5,110.016,161.536,51.519999999999996,225,330,105,chromagram
266,6,161.536,169.38666666666666,7.850666666666655,330,346,16,chromagram
266,7,169.38666666666666,175.27466666666666,5.888000000000005,346,358,12,chromagram
266,8,175.27466666666666,204.626,29.351333333333343,358,416,58,chromagram
266,1,0.0,169.38666666666666,169.38666666666666,0,346,346,chroma_acts
266,2,169.38666666666666,175.27466666666666,5.888000000000005,346,358,12,chroma_acts
266,3,175.27466666666666,183.12533333333334,7.850666666666683,358,374,16,chroma_acts
266,4,183.12533333333334,187.05066666666667,3.9253333333333273,374,382,8,chroma_acts
266,5,187.05066666666667,190.976,3.9253333333333273,382,390,8,chroma_acts
266,6,190.976,194.90133333333333,3.9253333333333273,390,398,8,chroma_acts
266,7,194.90133333333333,196.864,1.9626666666666779,398,402,4,chroma_acts
266,8,196.864,204.626,7.7620000000000005,402,416,14,chroma_acts
266,1,0.0,35.43466666666667,35.43466666666667,0,73,73,chroma_acts_smoothed
266,2,35.43466666666667,41.32266666666667,5.887999999999998,73,85,12,chroma_acts_smoothed
266,3,41.32266666666667,90.38933333333334,49.06666666666667,85,185,100,chroma_acts_smoothed
266,4,90.38933333333334,161.536,71.14666666666666,185,330,145,chroma_acts_smoothed
266,5,161.536,169.38666666666666,7.850666666666655,330,346,16,chroma_acts_smoothed
266,6,169.38666666666666,175.27466666666666,5.888000000000005,346,358,12,chroma_acts_smoothed
266,7,175.27466666666666,190.976,15.701333333333338,358,390,32,chroma_acts_smoothed
266,8,190.976,204.626,13.650000000000006,390,416,26,chroma_acts_smoothed
266,1,0.0,15.317333333333336,15.317333333333336,0,32,32,ki_chroma
266,2,15.317333333333336,41.32266666666667,26.005333333333333,32,85,53,ki_chroma
266,3,41.32266666666667,51.136,9.813333333333333,85,105,20,ki_chroma
266,4,51.136,110.016,58.88,105,225,120,ki_chroma
266,5,110.016,161.536,51.519999999999996,225,330,105,ki_chroma
266,6,161.536,169.38666666666666,7.850666666666655,330,346,16,ki_chroma
266,7,169.38666666666666,175.27466666666666,5.888000000000005,346,358,12,ki_chroma
266,8,175.27466666666666,204.626,29.351333333333343,358,416,58,ki_chroma
266,1,0.0,169.38666666666666,169.38666666666666,0,346,346,ki_chroma_acts
266,2,169.38666666666666,175.27466666666666,5.888000000000005,346,358,12,ki_chroma_acts
266,3,175.27466666666666,183.12533333333334,7.850666666666683,358,374,16,ki_chroma_acts
266,4,183.12533333333334,187.05066666666667,3.9253333333333273,374,382,8,ki_chroma_acts
266,5,187.05066666666667,190.976,3.9253333333333273,382,390,8,ki_chroma_acts
266,6,190.976,194.90133333333333,3.9253333333333273,390,398,8,ki_chroma_acts
266,7,194.90133333333333,196.864,1.9626666666666779,398,402,4,ki_chroma_acts
266,8,196.864,204.626,7.7620000000000005,402,416,14,ki_chroma_acts
266,1,0.0,35.43466666666667,35.43466666666667,0,73,73,ki_chroma_acts_smoothed
266,2,35.43466666666667,41.32266666666667,5.887999999999998,73,85,12,ki_chroma_acts_smoothed
266,3,41.32266666666667,90.38933333333334,49.06666666666667,85,185,100,ki_chroma_acts_smoothed
266,4,90.38933333333334,161.536,71.14666666666666,185,330,145,ki_chroma_acts_smoothed
266,5,161.536,169.38666666666666,7.850666666666655,330,346,16,ki_chroma_acts_smoothed
266,6,169.38666666666666,175.27466666666666,5.888000000000005,346,358,12,ki_chroma_acts_smoothed
266,7,175.27466666666666,190.976,15.701333333333338,358,390,32,ki_chroma_acts_smoothed
266,8,190.976,204.626,13.650000000000006,390,416,26,ki_chroma_acts_smoothed
267,1,0.0,25.962666666666667,25.962666666666667,0,56,56,chromagram
267,2,25.962666666666667,37.22666666666667,11.264,56,80,24,chromagram
267,3,37.22666666666667,53.184,15.957333333333331,80,114,34,chromagram
267,4,53.184,89.792,36.608000000000004,114,192,78,chromagram
267,5,89.792,96.832,7.039999999999992,192,207,15,chromagram
267,6,96.832,130.62400000000002,33.79200000000003,207,279,72,chromagram
267,7,130.62400000000002,156.90666666666667,26.282666666666643,279,335,56,chromagram
267,8,156.90666666666667,173.099,16.192333333333323,335,368,33,chromagram
267,1,0.0,63.04,63.04,0,135,135,chroma_acts
267,2,63.04,68.20266666666666,5.162666666666659,135,146,11,chroma_acts
267,3,68.20266666666666,78.05866666666667,9.856000000000009,146,167,21,chroma_acts
267,4,78.05866666666667,82.28266666666666,4.2239999999999895,167,176,9,chroma_acts
267,5,82.28266666666666,101.056,18.77333333333334,176,216,40,chroma_acts
267,6,101.056,130.62400000000002,29.568000000000026,216,279,63,chroma_acts
267,7,130.62400000000002,156.90666666666667,26.282666666666643,279,335,56,chroma_acts
267,8,156.90666666666667,173.099,16.192333333333323,335,368,33,chroma_acts
267,1,0.0,63.97866666666666,63.97866666666666,0,137,137,chroma_acts_smoothed
267,2,63.97866666666666,67.264,3.285333333333334,137,144,7,chroma_acts_smoothed
267,3,67.264,78.05866666666667,10.794666666666672,144,167,23,chroma_acts_smoothed
267,4,78.05866666666667,82.752,4.693333333333328,167,177,10,chroma_acts_smoothed
267,5,82.752,96.36266666666667,13.610666666666674,177,206,29,chroma_acts_smoothed
267,6,96.36266666666667,130.15466666666669,33.792000000000016,206,278,72,chroma_acts_smoothed
267,7,130.15466666666669,156.90666666666667,26.75199999999998,278,335,57,chroma_acts_smoothed
267,8,156.90666666666667,173.099,16.192333333333323,335,368,33,chroma_acts_smoothed
267,1,0.0,25.962666666666667,25.962666666666667,0,56,56,ki_chroma
267,2,25.962666666666667,37.22666666666667,11.264,56,80,24,ki_chroma
267,3,37.22666666666667,53.184,15.957333333333331,80,114,34,ki_chroma
267,4,53.184,89.792,36.608000000000004,114,192,78,ki_chroma
267,5,89.792,96.832,7.039999999999992,192,207,15,ki_chroma
267,6,96.832,130.62400000000002,33.79200000000003,207,279,72,ki_chroma
267,7,130.62400000000002,156.90666666666667,26.282666666666643,279,335,56,ki_chroma
267,8,156.90666666666667,173.099,16.192333333333323,335,368,33,ki_chroma
267,1,0.0,63.04,63.04,0,135,135,ki_chroma_acts
267,2,63.04,68.20266666666666,5.162666666666659,135,146,11,ki_chroma_acts
267,3,68.20266666666666,78.05866666666667,9.856000000000009,146,167,21,ki_chroma_acts
267,4,78.05866666666667,82.28266666666666,4.2239999999999895,167,176,9,ki_chroma_acts
267,5,82.28266666666666,101.056,18.77333333333334,176,216,40,ki_chroma_acts
267,6,101.056,130.62400000000002,29.568000000000026,216,279,63,ki_chroma_acts
267,7,130.62400000000002,156.90666666666667,26.282666666666643,279,335,56,ki_chroma_acts
267,8,156.90666666666667,173.099,16.192333333333323,335,368,33,ki_chroma_acts
267,1,0.0,63.97866666666666,63.97866666666666,0,137,137,ki_chroma_acts_smoothed
267,2,63.97866666666666,67.264,3.285333333333334,137,144,7,ki_chroma_acts_smoothed
267,3,67.264,78.05866666666667,10.794666666666672,144,167,23,ki_chroma_acts_smoothed
267,4,78.05866666666667,82.752,4.693333333333328,167,177,10,ki_chroma_acts_smoothed
267,5,82.752,96.36266666666667,13.610666666666674,177,206,29,ki_chroma_acts_smoothed
267,6,96.36266666666667,130.15466666666669,33.792000000000016,206,278,72,ki_chroma_acts_smoothed
267,7,130.15466666666669,156.90666666666667,26.75199999999998,278,335,57,ki_chroma_acts_smoothed
267,8,156.90666666666667,173.099,16.192333333333323,335,368,33,ki_chroma_acts_smoothed
268,1,0.0,22.101333333333336,22.101333333333336,0,54,54,chromagram
268,2,22.101333333333336,53.30133333333333,31.199999999999996,54,129,75,chromagram
268,3,53.30133333333333,78.26133333333334,24.960000000000008,129,189,60,chromagram
268,4,78.26133333333334,123.60533333333335,45.34400000000001,189,298,109,chromagram
268,5,123.60533333333335,133.17333333333335,9.567999999999998,298,321,23,chromagram
268,6,133.17333333333335,178.93333333333337,45.76000000000002,321,431,110,chromagram
268,7,178.93333333333337,180.18133333333336,1.2479999999999905,431,434,3,chromagram
268,8,180.18133333333336,213.333,33.15166666666664,434,512,78,chromagram
268,1,0.0,30.005333333333333,30.005333333333333,0,73,73,chroma_acts
268,2,30.005333333333333,33.333333333333336,3.328000000000003,73,81,8,chroma_acts
268,3,33.333333333333336,36.66133333333333,3.327999999999996,81,89,8,chroma_acts
268,4,36.66133333333333,53.30133333333333,16.64,89,129,40,chroma_acts
268,5,53.30133333333333,110.29333333333335,56.99200000000002,129,266,137,chroma_acts
268,6,110.29333333333335,113.62133333333335,3.328000000000003,266,274,8,chroma_acts
268,7,113.62133333333335,133.17333333333335,19.551999999999992,274,321,47,chroma_acts
268,8,133.17333333333335,186.83733333333336,53.664000000000016,321,450,129,chroma_acts
268,9,186.83733333333336,213.333,26.495666666666637,450,512,62,chroma_acts
268,1,0.0,22.101333333333336,22.101333333333336,0,54,54,chroma_acts_smoothed
268,2,22.101333333333336,53.30133333333333,31.199999999999996,54,129,75,chroma_acts_smoothed
268,3,53.30133333333333,109.87733333333335,56.57600000000002,129,265,136,chroma_acts_smoothed
268,4,109.87733333333335,113.62133333333335,3.7439999999999998,265,274,9,chroma_acts_smoothed
268,5,113.62133333333335,116.53333333333335,2.911999999999992,274,281,7,chroma_acts_smoothed
268,6,116.53333333333335,133.17333333333335,16.64,281,321,40,chroma_acts_smoothed
268,7,133.17333333333335,186.83733333333336,53.664000000000016,321,450,129,chroma_acts_smoothed
268,8,186.83733333333336,204.72533333333337,17.888000000000005,450,493,43,chroma_acts_smoothed
268,9,204.72533333333337,213.333,8.607666666666631,493,512,19,chroma_acts_smoothed
268,1,0.0,22.101333333333336,22.101333333333336,0,54,54,ki_chroma
268,2,22.101333333333336,53.30133333333333,31.199999999999996,54,129,75,ki_chroma
268,3,53.30133333333333,78.26133333333334,24.960000000000008,129,189,60,ki_chroma
268,4,78.26133333333334,123.60533333333335,45.34400000000001,189,298,109,ki_chroma
268,5,123.60533333333335,133.17333333333335,9.567999999999998,298,321,23,ki_chroma
268,6,133.17333333333335,178.93333333333337,45.76000000000002,321,431,110,ki_chroma
268,7,178.93333333333337,180.18133333333336,1.2479999999999905,431,434,3,ki_chroma
268,8,180.18133333333336,213.333,33.15166666666664,434,512,78,ki_chroma
268,1,0.0,30.005333333333333,30.005333333333333,0,73,73,ki_chroma_acts
268,2,30.005333333333333,33.333333333333336,3.328000000000003,73,81,8,ki_chroma_acts
268,3,33.333333333333336,36.66133333333333,3.327999999999996,81,89,8,ki_chroma_acts
268,4,36.66133333333333,53.30133333333333,16.64,89,129,40,ki_chroma_acts
268,5,53.30133333333333,110.29333333333335,56.99200000000002,129,266,137,ki_chroma_acts
268,6,110.29333333333335,113.62133333333335,3.328000000000003,266,274,8,ki_chroma_acts
268,7,113.62133333333335,133.17333333333335,19.551999999999992,274,321,47,ki_chroma_acts
268,8,133.17333333333335,186.83733333333336,53.664000000000016,321,450,129,ki_chroma_acts
268,9,186.83733333333336,213.333,26.495666666666637,450,512,62,ki_chroma_acts
268,1,0.0,22.101333333333336,22.101333333333336,0,54,54,ki_chroma_acts_smoothed
268,2,22.101333333333336,53.30133333333333,31.199999999999996,54,129,75,ki_chroma_acts_smoothed
268,3,53.30133333333333,109.87733333333335,56.57600000000002,129,265,136,ki_chroma_acts_smoothed
268,4,109.87733333333335,113.62133333333335,3.7439999999999998,265,274,9,ki_chroma_acts_smoothed
268,5,113.62133333333335,116.53333333333335,2.911999999999992,274,281,7,ki_chroma_acts_smoothed
268,6,116.53333333333335,133.17333333333335,16.64,281,321,40,ki_chroma_acts_smoothed
268,7,133.17333333333335,186.83733333333336,53.664000000000016,321,450,129,ki_chroma_acts_smoothed
268,8,186.83733333333336,204.72533333333337,17.888000000000005,450,493,43,ki_chroma_acts_smoothed
268,9,204.72533333333337,213.333,8.607666666666631,493,512,19,ki_chroma_acts_smoothed
269,1,0.0,41.19466666666666,41.19466666666666,0,60,60,chromagram
269,2,41.19466666666666,44.66133333333333,3.4666666666666686,60,65,5,chromagram
269,3,44.66133333333333,57.834666666666664,13.173333333333332,65,84,19,chromagram
269,4,57.834666666666664,59.221333333333334,1.3866666666666703,84,86,2,chromagram
269,5,59.221333333333334,103.59466666666667,44.373333333333335,86,150,64,chromagram
269,6,103.59466666666667,118.848,15.25333333333333,150,172,22,chromagram
269,7,118.848,132.02133333333336,13.17333333333336,172,191,19,chromagram
269,8,132.02133333333336,175.008,42.98666666666665,191,253,62,chromagram
269,9,175.008,183.19,8.181999999999988,253,263,10,chromagram
269,1,0.0,41.19466666666666,41.19466666666666,0,60,60,chroma_acts
269,2,41.19466666666666,57.834666666666664,16.64,60,84,24,chroma_acts
269,3,57.834666666666664,59.221333333333334,1.3866666666666703,84,86,2,chroma_acts
269,4,59.221333333333334,103.59466666666667,44.373333333333335,86,150,64,chroma_acts
269,5,103.59466666666667,118.848,15.25333333333333,150,172,22,chroma_acts
269,6,118.848,132.02133333333336,13.17333333333336,172,191,19,chroma_acts
269,7,132.02133333333336,175.008,42.98666666666665,191,253,62,chroma_acts
269,8,175.008,183.19,8.181999999999988,253,263,10,chroma_acts
269,1,0.0,28.021333333333335,28.021333333333335,0,41,41,chroma_acts_smoothed
269,2,28.021333333333335,41.19466666666666,13.173333333333328,41,60,19,chroma_acts_smoothed
269,3,41.19466666666666,44.66133333333333,3.4666666666666686,60,65,5,chroma_acts_smoothed
269,4,44.66133333333333,103.59466666666667,58.93333333333334,65,150,85,chroma_acts_smoothed
269,5,103.59466666666667,118.848,15.25333333333333,150,172,22,chroma_acts_smoothed
269,6,118.848,132.02133333333336,13.17333333333336,172,191,19,chroma_acts_smoothed
269,7,132.02133333333336,175.008,42.98666666666665,191,253,62,chroma_acts_smoothed
269,8,175.008,183.19,8.181999999999988,253,263,10,chroma_acts_smoothed
269,1,0.0,41.19466666666666,41.19466666666666,0,60,60,ki_chroma
269,2,41.19466666666666,44.66133333333333,3.4666666666666686,60,65,5,ki_chroma
269,3,44.66133333333333,57.834666666666664,13.173333333333332,65,84,19,ki_chroma
269,4,57.834666666666664,59.221333333333334,1.3866666666666703,84,86,2,ki_chroma
269,5,59.221333333333334,103.59466666666667,44.373333333333335,86,150,64,ki_chroma
269,6,103.59466666666667,118.848,15.25333333333333,150,172,22,ki_chroma
269,7,118.848,132.02133333333336,13.17333333333336,172,191,19,ki_chroma
269,8,132.02133333333336,175.008,42.98666666666665,191,253,62,ki_chroma
269,9,175.008,183.19,8.181999999999988,253,263,10,ki_chroma
269,1,0.0,41.19466666666666,41.19466666666666,0,60,60,ki_chroma_acts
269,2,41.19466666666666,57.834666666666664,16.64,60,84,24,ki_chroma_acts
269,3,57.834666666666664,59.221333333333334,1.3866666666666703,84,86,2,ki_chroma_acts
269,4,59.221333333333334,103.59466666666667,44.373333333333335,86,150,64,ki_chroma_acts
269,5,103.59466666666667,118.848,15.25333333333333,150,172,22,ki_chroma_acts
269,6,118.848,132.02133333333336,13.17333333333336,172,191,19,ki_chroma_acts
269,7,132.02133333333336,175.008,42.98666666666665,191,253,62,ki_chroma_acts
269,8,175.008,183.19,8.181999999999988,253,263,10,ki_chroma_acts
269,1,0.0,28.021333333333335,28.021333333333335,0,41,41,ki_chroma_acts_smoothed
269,2,28.021333333333335,41.19466666666666,13.173333333333328,41,60,19,ki_chroma_acts_smoothed
269,3,41.19466666666666,44.66133333333333,3.4666666666666686,60,65,5,ki_chroma_acts_smoothed
269,4,44.66133333333333,103.59466666666667,58.93333333333334,65,150,85,ki_chroma_acts_smoothed
269,5,103.59466666666667,118.848,15.25333333333333,150,172,22,ki_chroma_acts_smoothed
269,6,118.848,132.02133333333336,13.17333333333336,172,191,19,ki_chroma_acts_smoothed
269,7,132.02133333333336,175.008,42.98666666666665,191,253,62,ki_chroma_acts_smoothed
269,8,175.008,183.19,8.181999999999988,253,263,10,ki_chroma_acts_smoothed
273,1,0.0,39.08266666666667,39.08266666666667,0,64,64,chromagram
273,2,39.08266666666667,45.269333333333336,6.186666666666667,64,74,10,chromagram
273,3,45.269333333333336,67.54133333333334,22.272000000000006,74,110,36,chromagram
273,4,67.54133333333334,94.76266666666668,27.221333333333334,110,154,44,chromagram
273,5,94.76266666666668,153.536,58.773333333333326,154,249,95,chromagram
273,6,153.536,167.76533333333333,14.22933333333333,249,272,23,chromagram
273,7,167.76533333333333,192.512,24.74666666666667,272,312,40,chromagram
273,8,192.512,225.30133333333333,32.78933333333333,312,365,53,chromagram
273,9,225.30133333333333,240.025,14.723666666666674,365,387,22,chromagram
273,1,0.0,39.08266666666667,39.08266666666667,0,64,64,chroma_acts
273,2,39.08266666666667,67.54133333333334,28.458666666666673,64,110,46,chroma_acts
273,3,67.54133333333334,94.76266666666668,27.221333333333334,110,154,44,chroma_acts
273,4,94.76266666666668,125.07733333333334,30.314666666666668,154,203,49,chroma_acts
273,5,125.07733333333334,132.50133333333332,7.423999999999978,203,215,12,chroma_acts
273,6,132.50133333333332,153.536,21.03466666666668,215,249,34,chroma_acts
273,7,153.536,167.76533333333333,14.22933333333333,249,272,23,chroma_acts
273,8,167.76533333333333,192.512,24.74666666666667,272,312,40,chroma_acts
273,9,192.512,240.025,47.513000000000005,312,387,75,chroma_acts
273,1,0.0,39.08266666666667,39.08266666666667,0,64,64,chroma_acts_smoothed
273,2,39.08266666666667,67.54133333333334,28.458666666666673,64,110,46,chroma_acts_smoothed
273,3,67.54133333333334,94.76266666666668,27.221333333333334,110,154,44,chroma_acts_smoothed
273,4,94.76266666666668,125.07733333333334,30.314666666666668,154,203,49,chroma_acts_smoothed
273,5,125.07733333333334,142.4,17.322666666666663,203,231,28,chroma_acts_smoothed
273,6,142.4,152.91733333333332,10.517333333333312,231,248,17,chroma_acts_smoothed
273,7,152.91733333333332,167.76533333333333,14.848000000000013,248,272,24,chroma_acts_smoothed
273,8,167.76533333333333,192.512,24.74666666666667,272,312,40,chroma_acts_smoothed
273,9,192.512,240.025,47.513000000000005,312,387,75,chroma_acts_smoothed
273,1,0.0,39.08266666666667,39.08266666666667,0,64,64,ki_chroma
273,2,39.08266666666667,45.269333333333336,6.186666666666667,64,74,10,ki_chroma
273,3,45.269333333333336,67.54133333333334,22.272000000000006,74,110,36,ki_chroma
273,4,67.54133333333334,94.76266666666668,27.221333333333334,110,154,44,ki_chroma
273,5,94.76266666666668,153.536,58.773333333333326,154,249,95,ki_chroma
273,6,153.536,167.76533333333333,14.22933333333333,249,272,23,ki_chroma
273,7,167.76533333333333,192.512,24.74666666666667,272,312,40,ki_chroma
273,8,192.512,225.30133333333333,32.78933333333333,312,365,53,ki_chroma
273,9,225.30133333333333,240.025,14.723666666666674,365,387,22,ki_chroma
273,1,0.0,39.08266666666667,39.08266666666667,0,64,64,ki_chroma_acts
273,2,39.08266666666667,67.54133333333334,28.458666666666673,64,110,46,ki_chroma_acts
273,3,67.54133333333334,94.76266666666668,27.221333333333334,110,154,44,ki_chroma_acts
273,4,94.76266666666668,125.07733333333334,30.314666666666668,154,203,49,ki_chroma_acts
273,5,125.07733333333334,132.50133333333332,7.423999999999978,203,215,12,ki_chroma_acts
273,6,132.50133333333332,153.536,21.03466666666668,215,249,34,ki_chroma_acts
273,7,153.536,167.76533333333333,14.22933333333333,249,272,23,ki_chroma_acts
273,8,167.76533333333333,192.512,24.74666666666667,272,312,40,ki_chroma_acts
273,9,192.512,240.025,47.513000000000005,312,387,75,ki_chroma_acts
273,1,0.0,39.08266666666667,39.08266666666667,0,64,64,ki_chroma_acts_smoothed
273,2,39.08266666666667,67.54133333333334,28.458666666666673,64,110,46,ki_chroma_acts_smoothed
273,3,67.54133333333334,94.76266666666668,27.221333333333334,110,154,44,ki_chroma_acts_smoothed
273,4,94.76266666666668,125.07733333333334,30.314666666666668,154,203,49,ki_chroma_acts_smoothed
273,5,125.07733333333334,142.4,17.322666666666663,203,231,28,ki_chroma_acts_smoothed
273,6,142.4,152.91733333333332,10.517333333333312,231,248,17,ki_chroma_acts_smoothed
273,7,152.91733333333332,167.76533333333333,14.848000000000013,248,272,24,ki_chroma_acts_smoothed
273,8,167.76533333333333,192.512,24.74666666666667,272,312,40,ki_chroma_acts_smoothed
273,9,192.512,240.025,47.513000000000005,312,387,75,ki_chroma_acts_smoothed
275,1,0.0,15.733333333333334,15.733333333333334,0,34,34,chromagram
275,2,15.733333333333334,73.93066666666667,58.19733333333333,34,158,124,chromagram
275,3,73.93066666666667,81.44,7.5093333333333305,158,174,16,chromagram
275,4,81.44,84.72533333333334,3.285333333333341,174,181,7,chromagram
275,5,84.72533333333334,98.336,13.61066666666666,181,210,29,chromagram
275,6,98.336,104.43733333333333,6.101333333333329,210,223,13,chromagram
275,7,104.43733333333333,120.864,16.426666666666677,223,258,35,chromagram
275,8,120.864,134.00533333333334,13.141333333333336,258,286,28,chromagram
275,9,134.00533333333334,166.733,32.727666666666664,286,354,68,chromagram
275,1,0.0,15.733333333333334,15.733333333333334,0,34,34,chroma_acts
275,2,15.733333333333334,73.93066666666667,58.19733333333333,34,158,124,chroma_acts
275,3,73.93066666666667,87.072,13.141333333333336,158,186,28,chroma_acts
275,4,87.072,112.88533333333334,25.813333333333333,186,241,55,chroma_acts
275,5,112.88533333333334,120.864,7.978666666666669,241,258,17,chroma_acts
275,6,120.864,134.00533333333334,13.141333333333336,258,286,28,chroma_acts
275,7,134.00533333333334,135.88266666666667,1.8773333333333255,286,290,4,chroma_acts
275,8,135.88266666666667,166.733,30.85033333333334,290,354,64,chroma_acts
275,1,0.0,15.733333333333334,15.733333333333334,0,34,34,chroma_acts_smoothed
275,2,15.733333333333334,73.93066666666667,58.19733333333333,34,158,124,chroma_acts_smoothed
275,3,73.93066666666667,81.44,7.5093333333333305,158,174,16,chroma_acts_smoothed
275,4,81.44,85.19466666666666,3.7546666666666653,174,182,8,chroma_acts_smoothed
275,5,85.19466666666666,112.88533333333334,27.690666666666672,182,241,59,chroma_acts_smoothed
275,6,112.88533333333334,120.864,7.978666666666669,241,258,17,chroma_acts_smoothed
275,7,120.864,133.536,12.671999999999997,258,285,27,chroma_acts_smoothed
275,8,133.536,166.733,33.197,285,354,69,chroma_acts_smoothed
275,1,0.0,15.733333333333334,15.733333333333334,0,34,34,ki_chroma
275,2,15.733333333333334,73.93066666666667,58.19733333333333,34,158,124,ki_chroma
275,3,73.93066666666667,81.44,7.5093333333333305,158,174,16,ki_chroma
275,4,81.44,84.72533333333334,3.285333333333341,174,181,7,ki_chroma
275,5,84.72533333333334,98.336,13.61066666666666,181,210,29,ki_chroma
275,6,98.336,104.43733333333333,6.101333333333329,210,223,13,ki_chroma
275,7,104.43733333333333,120.864,16.426666666666677,223,258,35,ki_chroma
275,8,120.864,134.00533333333334,13.141333333333336,258,286,28,ki_chroma
275,9,134.00533333333334,166.733,32.727666666666664,286,354,68,ki_chroma
275,1,0.0,15.733333333333334,15.733333333333334,0,34,34,ki_chroma_acts
275,2,15.733333333333334,73.93066666666667,58.19733333333333,34,158,124,ki_chroma_acts
275,3,73.93066666666667,87.072,13.141333333333336,158,186,28,ki_chroma_acts
275,4,87.072,112.88533333333334,25.813333333333333,186,241,55,ki_chroma_acts
275,5,112.88533333333334,120.864,7.978666666666669,241,258,17,ki_chroma_acts
275,6,120.864,134.00533333333334,13.141333333333336,258,286,28,ki_chroma_acts
275,7,134.00533333333334,135.88266666666667,1.8773333333333255,286,290,4,ki_chroma_acts
275,8,135.88266666666667,166.733,30.85033333333334,290,354,64,ki_chroma_acts
275,1,0.0,15.733333333333334,15.733333333333334,0,34,34,ki_chroma_acts_smoothed
275,2,15.733333333333334,73.93066666666667,58.19733333333333,34,158,124,ki_chroma_acts_smoothed
275,3,73.93066666666667,81.44,7.5093333333333305,158,174,16,ki_chroma_acts_smoothed
275,4,81.44,85.19466666666666,3.7546666666666653,174,182,8,ki_chroma_acts_smoothed
275,5,85.19466666666666,112.88533333333334,27.690666666666672,182,241,59,ki_chroma_acts_smoothed
275,6,112.88533333333334,120.864,7.978666666666669,241,258,17,ki_chroma_acts_smoothed
275,7,120.864,133.536,12.671999999999997,258,285,27,ki_chroma_acts_smoothed
275,8,133.536,166.733,33.197,285,354,69,ki_chroma_acts_smoothed
279,1,0.0,30.272,30.272,0,64,64,chromagram
279,2,30.272,76.352,46.080000000000005,64,160,96,chromagram
279,3,76.352,91.232,14.879999999999995,160,191,31,chromagram
279,4,91.232,120.99199999999999,29.75999999999999,191,253,62,chromagram
279,5,120.99199999999999,136.832,15.840000000000003,253,286,33,chromagram
279,6,136.832,167.552,30.72,286,350,64,chromagram
279,7,167.552,217.952,50.400000000000006,350,455,105,chromagram
279,8,217.952,228.512,10.560000000000002,455,477,22,chromagram
279,9,228.512,304.763,76.25099999999998,477,634,157,chromagram
279,1,0.0,30.272,30.272,0,64,64,chroma_acts
279,2,30.272,84.032,53.76,64,176,112,chroma_acts
279,3,84.032,91.232,7.200000000000003,176,191,15,chroma_acts
279,4,91.232,120.99199999999999,29.75999999999999,191,253,62,chroma_acts
279,5,120.99199999999999,135.392,14.400000000000006,253,283,30,chroma_acts
279,6,135.392,167.552,32.16,283,350,67,chroma_acts
279,7,167.552,213.632,46.08000000000001,350,446,96,chroma_acts
279,8,213.632,228.512,14.879999999999995,446,477,31,chroma_acts
279,9,228.512,304.763,76.25099999999998,477,634,157,chroma_acts
279,1,0.0,28.832,28.832,0,61,61,chroma_acts_smoothed
279,2,28.832,83.55199999999999,54.71999999999999,61,175,114,chroma_acts_smoothed
279,3,83.55199999999999,91.232,7.680000000000007,175,191,16,chroma_acts_smoothed
279,4,91.232,120.99199999999999,29.75999999999999,191,253,62,chroma_acts_smoothed
279,5,120.99199999999999,134.912,13.920000000000016,253,282,29,chroma_acts_smoothed
279,6,134.912,165.632,30.72,282,346,64,chroma_acts_smoothed
279,7,165.632,213.632,48.0,346,446,100,chroma_acts_smoothed
279,8,213.632,228.512,14.879999999999995,446,477,31,chroma_acts_smoothed
279,9,228.512,304.763,76.25099999999998,477,634,157,chroma_acts_smoothed
279,1,0.0,30.272,30.272,0,64,64,ki_chroma
279,2,30.272,76.352,46.080000000000005,64,160,96,ki_chroma
279,3,76.352,91.232,14.879999999999995,160,191,31,ki_chroma
279,4,91.232,120.99199999999999,29.75999999999999,191,253,62,ki_chroma
279,5,120.99199999999999,136.832,15.840000000000003,253,286,33,ki_chroma
279,6,136.832,167.552,30.72,286,350,64,ki_chroma
279,7,167.552,217.952,50.400000000000006,350,455,105,ki_chroma
279,8,217.952,228.512,10.560000000000002,455,477,22,ki_chroma
279,9,228.512,304.763,76.25099999999998,477,634,157,ki_chroma
279,1,0.0,30.272,30.272,0,64,64,ki_chroma_acts
279,2,30.272,84.032,53.76,64,176,112,ki_chroma_acts
279,3,84.032,91.232,7.200000000000003,176,191,15,ki_chroma_acts
279,4,91.232,120.99199999999999,29.75999999999999,191,253,62,ki_chroma_acts
279,5,120.99199999999999,135.392,14.400000000000006,253,283,30,ki_chroma_acts
279,6,135.392,167.552,32.16,283,350,67,ki_chroma_acts
279,7,167.552,213.632,46.08000000000001,350,446,96,ki_chroma_acts
279,8,213.632,228.512,14.879999999999995,446,477,31,ki_chroma_acts
279,9,228.512,304.763,76.25099999999998,477,634,157,ki_chroma_acts
279,1,0.0,28.832,28.832,0,61,61,ki_chroma_acts_smoothed
279,2,28.832,83.55199999999999,54.71999999999999,61,175,114,ki_chroma_acts_smoothed
279,3,83.55199999999999,91.232,7.680000000000007,175,191,16,ki_chroma_acts_smoothed
279,4,91.232,120.99199999999999,29.75999999999999,191,253,62,ki_chroma_acts_smoothed
279,5,120.99199999999999,134.912,13.920000000000016,253,282,29,ki_chroma_acts_smoothed
279,6,134.912,165.632,30.72,282,346,64,ki_chroma_acts_smoothed
279,7,165.632,213.632,48.0,346,446,100,ki_chroma_acts_smoothed
279,8,213.632,228.512,14.879999999999995,446,477,31,ki_chroma_acts_smoothed
279,9,228.512,304.763,76.25099999999998,477,634,157,ki_chroma_acts_smoothed
280,1,0.0,28.66133333333333,28.66133333333333,0,62,62,chromagram
280,2,28.66133333333333,63.86133333333333,35.199999999999996,62,137,75,chromagram
280,3,63.86133333333333,105.16266666666667,41.30133333333334,137,225,88,chromagram
280,4,105.16266666666667,122.05866666666667,16.896,225,261,36,chromagram
280,5,122.05866666666667,172.27733333333333,50.218666666666664,261,368,107,chromagram
280,6,172.27733333333333,210.29333333333335,38.01600000000002,368,449,81,chromagram
280,7,210.29333333333335,213.57866666666666,3.2853333333333126,449,456,7,chromagram
280,8,213.57866666666666,244.481,30.90233333333333,456,520,64,chromagram
280,1,0.0,28.66133333333333,28.66133333333333,0,62,62,chroma_acts
280,2,28.66133333333333,62.922666666666665,34.26133333333333,62,135,73,chroma_acts
280,3,62.922666666666665,105.16266666666667,42.24,135,225,90,chroma_acts
280,4,105.16266666666667,130.5066666666667,25.344000000000023,225,279,54,chroma_acts
280,5,130.5066666666667,172.27733333333333,41.77066666666664,279,368,89,chroma_acts
280,6,172.27733333333333,210.29333333333335,38.01600000000002,368,449,81,chroma_acts
280,7,210.29333333333335,213.57866666666666,3.2853333333333126,449,456,7,chroma_acts
280,8,213.57866666666666,244.481,30.90233333333333,456,520,64,chroma_acts
280,1,0.0,28.192,28.192,0,61,61,chroma_acts_smoothed
280,2,28.192,62.922666666666665,34.730666666666664,61,135,74,chroma_acts_smoothed
280,3,62.922666666666665,105.16266666666667,42.24,135,225,90,chroma_acts_smoothed
280,4,105.16266666666667,130.976,25.813333333333333,225,280,55,chroma_acts_smoothed
280,5,130.976,172.27733333333333,41.30133333333333,280,368,88,chroma_acts_smoothed
280,6,172.27733333333333,209.824,37.54666666666668,368,448,80,chroma_acts_smoothed
280,7,209.824,214.048,4.2239999999999895,448,457,9,chroma_acts_smoothed
280,8,214.048,244.481,30.432999999999993,457,520,63,chroma_acts_smoothed
280,1,0.0,28.66133333333333,28.66133333333333,0,62,62,ki_chroma
280,2,28.66133333333333,63.86133333333333,35.199999999999996,62,137,75,ki_chroma
280,3,63.86133333333333,105.16266666666667,41.30133333333334,137,225,88,ki_chroma
280,4,105.16266666666667,122.05866666666667,16.896,225,261,36,ki_chroma
280,5,122.05866666666667,172.27733333333333,50.218666666666664,261,368,107,ki_chroma
280,6,172.27733333333333,210.29333333333335,38.01600000000002,368,449,81,ki_chroma
280,7,210.29333333333335,213.57866666666666,3.2853333333333126,449,456,7,ki_chroma
280,8,213.57866666666666,244.481,30.90233333333333,456,520,64,ki_chroma
280,1,0.0,28.66133333333333,28.66133333333333,0,62,62,ki_chroma_acts
280,2,28.66133333333333,62.922666666666665,34.26133333333333,62,135,73,ki_chroma_acts
280,3,62.922666666666665,105.16266666666667,42.24,135,225,90,ki_chroma_acts
280,4,105.16266666666667,130.5066666666667,25.344000000000023,225,279,54,ki_chroma_acts
280,5,130.5066666666667,172.27733333333333,41.77066666666664,279,368,89,ki_chroma_acts
280,6,172.27733333333333,210.29333333333335,38.01600000000002,368,449,81,ki_chroma_acts
280,7,210.29333333333335,213.57866666666666,3.2853333333333126,449,456,7,ki_chroma_acts
280,8,213.57866666666666,244.481,30.90233333333333,456,520,64,ki_chroma_acts
280,1,0.0,28.192,28.192,0,61,61,ki_chroma_acts_smoothed
280,2,28.192,62.922666666666665,34.730666666666664,61,135,74,ki_chroma_acts_smoothed
280,3,62.922666666666665,105.16266666666667,42.24,135,225,90,ki_chroma_acts_smoothed
280,4,105.16266666666667,130.976,25.813333333333333,225,280,55,ki_chroma_acts_smoothed
280,5,130.976,172.27733333333333,41.30133333333333,280,368,88,ki_chroma_acts_smoothed
280,6,172.27733333333333,209.824,37.54666666666668,368,448,80,ki_chroma_acts_smoothed
280,7,209.824,214.048,4.2239999999999895,448,457,9,ki_chroma_acts_smoothed
280,8,214.048,244.481,30.432999999999993,457,520,63,ki_chroma_acts_smoothed
281,1,0.0,44.672000000000004,44.672000000000004,0,92,92,chromagram
281,2,44.672000000000004,77.05600000000001,32.38400000000001,92,158,66,chromagram
281,3,77.05600000000001,123.17866666666667,46.12266666666666,158,252,94,chromagram
281,4,123.17866666666667,129.55733333333333,6.3786666666666605,252,265,13,chromagram
281,5,129.55733333333333,180.096,50.53866666666667,265,368,103,chromagram
281,6,180.096,186.47466666666668,6.378666666666675,368,381,13,chromagram
281,7,186.47466666666668,253.20533333333336,66.73066666666668,381,517,136,chromagram
281,8,253.20533333333336,268.659,15.453666666666635,517,547,30,chromagram
281,1,0.0,44.672000000000004,44.672000000000004,0,92,92,chroma_acts
281,2,44.672000000000004,74.11200000000001,29.440000000000005,92,152,60,chroma_acts
281,3,74.11200000000001,77.05600000000001,2.9440000000000026,152,158,6,chroma_acts
281,4,77.05600000000001,124.16000000000001,47.104,158,254,96,chroma_acts
281,5,124.16000000000001,183.04000000000002,58.88000000000001,254,374,120,chroma_acts
281,6,183.04000000000002,186.47466666666668,3.434666666666658,374,381,7,chroma_acts
281,7,186.47466666666668,252.22400000000002,65.74933333333334,381,515,134,chroma_acts
281,8,252.22400000000002,268.659,16.434999999999974,515,547,32,chroma_acts
281,1,0.0,44.672000000000004,44.672000000000004,0,92,92,chroma_acts_smoothed
281,2,44.672000000000004,77.05600000000001,32.38400000000001,92,158,66,chroma_acts_smoothed
281,3,77.05600000000001,123.66933333333334,46.61333333333333,158,253,95,chroma_acts_smoothed
281,4,123.66933333333334,128.57600000000002,4.9066666666666805,253,263,10,chroma_acts_smoothed
281,5,128.57600000000002,180.096,51.51999999999998,263,368,105,chroma_acts_smoothed
281,6,180.096,186.96533333333335,6.869333333333344,368,382,14,chroma_acts_smoothed
281,7,186.96533333333335,252.22400000000002,65.25866666666667,382,515,133,chroma_acts_smoothed
281,8,252.22400000000002,268.659,16.434999999999974,515,547,32,chroma_acts_smoothed
281,1,0.0,44.672000000000004,44.672000000000004,0,92,92,ki_chroma
281,2,44.672000000000004,77.05600000000001,32.38400000000001,92,158,66,ki_chroma
281,3,77.05600000000001,123.17866666666667,46.12266666666666,158,252,94,ki_chroma
281,4,123.17866666666667,129.55733333333333,6.3786666666666605,252,265,13,ki_chroma
281,5,129.55733333333333,180.096,50.53866666666667,265,368,103,ki_chroma
281,6,180.096,186.47466666666668,6.378666666666675,368,381,13,ki_chroma
281,7,186.47466666666668,253.20533333333336,66.73066666666668,381,517,136,ki_chroma
281,8,253.20533333333336,268.659,15.453666666666635,517,547,30,ki_chroma
281,1,0.0,44.672000000000004,44.672000000000004,0,92,92,ki_chroma_acts
281,2,44.672000000000004,74.11200000000001,29.440000000000005,92,152,60,ki_chroma_acts
281,3,74.11200000000001,77.05600000000001,2.9440000000000026,152,158,6,ki_chroma_acts
281,4,77.05600000000001,124.16000000000001,47.104,158,254,96,ki_chroma_acts
281,5,124.16000000000001,183.04000000000002,58.88000000000001,254,374,120,ki_chroma_acts
281,6,183.04000000000002,186.47466666666668,3.434666666666658,374,381,7,ki_chroma_acts
281,7,186.47466666666668,252.22400000000002,65.74933333333334,381,515,134,ki_chroma_acts
281,8,252.22400000000002,268.659,16.434999999999974,515,547,32,ki_chroma_acts
281,1,0.0,44.672000000000004,44.672000000000004,0,92,92,ki_chroma_acts_smoothed
281,2,44.672000000000004,77.05600000000001,32.38400000000001,92,158,66,ki_chroma_acts_smoothed
281,3,77.05600000000001,123.66933333333334,46.61333333333333,158,253,95,ki_chroma_acts_smoothed
281,4,123.66933333333334,128.57600000000002,4.9066666666666805,253,263,10,ki_chroma_acts_smoothed
281,5,128.57600000000002,180.096,51.51999999999998,263,368,105,ki_chroma_acts_smoothed
281,6,180.096,186.96533333333335,6.869333333333344,368,382,14,ki_chroma_acts_smoothed
281,7,186.96533333333335,252.22400000000002,65.25866666666667,382,515,133,ki_chroma_acts_smoothed
281,8,252.22400000000002,268.659,16.434999999999974,515,547,32,ki_chroma_acts_smoothed
282,1,0.0,29.48266666666667,29.48266666666667,0,61,61,chromagram
282,2,29.48266666666667,47.14666666666667,17.663999999999998,61,97,36,chromagram
282,3,47.14666666666667,86.89066666666668,39.74400000000001,97,178,81,chromagram
282,4,86.89066666666668,141.35466666666667,54.464,178,289,111,chromagram
282,5,141.35466666666667,160.98133333333334,19.626666666666665,289,329,40,chromagram
282,6,160.98133333333334,204.65066666666667,43.66933333333333,329,418,89,chromagram
282,7,204.65066666666667,213.4826666666667,8.832000000000022,418,436,18,chromagram
282,8,213.4826666666667,267.456,53.97333333333333,436,546,110,chromagram
282,9,267.456,284.97,17.51400000000001,546,580,34,chromagram
282,1,0.0,29.48266666666667,29.48266666666667,0,61,61,chroma_acts
282,2,29.48266666666667,78.54933333333334,49.06666666666666,61,161,100,chroma_acts
282,3,78.54933333333334,86.89066666666668,8.341333333333338,161,178,17,chroma_acts
282,4,86.89066666666668,141.35466666666667,54.464,178,289,111,chroma_acts
282,5,141.35466666666667,160.98133333333334,19.626666666666665,289,329,40,chroma_acts
282,6,160.98133333333334,204.65066666666667,43.66933333333333,329,418,89,chroma_acts
282,7,204.65066666666667,213.4826666666667,8.832000000000022,418,436,18,chroma_acts
282,8,213.4826666666667,266.9653333333334,53.48266666666669,436,545,109,chroma_acts
282,9,266.9653333333334,284.97,18.00466666666665,545,580,35,chroma_acts
282,1,0.0,29.48266666666667,29.48266666666667,0,61,61,chroma_acts_smoothed
282,2,29.48266666666667,79.04,49.55733333333333,61,162,101,chroma_acts_smoothed
282,3,79.04,86.89066666666668,7.850666666666669,162,178,16,chroma_acts_smoothed
282,4,86.89066666666668,141.35466666666667,54.464,178,289,111,chroma_acts_smoothed
282,5,141.35466666666667,160.98133333333334,19.626666666666665,289,329,40,chroma_acts_smoothed
282,6,160.98133333333334,205.14133333333334,44.16,329,419,90,chroma_acts_smoothed
282,7,205.14133333333334,213.4826666666667,8.341333333333353,419,436,17,chroma_acts_smoothed
282,8,213.4826666666667,267.456,53.97333333333333,436,546,110,chroma_acts_smoothed
282,9,267.456,284.97,17.51400000000001,546,580,34,chroma_acts_smoothed
282,1,0.0,29.48266666666667,29.48266666666667,0,61,61,ki_chroma
282,2,29.48266666666667,47.14666666666667,17.663999999999998,61,97,36,ki_chroma
282,3,47.14666666666667,86.89066666666668,39.74400000000001,97,178,81,ki_chroma
282,4,86.89066666666668,141.35466666666667,54.464,178,289,111,ki_chroma
282,5,141.35466666666667,160.98133333333334,19.626666666666665,289,329,40,ki_chroma
282,6,160.98133333333334,204.65066666666667,43.66933333333333,329,418,89,ki_chroma
282,7,204.65066666666667,213.4826666666667,8.832000000000022,418,436,18,ki_chroma
282,8,213.4826666666667,267.456,53.97333333333333,436,546,110,ki_chroma
282,9,267.456,284.97,17.51400000000001,546,580,34,ki_chroma
282,1,0.0,29.48266666666667,29.48266666666667,0,61,61,ki_chroma_acts
282,2,29.48266666666667,78.54933333333334,49.06666666666666,61,161,100,ki_chroma_acts
282,3,78.54933333333334,86.89066666666668,8.341333333333338,161,178,17,ki_chroma_acts
282,4,86.89066666666668,141.35466666666667,54.464,178,289,111,ki_chroma_acts
282,5,141.35466666666667,160.98133333333334,19.626666666666665,289,329,40,ki_chroma_acts
282,6,160.98133333333334,204.65066666666667,43.66933333333333,329,418,89,ki_chroma_acts
282,7,204.65066666666667,213.4826666666667,8.832000000000022,418,436,18,ki_chroma_acts
282,8,213.4826666666667,266.9653333333334,53.48266666666669,436,545,109,ki_chroma_acts
282,9,266.9653333333334,284.97,18.00466666666665,545,580,35,ki_chroma_acts
282,1,0.0,29.48266666666667,29.48266666666667,0,61,61,ki_chroma_acts_smoothed
282,2,29.48266666666667,79.04,49.55733333333333,61,162,101,ki_chroma_acts_smoothed
282,3,79.04,86.89066666666668,7.850666666666669,162,178,16,ki_chroma_acts_smoothed
282,4,86.89066666666668,141.35466666666667,54.464,178,289,111,ki_chroma_acts_smoothed
282,5,141.35466666666667,160.98133333333334,19.626666666666665,289,329,40,ki_chroma_acts_smoothed
282,6,160.98133333333334,205.14133333333334,44.16,329,419,90,ki_chroma_acts_smoothed
282,7,205.14133333333334,213.4826666666667,8.341333333333353,419,436,17,ki_chroma_acts_smoothed
282,8,213.4826666666667,267.456,53.97333333333333,436,546,110,ki_chroma_acts_smoothed
282,9,267.456,284.97,17.51400000000001,546,580,34,ki_chroma_acts_smoothed
283,1,0.0,30.272,30.272,0,64,64,chromagram
283,2,30.272,38.912,8.64,64,82,18,chromagram
283,3,38.912,46.592,7.68,82,98,16,chromagram
283,4,46.592,61.472,14.880000000000003,98,129,31,chromagram
283,5,61.472,102.27199999999999,40.79999999999999,129,214,85,chromagram
283,6,102.27199999999999,131.072,28.80000000000001,214,274,60,chromagram
283,7,131.072,185.792,54.72,274,388,114,chromagram
283,8,185.792,217.188,31.395999999999987,388,452,64,chromagram
283,1,0.0,30.272,30.272,0,64,64,chroma_acts
283,2,30.272,38.912,8.64,64,82,18,chroma_acts
283,3,38.912,61.952,23.04,82,130,48,chroma_acts
283,4,61.952,99.872,37.92,130,209,79,chroma_acts
283,5,99.872,102.27199999999999,2.3999999999999915,209,214,5,chroma_acts
283,6,102.27199999999999,131.072,28.80000000000001,214,274,60,chroma_acts
283,7,131.072,185.792,54.72,274,388,114,chroma_acts
283,8,185.792,217.188,31.395999999999987,388,452,64,chroma_acts
283,1,0.0,30.272,30.272,0,64,64,chroma_acts_smoothed
283,2,30.272,46.592,16.32,64,98,34,chroma_acts_smoothed
283,3,46.592,61.952,15.36,98,130,32,chroma_acts_smoothed
283,4,61.952,99.872,37.92,130,209,79,chroma_acts_smoothed
283,5,99.872,102.752,2.8799999999999955,209,215,6,chroma_acts_smoothed
283,6,102.752,131.552,28.799999999999997,215,275,60,chroma_acts_smoothed
283,7,131.552,186.272,54.72,275,389,114,chroma_acts_smoothed
283,8,186.272,217.188,30.915999999999997,389,452,63,chroma_acts_smoothed
283,1,0.0,30.272,30.272,0,64,64,ki_chroma
283,2,30.272,38.912,8.64,64,82,18,ki_chroma
283,3,38.912,46.592,7.68,82,98,16,ki_chroma
283,4,46.592,61.472,14.880000000000003,98,129,31,ki_chroma
283,5,61.472,102.27199999999999,40.79999999999999,129,214,85,ki_chroma
283,6,102.27199999999999,131.072,28.80000000000001,214,274,60,ki_chroma
283,7,131.072,185.792,54.72,274,388,114,ki_chroma
283,8,185.792,217.188,31.395999999999987,388,452,64,ki_chroma
283,1,0.0,30.272,30.272,0,64,64,ki_chroma_acts
283,2,30.272,38.912,8.64,64,82,18,ki_chroma_acts
283,3,38.912,61.952,23.04,82,130,48,ki_chroma_acts
283,4,61.952,99.872,37.92,130,209,79,ki_chroma_acts
283,5,99.872,102.27199999999999,2.3999999999999915,209,214,5,ki_chroma_acts
283,6,102.27199999999999,131.072,28.80000000000001,214,274,60,ki_chroma_acts
283,7,131.072,185.792,54.72,274,388,114,ki_chroma_acts
283,8,185.792,217.188,31.395999999999987,388,452,64,ki_chroma_acts
283,1,0.0,30.272,30.272,0,64,64,ki_chroma_acts_smoothed
283,2,30.272,46.592,16.32,64,98,34,ki_chroma_acts_smoothed
283,3,46.592,61.952,15.36,98,130,32,ki_chroma_acts_smoothed
283,4,61.952,99.872,37.92,130,209,79,ki_chroma_acts_smoothed
283,5,99.872,102.752,2.8799999999999955,209,215,6,ki_chroma_acts_smoothed
283,6,102.752,131.552,28.799999999999997,215,275,60,ki_chroma_acts_smoothed
283,7,131.552,186.272,54.72,275,389,114,ki_chroma_acts_smoothed
283,8,186.272,217.188,30.915999999999997,389,452,63,ki_chroma_acts_smoothed
287,1,0.0,43.114666666666665,43.114666666666665,0,90,90,chromagram
287,2,43.114666666666665,57.99466666666666,14.879999999999995,90,121,31,chromagram
287,3,57.99466666666666,103.59466666666665,45.599999999999994,121,216,95,chromagram
287,4,103.59466666666665,127.11466666666666,23.52000000000001,216,265,49,chromagram
287,5,127.11466666666666,133.35466666666665,6.239999999999981,265,278,13,chromagram
287,6,133.35466666666665,153.51466666666667,20.160000000000025,278,320,42,chromagram
287,7,153.51466666666667,162.15466666666666,8.639999999999986,320,338,18,chromagram
287,8,162.15466666666666,193.35466666666665,31.19999999999999,338,403,65,chromagram
287,9,193.35466666666665,226.407,33.052333333333365,403,470,67,chromagram
287,1,0.0,28.714666666666666,28.714666666666666,0,60,60,chroma_acts
287,2,28.714666666666666,54.154666666666664,25.439999999999998,60,113,53,chroma_acts
287,3,54.154666666666664,57.99466666666666,3.8399999999999963,113,121,8,chroma_acts
287,4,57.99466666666666,103.11466666666666,45.120000000000005,121,215,94,chroma_acts
287,5,103.11466666666666,129.99466666666666,26.879999999999995,215,271,56,chroma_acts
287,6,129.99466666666666,133.35466666666665,3.359999999999985,271,278,7,chroma_acts
287,7,133.35466666666665,153.51466666666667,20.160000000000025,278,320,42,chroma_acts
287,8,153.51466666666667,162.63466666666665,9.119999999999976,320,339,19,chroma_acts
287,9,162.63466666666665,226.407,63.772333333333364,339,470,131,chroma_acts
287,1,0.0,28.714666666666666,28.714666666666666,0,60,60,chroma_acts_smoothed
287,2,28.714666666666666,53.67466666666666,24.959999999999994,60,112,52,chroma_acts_smoothed
287,3,53.67466666666666,57.99466666666666,4.32,112,121,9,chroma_acts_smoothed
287,4,57.99466666666666,103.59466666666665,45.599999999999994,121,216,95,chroma_acts_smoothed
287,5,103.59466666666665,126.63466666666666,23.040000000000006,216,264,48,chroma_acts_smoothed
287,6,126.63466666666666,134.31466666666665,7.679999999999993,264,280,16,chroma_acts_smoothed
287,7,134.31466666666665,153.99466666666666,19.680000000000007,280,321,41,chroma_acts_smoothed
287,8,153.99466666666666,162.15466666666666,8.159999999999997,321,338,17,chroma_acts_smoothed
287,9,162.15466666666666,226.407,64.25233333333335,338,470,132,chroma_acts_smoothed
287,1,0.0,43.114666666666665,43.114666666666665,0,90,90,ki_chroma
287,2,43.114666666666665,57.99466666666666,14.879999999999995,90,121,31,ki_chroma
287,3,57.99466666666666,103.59466666666665,45.599999999999994,121,216,95,ki_chroma
287,4,103.59466666666665,127.11466666666666,23.52000000000001,216,265,49,ki_chroma
287,5,127.11466666666666,133.35466666666665,6.239999999999981,265,278,13,ki_chroma
287,6,133.35466666666665,153.51466666666667,20.160000000000025,278,320,42,ki_chroma
287,7,153.51466666666667,162.15466666666666,8.639999999999986,320,338,18,ki_chroma
287,8,162.15466666666666,193.35466666666665,31.19999999999999,338,403,65,ki_chroma
287,9,193.35466666666665,226.407,33.052333333333365,403,470,67,ki_chroma
287,1,0.0,28.714666666666666,28.714666666666666,0,60,60,ki_chroma_acts
287,2,28.714666666666666,54.154666666666664,25.439999999999998,60,113,53,ki_chroma_acts
287,3,54.154666666666664,57.99466666666666,3.8399999999999963,113,121,8,ki_chroma_acts
287,4,57.99466666666666,103.11466666666666,45.120000000000005,121,215,94,ki_chroma_acts
287,5,103.11466666666666,129.99466666666666,26.879999999999995,215,271,56,ki_chroma_acts
287,6,129.99466666666666,133.35466666666665,3.359999999999985,271,278,7,ki_chroma_acts
287,7,133.35466666666665,153.51466666666667,20.160000000000025,278,320,42,ki_chroma_acts
287,8,153.51466666666667,162.63466666666665,9.119999999999976,320,339,19,ki_chroma_acts
287,9,162.63466666666665,226.407,63.772333333333364,339,470,131,ki_chroma_acts
287,1,0.0,28.714666666666666,28.714666666666666,0,60,60,ki_chroma_acts_smoothed
287,2,28.714666666666666,53.67466666666666,24.959999999999994,60,112,52,ki_chroma_acts_smoothed
287,3,53.67466666666666,57.99466666666666,4.32,112,121,9,ki_chroma_acts_smoothed
287,4,57.99466666666666,103.59466666666665,45.599999999999994,121,216,95,ki_chroma_acts_smoothed
287,5,103.59466666666665,126.63466666666666,23.040000000000006,216,264,48,ki_chroma_acts_smoothed
287,6,126.63466666666666,134.31466666666665,7.679999999999993,264,280,16,ki_chroma_acts_smoothed
287,7,134.31466666666665,153.99466666666666,19.680000000000007,280,321,41,ki_chroma_acts_smoothed
287,8,153.99466666666666,162.15466666666666,8.159999999999997,321,338,17,ki_chroma_acts_smoothed
287,9,162.15466666666666,226.407,64.25233333333335,338,470,132,ki_chroma_acts_smoothed
288,1,0.0,17.333333333333332,17.333333333333332,0,37,37,chromagram
288,2,17.333333333333332,29.333333333333332,12.0,37,62,25,chromagram
288,3,29.333333333333332,46.61333333333334,17.280000000000005,62,98,36,chromagram
288,4,46.61333333333334,90.77333333333333,44.15999999999999,98,190,92,chromagram
288,5,90.77333333333333,96.05333333333333,5.280000000000001,190,201,11,chromagram
288,6,96.05333333333333,99.41333333333333,3.3599999999999994,201,208,7,chromagram
288,7,99.41333333333333,103.73333333333333,4.320000000000007,208,217,9,chromagram
288,8,103.73333333333333,122.93333333333334,19.200000000000003,217,257,40,chromagram
288,9,122.93333333333334,184.32,61.386666666666656,257,383,126,chromagram
288,1,0.0,26.93333333333333,26.93333333333333,0,57,57,chroma_acts
288,2,26.93333333333333,29.333333333333332,2.400000000000002,57,62,5,chroma_acts
288,3,29.333333333333332,46.61333333333334,17.280000000000005,62,98,36,chroma_acts
288,4,46.61333333333334,90.77333333333333,44.15999999999999,98,190,92,chroma_acts
288,5,90.77333333333333,96.05333333333333,5.280000000000001,190,201,11,chroma_acts
288,6,96.05333333333333,99.41333333333333,3.3599999999999994,201,208,7,chroma_acts
288,7,99.41333333333333,103.73333333333333,4.320000000000007,208,217,9,chroma_acts
288,8,103.73333333333333,122.93333333333334,19.200000000000003,217,257,40,chroma_acts
288,9,122.93333333333334,184.32,61.386666666666656,257,383,126,chroma_acts
288,1,0.0,19.25333333333333,19.25333333333333,0,41,41,chroma_acts_smoothed
288,2,19.25333333333333,31.25333333333333,12.0,41,66,25,chroma_acts_smoothed
288,3,31.25333333333333,46.61333333333334,15.360000000000007,66,98,32,chroma_acts_smoothed
288,4,46.61333333333334,90.77333333333333,44.15999999999999,98,190,92,chroma_acts_smoothed
288,5,90.77333333333333,96.05333333333333,5.280000000000001,190,201,11,chroma_acts_smoothed
288,6,96.05333333333333,99.41333333333333,3.3599999999999994,201,208,7,chroma_acts_smoothed
288,7,99.41333333333333,103.73333333333333,4.320000000000007,208,217,9,chroma_acts_smoothed
288,8,103.73333333333333,123.41333333333333,19.679999999999993,217,258,41,chroma_acts_smoothed
288,9,123.41333333333333,184.32,60.906666666666666,258,383,125,chroma_acts_smoothed
288,1,0.0,17.333333333333332,17.333333333333332,0,37,37,ki_chroma
288,2,17.333333333333332,29.333333333333332,12.0,37,62,25,ki_chroma
288,3,29.333333333333332,46.61333333333334,17.280000000000005,62,98,36,ki_chroma
288,4,46.61333333333334,90.77333333333333,44.15999999999999,98,190,92,ki_chroma
288,5,90.77333333333333,96.05333333333333,5.280000000000001,190,201,11,ki_chroma
288,6,96.05333333333333,99.41333333333333,3.3599999999999994,201,208,7,ki_chroma
288,7,99.41333333333333,103.73333333333333,4.320000000000007,208,217,9,ki_chroma
288,8,103.73333333333333,122.93333333333334,19.200000000000003,217,257,40,ki_chroma
288,9,122.93333333333334,184.32,61.386666666666656,257,383,126,ki_chroma
288,1,0.0,26.93333333333333,26.93333333333333,0,57,57,ki_chroma_acts
288,2,26.93333333333333,29.333333333333332,2.400000000000002,57,62,5,ki_chroma_acts
288,3,29.333333333333332,46.61333333333334,17.280000000000005,62,98,36,ki_chroma_acts
288,4,46.61333333333334,90.77333333333333,44.15999999999999,98,190,92,ki_chroma_acts
288,5,90.77333333333333,96.05333333333333,5.280000000000001,190,201,11,ki_chroma_acts
288,6,96.05333333333333,99.41333333333333,3.3599999999999994,201,208,7,ki_chroma_acts
288,7,99.41333333333333,103.73333333333333,4.320000000000007,208,217,9,ki_chroma_acts
288,8,103.73333333333333,122.93333333333334,19.200000000000003,217,257,40,ki_chroma_acts
288,9,122.93333333333334,184.32,61.386666666666656,257,383,126,ki_chroma_acts
288,1,0.0,19.25333333333333,19.25333333333333,0,41,41,ki_chroma_acts_smoothed
288,2,19.25333333333333,31.25333333333333,12.0,41,66,25,ki_chroma_acts_smoothed
288,3,31.25333333333333,46.61333333333334,15.360000000000007,66,98,32,ki_chroma_acts_smoothed
288,4,46.61333333333334,90.77333333333333,44.15999999999999,98,190,92,ki_chroma_acts_smoothed
288,5,90.77333333333333,96.05333333333333,5.280000000000001,190,201,11,ki_chroma_acts_smoothed
288,6,96.05333333333333,99.41333333333333,3.3599999999999994,201,208,7,ki_chroma_acts_smoothed
288,7,99.41333333333333,103.73333333333333,4.320000000000007,208,217,9,ki_chroma_acts_smoothed
288,8,103.73333333333333,123.41333333333333,19.679999999999993,217,258,41,ki_chroma_acts_smoothed
288,9,123.41333333333333,184.32,60.906666666666666,258,383,125,ki_chroma_acts_smoothed
289,1,0.0,23.594666666666665,23.594666666666665,0,50,50,chromagram
289,2,23.594666666666665,30.794666666666664,7.199999999999999,50,65,15,chromagram
289,3,30.794666666666664,58.154666666666664,27.36,65,122,57,chromagram
289,4,58.154666666666664,85.51466666666666,27.359999999999992,122,179,57,chromagram
289,5,85.51466666666666,100.39466666666667,14.88000000000001,179,210,31,chromagram
289,6,100.39466666666667,113.83466666666666,13.439999999999998,210,238,28,chromagram
289,7,113.83466666666666,157.99466666666666,44.16,238,330,92,chromagram
289,8,157.99466666666666,180.495,22.500333333333344,330,375,45,chromagram
289,1,0.0,6.794666666666667,6.794666666666667,0,15,15,chroma_acts
289,2,6.794666666666667,25.514666666666667,18.72,15,54,39,chroma_acts
289,3,25.514666666666667,30.794666666666664,5.279999999999998,54,65,11,chroma_acts
289,4,30.794666666666664,58.154666666666664,27.36,65,122,57,chroma_acts
289,5,58.154666666666664,82.63466666666666,24.479999999999997,122,173,51,chroma_acts
289,6,82.63466666666666,114.31466666666665,31.679999999999993,173,239,66,chroma_acts
289,7,114.31466666666665,161.83466666666666,47.52000000000001,239,338,99,chroma_acts
289,8,161.83466666666666,180.495,18.66033333333334,338,375,37,chroma_acts
289,1,0.0,6.794666666666667,6.794666666666667,0,15,15,chroma_acts_smoothed
289,2,6.794666666666667,25.514666666666667,18.72,15,54,39,chroma_acts_smoothed
289,3,25.514666666666667,30.794666666666664,5.279999999999998,54,65,11,chroma_acts_smoothed
289,4,30.794666666666664,58.154666666666664,27.36,65,122,57,chroma_acts_smoothed
289,5,58.154666666666664,84.07466666666666,25.919999999999995,122,176,54,chroma_acts_smoothed
289,6,84.07466666666666,114.31466666666665,30.239999999999995,176,239,63,chroma_acts_smoothed
289,7,114.31466666666665,162.31466666666665,48.0,239,339,100,chroma_acts_smoothed
289,8,162.31466666666665,180.495,18.18033333333335,339,375,36,chroma_acts_smoothed
289,1,0.0,23.594666666666665,23.594666666666665,0,50,50,ki_chroma
289,2,23.594666666666665,30.794666666666664,7.199999999999999,50,65,15,ki_chroma
289,3,30.794666666666664,58.154666666666664,27.36,65,122,57,ki_chroma
289,4,58.154666666666664,85.51466666666666,27.359999999999992,122,179,57,ki_chroma
289,5,85.51466666666666,100.39466666666667,14.88000000000001,179,210,31,ki_chroma
289,6,100.39466666666667,113.83466666666666,13.439999999999998,210,238,28,ki_chroma
289,7,113.83466666666666,157.99466666666666,44.16,238,330,92,ki_chroma
289,8,157.99466666666666,180.495,22.500333333333344,330,375,45,ki_chroma
289,1,0.0,6.794666666666667,6.794666666666667,0,15,15,ki_chroma_acts
289,2,6.794666666666667,25.514666666666667,18.72,15,54,39,ki_chroma_acts
289,3,25.514666666666667,30.794666666666664,5.279999999999998,54,65,11,ki_chroma_acts
289,4,30.794666666666664,58.154666666666664,27.36,65,122,57,ki_chroma_acts
289,5,58.154666666666664,82.63466666666666,24.479999999999997,122,173,51,ki_chroma_acts
289,6,82.63466666666666,114.31466666666665,31.679999999999993,173,239,66,ki_chroma_acts
289,7,114.31466666666665,161.83466666666666,47.52000000000001,239,338,99,ki_chroma_acts
289,8,161.83466666666666,180.495,18.66033333333334,338,375,37,ki_chroma_acts
289,1,0.0,6.794666666666667,6.794666666666667,0,15,15,ki_chroma_acts_smoothed
289,2,6.794666666666667,25.514666666666667,18.72,15,54,39,ki_chroma_acts_smoothed
289,3,25.514666666666667,30.794666666666664,5.279999999999998,54,65,11,ki_chroma_acts_smoothed
289,4,30.794666666666664,58.154666666666664,27.36,65,122,57,ki_chroma_acts_smoothed
289,5,58.154666666666664,84.07466666666666,25.919999999999995,122,176,54,ki_chroma_acts_smoothed
289,6,84.07466666666666,114.31466666666665,30.239999999999995,176,239,63,ki_chroma_acts_smoothed
289,7,114.31466666666665,162.31466666666665,48.0,239,339,100,ki_chroma_acts_smoothed
289,8,162.31466666666665,180.495,18.18033333333335,339,375,36,ki_chroma_acts_smoothed
290,1,0.0,10.336,10.336,0,22,22,chromagram
290,2,10.336,12.789333333333333,2.453333333333333,22,27,5,chromagram
290,3,12.789333333333333,32.906666666666666,20.117333333333335,27,68,41,chromagram
290,4,32.906666666666666,36.832,3.9253333333333345,68,76,8,chromagram
290,5,36.832,85.40800000000002,48.576000000000015,76,175,99,chromagram
290,6,85.40800000000002,93.25866666666667,7.850666666666655,175,191,16,chromagram
290,7,93.25866666666667,124.17066666666668,30.912000000000006,191,254,63,chromagram
290,8,124.17066666666668,130.54933333333332,6.378666666666646,254,267,13,chromagram
290,9,130.54933333333332,197.744,67.19466666666668,267,402,135,chromagram
290,1,0.0,12.789333333333333,12.789333333333333,0,27,27,chroma_acts
290,2,12.789333333333333,32.416000000000004,19.626666666666672,27,67,40,chroma_acts
290,3,32.416000000000004,36.832,4.415999999999997,67,76,9,chroma_acts
290,4,36.832,85.40800000000002,48.576000000000015,76,175,99,chroma_acts
290,5,85.40800000000002,93.74933333333334,8.341333333333324,175,192,17,chroma_acts
290,6,93.74933333333334,126.62400000000001,32.87466666666667,192,259,67,chroma_acts
290,7,126.62400000000001,130.54933333333332,3.925333333333313,259,267,8,chroma_acts
290,8,130.54933333333332,197.744,67.19466666666668,267,402,135,chroma_acts
290,1,0.0,16.224,16.224,0,34,34,chroma_acts_smoothed
290,2,16.224,31.925333333333338,15.701333333333338,34,66,32,chroma_acts_smoothed
290,3,31.925333333333338,38.304,6.378666666666664,66,79,13,chroma_acts_smoothed
290,4,38.304,85.40800000000002,47.10400000000001,79,175,96,chroma_acts_smoothed
290,5,85.40800000000002,93.25866666666667,7.850666666666655,175,191,16,chroma_acts_smoothed
290,6,93.25866666666667,126.62400000000001,33.36533333333334,191,259,68,chroma_acts_smoothed
290,7,126.62400000000001,130.54933333333332,3.925333333333313,259,267,8,chroma_acts_smoothed
290,8,130.54933333333332,197.744,67.19466666666668,267,402,135,chroma_acts_smoothed
290,1,0.0,10.336,10.336,0,22,22,ki_chroma
290,2,10.336,12.789333333333333,2.453333333333333,22,27,5,ki_chroma
290,3,12.789333333333333,32.906666666666666,20.117333333333335,27,68,41,ki_chroma
290,4,32.906666666666666,36.832,3.9253333333333345,68,76,8,ki_chroma
290,5,36.832,85.40800000000002,48.576000000000015,76,175,99,ki_chroma
290,6,85.40800000000002,93.25866666666667,7.850666666666655,175,191,16,ki_chroma
290,7,93.25866666666667,124.17066666666668,30.912000000000006,191,254,63,ki_chroma
290,8,124.17066666666668,130.54933333333332,6.378666666666646,254,267,13,ki_chroma
290,9,130.54933333333332,197.744,67.19466666666668,267,402,135,ki_chroma
290,1,0.0,12.789333333333333,12.789333333333333,0,27,27,ki_chroma_acts
290,2,12.789333333333333,32.416000000000004,19.626666666666672,27,67,40,ki_chroma_acts
290,3,32.416000000000004,36.832,4.415999999999997,67,76,9,ki_chroma_acts
290,4,36.832,85.40800000000002,48.576000000000015,76,175,99,ki_chroma_acts
290,5,85.40800000000002,93.74933333333334,8.341333333333324,175,192,17,ki_chroma_acts
290,6,93.74933333333334,126.62400000000001,32.87466666666667,192,259,67,ki_chroma_acts
290,7,126.62400000000001,130.54933333333332,3.925333333333313,259,267,8,ki_chroma_acts
290,8,130.54933333333332,197.744,67.19466666666668,267,402,135,ki_chroma_acts
290,1,0.0,16.224,16.224,0,34,34,ki_chroma_acts_smoothed
290,2,16.224,31.925333333333338,15.701333333333338,34,66,32,ki_chroma_acts_smoothed
290,3,31.925333333333338,38.304,6.378666666666664,66,79,13,ki_chroma_acts_smoothed
290,4,38.304,85.40800000000002,47.10400000000001,79,175,96,ki_chroma_acts_smoothed
290,5,85.40800000000002,93.25866666666667,7.850666666666655,175,191,16,ki_chroma_acts_smoothed
290,6,93.25866666666667,126.62400000000001,33.36533333333334,191,259,68,ki_chroma_acts_smoothed
290,7,126.62400000000001,130.54933333333332,3.925333333333313,259,267,8,ki_chroma_acts_smoothed
290,8,130.54933333333332,197.744,67.19466666666668,267,402,135,ki_chroma_acts_smoothed
291,1,0.0,14.933333333333332,14.933333333333332,0,32,32,chromagram
291,2,14.933333333333332,34.61333333333333,19.68,32,73,41,chromagram
291,3,34.61333333333333,65.33333333333333,30.72,73,137,64,chromagram
291,4,65.33333333333333,100.37333333333333,35.040000000000006,137,210,73,chromagram
291,5,100.37333333333333,116.69333333333333,16.319999999999993,210,244,34,chromagram
291,6,116.69333333333333,134.93333333333334,18.24000000000001,244,282,38,chromagram
291,7,134.93333333333334,181.97333333333333,47.03999999999999,282,380,98,chromagram
291,8,181.97333333333333,199.916,17.942666666666668,380,416,36,chromagram
291,1,0.0,15.893333333333333,15.893333333333333,0,34,34,chroma_acts
291,2,15.893333333333333,34.61333333333333,18.72,34,73,39,chroma_acts
291,3,34.61333333333333,64.37333333333333,29.760000000000005,73,135,62,chroma_acts
291,4,64.37333333333333,69.65333333333334,5.280000000000001,135,146,11,chroma_acts
291,5,69.65333333333334,95.57333333333332,25.919999999999987,146,200,54,chroma_acts
291,6,95.57333333333332,135.41333333333333,39.84,200,283,83,chroma_acts
291,7,135.41333333333333,181.97333333333333,46.56,283,380,97,chroma_acts
291,8,181.97333333333333,199.916,17.942666666666668,380,416,36,chroma_acts
291,1,0.0,14.453333333333333,14.453333333333333,0,31,31,chroma_acts_smoothed
291,2,14.453333333333333,34.61333333333333,20.159999999999997,31,73,42,chroma_acts_smoothed
291,3,34.61333333333333,64.37333333333333,29.760000000000005,73,135,62,chroma_acts_smoothed
291,4,64.37333333333333,100.37333333333333,36.0,135,210,75,chroma_acts_smoothed
291,5,100.37333333333333,116.21333333333332,15.83999999999999,210,243,33,chroma_acts_smoothed
291,6,116.21333333333332,135.41333333333333,19.200000000000003,243,283,40,chroma_acts_smoothed
291,7,135.41333333333333,181.97333333333333,46.56,283,380,97,chroma_acts_smoothed
291,8,181.97333333333333,199.916,17.942666666666668,380,416,36,chroma_acts_smoothed
291,1,0.0,14.933333333333332,14.933333333333332,0,32,32,ki_chroma
291,2,14.933333333333332,34.61333333333333,19.68,32,73,41,ki_chroma
291,3,34.61333333333333,65.33333333333333,30.72,73,137,64,ki_chroma
291,4,65.33333333333333,100.37333333333333,35.040000000000006,137,210,73,ki_chroma
291,5,100.37333333333333,116.69333333333333,16.319999999999993,210,244,34,ki_chroma
291,6,116.69333333333333,134.93333333333334,18.24000000000001,244,282,38,ki_chroma
291,7,134.93333333333334,181.97333333333333,47.03999999999999,282,380,98,ki_chroma
291,8,181.97333333333333,199.916,17.942666666666668,380,416,36,ki_chroma
291,1,0.0,15.893333333333333,15.893333333333333,0,34,34,ki_chroma_acts
291,2,15.893333333333333,34.61333333333333,18.72,34,73,39,ki_chroma_acts
291,3,34.61333333333333,64.37333333333333,29.760000000000005,73,135,62,ki_chroma_acts
291,4,64.37333333333333,69.65333333333334,5.280000000000001,135,146,11,ki_chroma_acts
291,5,69.65333333333334,95.57333333333332,25.919999999999987,146,200,54,ki_chroma_acts
291,6,95.57333333333332,135.41333333333333,39.84,200,283,83,ki_chroma_acts
291,7,135.41333333333333,181.97333333333333,46.56,283,380,97,ki_chroma_acts
291,8,181.97333333333333,199.916,17.942666666666668,380,416,36,ki_chroma_acts
291,1,0.0,14.453333333333333,14.453333333333333,0,31,31,ki_chroma_acts_smoothed
291,2,14.453333333333333,34.61333333333333,20.159999999999997,31,73,42,ki_chroma_acts_smoothed
291,3,34.61333333333333,64.37333333333333,29.760000000000005,73,135,62,ki_chroma_acts_smoothed
291,4,64.37333333333333,100.37333333333333,36.0,135,210,75,ki_chroma_acts_smoothed
291,5,100.37333333333333,116.21333333333332,15.83999999999999,210,243,33,ki_chroma_acts_smoothed
291,6,116.21333333333332,135.41333333333333,19.200000000000003,243,283,40,ki_chroma_acts_smoothed
291,7,135.41333333333333,181.97333333333333,46.56,283,380,97,ki_chroma_acts_smoothed
291,8,181.97333333333333,199.916,17.942666666666668,380,416,36,ki_chroma_acts_smoothed
292,1,0.0,30.944000000000003,30.944000000000003,0,64,64,chromagram
292,2,30.944000000000003,47.136,16.192,64,97,33,chromagram
292,3,47.136,81.97333333333334,34.83733333333334,97,168,71,chromagram
292,4,81.97333333333334,125.152,43.17866666666666,168,256,88,chromagram
292,5,125.152,140.85333333333335,15.701333333333352,256,288,32,chromagram
292,6,140.85333333333335,188.44800000000004,47.59466666666668,288,385,97,chromagram
292,7,188.44800000000004,239.96800000000002,51.51999999999998,385,490,105,chromagram
292,8,239.96800000000002,263.126,23.15799999999996,490,536,46,chromagram
292,1,0.0,30.944000000000003,30.944000000000003,0,64,64,chroma_acts
292,2,30.944000000000003,46.64533333333333,15.70133333333333,64,96,32,chroma_acts
292,3,46.64533333333333,81.97333333333334,35.32800000000001,96,168,72,chroma_acts
292,4,81.97333333333334,125.152,43.17866666666666,168,256,88,chroma_acts
292,5,125.152,140.85333333333335,15.701333333333352,256,288,32,chroma_acts
292,6,140.85333333333335,187.4666666666667,46.613333333333344,288,383,95,chroma_acts
292,7,187.4666666666667,239.96800000000002,52.50133333333332,383,490,107,chroma_acts
292,8,239.96800000000002,263.126,23.15799999999996,490,536,46,chroma_acts
292,1,0.0,30.944000000000003,30.944000000000003,0,64,64,chroma_acts_smoothed
292,2,30.944000000000003,47.136,16.192,64,97,33,chroma_acts_smoothed
292,3,47.136,81.97333333333334,34.83733333333334,97,168,71,chroma_acts_smoothed
292,4,81.97333333333334,125.152,43.17866666666666,168,256,88,chroma_acts_smoothed
292,5,125.152,147.23200000000003,22.080000000000027,256,301,45,chroma_acts_smoothed
292,6,147.23200000000003,187.4666666666667,40.23466666666667,301,383,82,chroma_acts_smoothed
292,7,187.4666666666667,239.96800000000002,52.50133333333332,383,490,107,chroma_acts_smoothed
292,8,239.96800000000002,263.126,23.15799999999996,490,536,46,chroma_acts_smoothed
292,1,0.0,30.944000000000003,30.944000000000003,0,64,64,ki_chroma
292,2,30.944000000000003,47.136,16.192,64,97,33,ki_chroma
292,3,47.136,81.97333333333334,34.83733333333334,97,168,71,ki_chroma
292,4,81.97333333333334,125.152,43.17866666666666,168,256,88,ki_chroma
292,5,125.152,140.85333333333335,15.701333333333352,256,288,32,ki_chroma
292,6,140.85333333333335,188.44800000000004,47.59466666666668,288,385,97,ki_chroma
292,7,188.44800000000004,239.96800000000002,51.51999999999998,385,490,105,ki_chroma
292,8,239.96800000000002,263.126,23.15799999999996,490,536,46,ki_chroma
292,1,0.0,30.944000000000003,30.944000000000003,0,64,64,ki_chroma_acts
292,2,30.944000000000003,46.64533333333333,15.70133333333333,64,96,32,ki_chroma_acts
292,3,46.64533333333333,81.97333333333334,35.32800000000001,96,168,72,ki_chroma_acts
292,4,81.97333333333334,125.152,43.17866666666666,168,256,88,ki_chroma_acts
292,5,125.152,140.85333333333335,15.701333333333352,256,288,32,ki_chroma_acts
292,6,140.85333333333335,187.4666666666667,46.613333333333344,288,383,95,ki_chroma_acts
292,7,187.4666666666667,239.96800000000002,52.50133333333332,383,490,107,ki_chroma_acts
292,8,239.96800000000002,263.126,23.15799999999996,490,536,46,ki_chroma_acts
292,1,0.0,30.944000000000003,30.944000000000003,0,64,64,ki_chroma_acts_smoothed
292,2,30.944000000000003,47.136,16.192,64,97,33,ki_chroma_acts_smoothed
292,3,47.136,81.97333333333334,34.83733333333334,97,168,71,ki_chroma_acts_smoothed
292,4,81.97333333333334,125.152,43.17866666666666,168,256,88,ki_chroma_acts_smoothed
292,5,125.152,147.23200000000003,22.080000000000027,256,301,45,ki_chroma_acts_smoothed
292,6,147.23200000000003,187.4666666666667,40.23466666666667,301,383,82,ki_chroma_acts_smoothed
292,7,187.4666666666667,239.96800000000002,52.50133333333332,383,490,107,ki_chroma_acts_smoothed
292,8,239.96800000000002,263.126,23.15799999999996,490,536,46,ki_chroma_acts_smoothed
293,1,0.0,7.477333333333332,7.477333333333332,0,17,17,chromagram
293,2,7.477333333333332,21.23733333333333,13.759999999999996,17,47,30,chromagram
293,3,21.23733333333333,29.49333333333333,8.256,47,65,18,chromagram
293,4,29.49333333333333,70.77333333333333,41.28,65,155,90,chromagram
293,5,70.77333333333333,88.66133333333332,17.88799999999999,155,194,39,chromagram
293,6,88.66133333333332,95.99999999999999,7.3386666666666684,194,210,16,chromagram
293,7,95.99999999999999,103.33866666666665,7.3386666666666684,210,226,16,chromagram
293,8,103.33866666666665,118.01599999999999,14.677333333333337,226,258,32,chromagram
293,9,118.01599999999999,148.731,30.715000000000003,258,323,65,chromagram
293,1,0.0,7.477333333333332,7.477333333333332,0,17,17,chroma_acts
293,2,7.477333333333332,21.23733333333333,13.759999999999996,17,47,30,chroma_acts
293,3,21.23733333333333,29.49333333333333,8.256,47,65,18,chroma_acts
293,4,29.49333333333333,66.64533333333333,37.152,65,146,81,chroma_acts
293,5,66.64533333333333,87.74399999999999,21.09866666666666,146,192,46,chroma_acts
293,6,87.74399999999999,95.99999999999999,8.256,192,210,18,chroma_acts
293,7,95.99999999999999,103.33866666666665,7.3386666666666684,210,226,16,chroma_acts
293,8,103.33866666666665,118.01599999999999,14.677333333333337,226,258,32,chroma_acts
293,9,118.01599999999999,148.731,30.715000000000003,258,323,65,chroma_acts
293,1,0.0,11.146666666666667,11.146666666666667,0,25,25,chroma_acts_smoothed
293,2,11.146666666666667,29.49333333333333,18.346666666666664,25,65,40,chroma_acts_smoothed
293,3,29.49333333333333,66.18666666666665,36.69333333333333,65,145,80,chroma_acts_smoothed
293,4,66.18666666666665,71.69066666666666,5.504000000000005,145,157,12,chroma_acts_smoothed
293,5,71.69066666666666,87.74399999999999,16.053333333333327,157,192,35,chroma_acts_smoothed
293,6,87.74399999999999,96.45866666666666,8.714666666666673,192,211,19,chroma_acts_smoothed
293,7,96.45866666666666,103.33866666666665,6.8799999999999955,211,226,15,chroma_acts_smoothed
293,8,103.33866666666665,117.55733333333332,14.218666666666664,226,257,31,chroma_acts_smoothed
293,9,117.55733333333332,148.731,31.173666666666676,257,323,66,chroma_acts_smoothed
293,1,0.0,7.477333333333332,7.477333333333332,0,17,17,ki_chroma
293,2,7.477333333333332,21.23733333333333,13.759999999999996,17,47,30,ki_chroma
293,3,21.23733333333333,29.49333333333333,8.256,47,65,18,ki_chroma
293,4,29.49333333333333,70.77333333333333,41.28,65,155,90,ki_chroma
293,5,70.77333333333333,88.66133333333332,17.88799999999999,155,194,39,ki_chroma
293,6,88.66133333333332,95.99999999999999,7.3386666666666684,194,210,16,ki_chroma
293,7,95.99999999999999,103.33866666666665,7.3386666666666684,210,226,16,ki_chroma
293,8,103.33866666666665,118.01599999999999,14.677333333333337,226,258,32,ki_chroma
293,9,118.01599999999999,148.731,30.715000000000003,258,323,65,ki_chroma
293,1,0.0,7.477333333333332,7.477333333333332,0,17,17,ki_chroma_acts
293,2,7.477333333333332,21.23733333333333,13.759999999999996,17,47,30,ki_chroma_acts
293,3,21.23733333333333,29.49333333333333,8.256,47,65,18,ki_chroma_acts
293,4,29.49333333333333,66.64533333333333,37.152,65,146,81,ki_chroma_acts
293,5,66.64533333333333,87.74399999999999,21.09866666666666,146,192,46,ki_chroma_acts
293,6,87.74399999999999,95.99999999999999,8.256,192,210,18,ki_chroma_acts
293,7,95.99999999999999,103.33866666666665,7.3386666666666684,210,226,16,ki_chroma_acts
293,8,103.33866666666665,118.01599999999999,14.677333333333337,226,258,32,ki_chroma_acts
293,9,118.01599999999999,148.731,30.715000000000003,258,323,65,ki_chroma_acts
293,1,0.0,11.146666666666667,11.146666666666667,0,25,25,ki_chroma_acts_smoothed
293,2,11.146666666666667,29.49333333333333,18.346666666666664,25,65,40,ki_chroma_acts_smoothed
293,3,29.49333333333333,66.18666666666665,36.69333333333333,65,145,80,ki_chroma_acts_smoothed
293,4,66.18666666666665,71.69066666666666,5.504000000000005,145,157,12,ki_chroma_acts_smoothed
293,5,71.69066666666666,87.74399999999999,16.053333333333327,157,192,35,ki_chroma_acts_smoothed
293,6,87.74399999999999,96.45866666666666,8.714666666666673,192,211,19,ki_chroma_acts_smoothed
293,7,96.45866666666666,103.33866666666665,6.8799999999999955,211,226,15,ki_chroma_acts_smoothed
293,8,103.33866666666665,117.55733333333332,14.218666666666664,226,257,31,ki_chroma_acts_smoothed
293,9,117.55733333333332,148.731,31.173666666666676,257,323,66,ki_chroma_acts_smoothed
294,1,0.0,37.48266666666667,37.48266666666667,0,79,79,chromagram
294,2,37.48266666666667,45.16266666666667,7.68,79,95,16,chromagram
294,3,45.16266666666667,60.522666666666666,15.36,95,127,32,chromagram
294,4,60.522666666666666,62.44266666666666,1.9199999999999946,127,131,4,chromagram
294,5,62.44266666666666,75.88266666666667,13.440000000000005,131,159,28,chromagram
294,6,75.88266666666667,93.64266666666666,17.75999999999999,159,196,37,chromagram
294,7,93.64266666666666,132.04266666666666,38.400000000000006,196,276,80,chromagram
294,8,132.04266666666666,137.80266666666668,5.760000000000019,276,288,12,chromagram
294,9,137.80266666666668,186.963,49.16033333333331,288,389,101,chromagram
294,1,0.0,39.40266666666666,39.40266666666666,0,83,83,chroma_acts
294,2,39.40266666666666,45.16266666666667,5.760000000000005,83,95,12,chroma_acts
294,3,45.16266666666667,60.522666666666666,15.36,95,127,32,chroma_acts
294,4,60.522666666666666,62.44266666666666,1.9199999999999946,127,131,4,chroma_acts
294,5,62.44266666666666,75.88266666666667,13.440000000000005,131,159,28,chroma_acts
294,6,75.88266666666667,132.04266666666666,56.16,159,276,117,chroma_acts
294,7,132.04266666666666,137.80266666666668,5.760000000000019,276,288,12,chroma_acts
294,8,137.80266666666668,186.963,49.16033333333331,288,389,101,chroma_acts
294,1,0.0,37.48266666666667,37.48266666666667,0,79,79,chroma_acts_smoothed
294,2,37.48266666666667,44.68266666666666,7.199999999999996,79,94,15,chroma_acts_smoothed
294,3,44.68266666666666,60.522666666666666,15.840000000000003,94,127,33,chroma_acts_smoothed
294,4,60.522666666666666,75.40266666666666,14.879999999999995,127,158,31,chroma_acts_smoothed
294,5,75.40266666666666,93.64266666666666,18.239999999999995,158,196,38,chroma_acts_smoothed
294,6,93.64266666666666,132.04266666666666,38.400000000000006,196,276,80,chroma_acts_smoothed
294,7,132.04266666666666,137.80266666666668,5.760000000000019,276,288,12,chroma_acts_smoothed
294,8,137.80266666666668,186.963,49.16033333333331,288,389,101,chroma_acts_smoothed
294,1,0.0,37.48266666666667,37.48266666666667,0,79,79,ki_chroma
294,2,37.48266666666667,45.16266666666667,7.68,79,95,16,ki_chroma
294,3,45.16266666666667,60.522666666666666,15.36,95,127,32,ki_chroma
294,4,60.522666666666666,62.44266666666666,1.9199999999999946,127,131,4,ki_chroma
294,5,62.44266666666666,75.88266666666667,13.440000000000005,131,159,28,ki_chroma
294,6,75.88266666666667,93.64266666666666,17.75999999999999,159,196,37,ki_chroma
294,7,93.64266666666666,132.04266666666666,38.400000000000006,196,276,80,ki_chroma
294,8,132.04266666666666,137.80266666666668,5.760000000000019,276,288,12,ki_chroma
294,9,137.80266666666668,186.963,49.16033333333331,288,389,101,ki_chroma
294,1,0.0,39.40266666666666,39.40266666666666,0,83,83,ki_chroma_acts
294,2,39.40266666666666,45.16266666666667,5.760000000000005,83,95,12,ki_chroma_acts
294,3,45.16266666666667,60.522666666666666,15.36,95,127,32,ki_chroma_acts
294,4,60.522666666666666,62.44266666666666,1.9199999999999946,127,131,4,ki_chroma_acts
294,5,62.44266666666666,75.88266666666667,13.440000000000005,131,159,28,ki_chroma_acts
294,6,75.88266666666667,132.04266666666666,56.16,159,276,117,ki_chroma_acts
294,7,132.04266666666666,137.80266666666668,5.760000000000019,276,288,12,ki_chroma_acts
294,8,137.80266666666668,186.963,49.16033333333331,288,389,101,ki_chroma_acts
294,1,0.0,37.48266666666667,37.48266666666667,0,79,79,ki_chroma_acts_smoothed
294,2,37.48266666666667,44.68266666666666,7.199999999999996,79,94,15,ki_chroma_acts_smoothed
294,3,44.68266666666666,60.522666666666666,15.840000000000003,94,127,33,ki_chroma_acts_smoothed
294,4,60.522666666666666,75.40266666666666,14.879999999999995,127,158,31,ki_chroma_acts_smoothed
294,5,75.40266666666666,93.64266666666666,18.239999999999995,158,196,38,ki_chroma_acts_smoothed
294,6,93.64266666666666,132.04266666666666,38.400000000000006,196,276,80,ki_chroma_acts_smoothed
294,7,132.04266666666666,137.80266666666668,5.760000000000019,276,288,12,ki_chroma_acts_smoothed
294,8,137.80266666666668,186.963,49.16033333333331,288,389,101,ki_chroma_acts_smoothed
296,1,0.0,22.773333333333333,22.773333333333333,0,33,33,chromagram
296,2,22.773333333333333,38.026666666666664,15.25333333333333,33,55,22,chromagram
296,3,38.026666666666664,66.45333333333335,28.426666666666684,55,96,41,chromagram
296,4,66.45333333333335,77.54666666666668,11.093333333333334,96,112,16,chromagram
296,5,77.54666666666668,87.94666666666667,10.399999999999991,112,127,15,chromagram
296,6,87.94666666666667,110.82666666666668,22.88000000000001,127,160,33,chromagram
296,7,110.82666666666668,151.73333333333335,40.906666666666666,160,219,59,chromagram
296,8,151.73333333333335,183.6266666666667,31.893333333333345,219,265,46,chromagram
296,9,183.6266666666667,198.857,15.230333333333306,265,285,20,chromagram
296,1,0.0,22.773333333333333,22.773333333333333,0,33,33,chroma_acts
296,2,22.773333333333333,68.53333333333335,45.76000000000001,33,99,66,chroma_acts
296,3,68.53333333333335,71.30666666666667,2.7733333333333263,99,103,4,chroma_acts
296,4,71.30666666666667,74.08000000000001,2.7733333333333405,103,107,4,chroma_acts
296,5,74.08000000000001,77.54666666666668,3.4666666666666686,107,112,5,chroma_acts
296,6,77.54666666666668,87.25333333333334,9.706666666666663,112,126,14,chroma_acts
296,7,87.25333333333334,110.82666666666668,23.573333333333338,126,160,34,chroma_acts
296,8,110.82666666666668,182.24,71.41333333333333,160,263,103,chroma_acts
296,9,182.24,198.857,16.61699999999999,263,285,22,chroma_acts
296,1,0.0,22.773333333333333,22.773333333333333,0,33,33,chroma_acts_smoothed
296,2,22.773333333333333,38.72,15.946666666666665,33,56,23,chroma_acts_smoothed
296,3,38.72,68.53333333333335,29.813333333333347,56,99,43,chroma_acts_smoothed
296,4,68.53333333333335,77.54666666666668,9.013333333333335,99,112,13,chroma_acts_smoothed
296,5,77.54666666666668,87.94666666666667,10.399999999999991,112,127,15,chroma_acts_smoothed
296,6,87.94666666666667,110.82666666666668,22.88000000000001,127,160,33,chroma_acts_smoothed
296,7,110.82666666666668,176.0,65.17333333333332,160,254,94,chroma_acts_smoothed
296,8,176.0,185.70666666666668,9.706666666666678,254,268,14,chroma_acts_smoothed
296,9,185.70666666666668,198.857,13.150333333333322,268,285,17,chroma_acts_smoothed
296,1,0.0,22.773333333333333,22.773333333333333,0,33,33,ki_chroma
296,2,22.773333333333333,38.026666666666664,15.25333333333333,33,55,22,ki_chroma
296,3,38.026666666666664,66.45333333333335,28.426666666666684,55,96,41,ki_chroma
296,4,66.45333333333335,77.54666666666668,11.093333333333334,96,112,16,ki_chroma
296,5,77.54666666666668,87.94666666666667,10.399999999999991,112,127,15,ki_chroma
296,6,87.94666666666667,110.82666666666668,22.88000000000001,127,160,33,ki_chroma
296,7,110.82666666666668,151.73333333333335,40.906666666666666,160,219,59,ki_chroma
296,8,151.73333333333335,183.6266666666667,31.893333333333345,219,265,46,ki_chroma
296,9,183.6266666666667,198.857,15.230333333333306,265,285,20,ki_chroma
296,1,0.0,22.773333333333333,22.773333333333333,0,33,33,ki_chroma_acts
296,2,22.773333333333333,68.53333333333335,45.76000000000001,33,99,66,ki_chroma_acts
296,3,68.53333333333335,71.30666666666667,2.7733333333333263,99,103,4,ki_chroma_acts
296,4,71.30666666666667,74.08000000000001,2.7733333333333405,103,107,4,ki_chroma_acts
296,5,74.08000000000001,77.54666666666668,3.4666666666666686,107,112,5,ki_chroma_acts
296,6,77.54666666666668,87.25333333333334,9.706666666666663,112,126,14,ki_chroma_acts
296,7,87.25333333333334,110.82666666666668,23.573333333333338,126,160,34,ki_chroma_acts
296,8,110.82666666666668,182.24,71.41333333333333,160,263,103,ki_chroma_acts
296,9,182.24,198.857,16.61699999999999,263,285,22,ki_chroma_acts
296,1,0.0,22.773333333333333,22.773333333333333,0,33,33,ki_chroma_acts_smoothed
296,2,22.773333333333333,38.72,15.946666666666665,33,56,23,ki_chroma_acts_smoothed
296,3,38.72,68.53333333333335,29.813333333333347,56,99,43,ki_chroma_acts_smoothed
296,4,68.53333333333335,77.54666666666668,9.013333333333335,99,112,13,ki_chroma_acts_smoothed
296,5,77.54666666666668,87.94666666666667,10.399999999999991,112,127,15,ki_chroma_acts_smoothed
296,6,87.94666666666667,110.82666666666668,22.88000000000001,127,160,33,ki_chroma_acts_smoothed
296,7,110.82666666666668,176.0,65.17333333333332,160,254,94,ki_chroma_acts_smoothed
296,8,176.0,185.70666666666668,9.706666666666678,254,268,14,ki_chroma_acts_smoothed
296,9,185.70666666666668,198.857,13.150333333333322,268,285,17,ki_chroma_acts_smoothed
297,1,0.0,6.976,6.976,0,15,15,chromagram
297,2,6.976,28.576,21.6,15,60,45,chromagram
297,3,28.576,39.135999999999996,10.559999999999995,60,82,22,chromagram
297,4,39.135999999999996,84.73599999999999,45.599999999999994,82,177,95,chromagram
297,5,84.73599999999999,100.096,15.360000000000014,177,209,32,chromagram
297,6,100.096,114.496,14.399999999999991,209,239,30,chromagram
297,7,114.496,136.096,21.60000000000001,239,284,45,chromagram
297,8,136.096,146.176,10.079999999999984,284,305,21,chromagram
297,9,146.176,192.96,46.78400000000002,305,401,96,chromagram
297,1,0.0,6.976,6.976,0,15,15,chroma_acts
297,2,6.976,22.816,15.84,15,48,33,chroma_acts
297,3,22.816,38.176,15.360000000000003,48,80,32,chroma_acts
297,4,38.176,85.216,47.03999999999999,80,178,98,chroma_acts
297,5,85.216,100.096,14.88000000000001,178,209,31,chroma_acts
297,6,100.096,114.496,14.399999999999991,209,239,30,chroma_acts
297,7,114.496,130.33599999999998,15.83999999999999,239,272,33,chroma_acts
297,8,130.33599999999998,145.696,15.360000000000014,272,304,32,chroma_acts
297,9,145.696,192.96,47.26400000000001,304,401,97,chroma_acts
297,1,0.0,6.976,6.976,0,15,15,chroma_acts_smoothed
297,2,6.976,22.816,15.84,15,48,33,chroma_acts_smoothed
297,3,22.816,38.656,15.84,48,81,33,chroma_acts_smoothed
297,4,38.656,85.216,46.559999999999995,81,178,97,chroma_acts_smoothed
297,5,85.216,100.096,14.88000000000001,178,209,31,chroma_acts_smoothed
297,6,100.096,114.496,14.399999999999991,209,239,30,chroma_acts_smoothed
297,7,114.496,130.33599999999998,15.83999999999999,239,272,33,chroma_acts_smoothed
297,8,130.33599999999998,145.696,15.360000000000014,272,304,32,chroma_acts_smoothed
297,9,145.696,192.96,47.26400000000001,304,401,97,chroma_acts_smoothed
297,1,0.0,6.976,6.976,0,15,15,ki_chroma
297,2,6.976,28.576,21.6,15,60,45,ki_chroma
297,3,28.576,39.135999999999996,10.559999999999995,60,82,22,ki_chroma
297,4,39.135999999999996,84.73599999999999,45.599999999999994,82,177,95,ki_chroma
297,5,84.73599999999999,100.096,15.360000000000014,177,209,32,ki_chroma
297,6,100.096,114.496,14.399999999999991,209,239,30,ki_chroma
297,7,114.496,136.096,21.60000000000001,239,284,45,ki_chroma
297,8,136.096,146.176,10.079999999999984,284,305,21,ki_chroma
297,9,146.176,192.96,46.78400000000002,305,401,96,ki_chroma
297,1,0.0,6.976,6.976,0,15,15,ki_chroma_acts
297,2,6.976,22.816,15.84,15,48,33,ki_chroma_acts
297,3,22.816,38.176,15.360000000000003,48,80,32,ki_chroma_acts
297,4,38.176,85.216,47.03999999999999,80,178,98,ki_chroma_acts
297,5,85.216,100.096,14.88000000000001,178,209,31,ki_chroma_acts
297,6,100.096,114.496,14.399999999999991,209,239,30,ki_chroma_acts
297,7,114.496,130.33599999999998,15.83999999999999,239,272,33,ki_chroma_acts
297,8,130.33599999999998,145.696,15.360000000000014,272,304,32,ki_chroma_acts
297,9,145.696,192.96,47.26400000000001,304,401,97,ki_chroma_acts
297,1,0.0,6.976,6.976,0,15,15,ki_chroma_acts_smoothed
297,2,6.976,22.816,15.84,15,48,33,ki_chroma_acts_smoothed
297,3,22.816,38.656,15.84,48,81,33,ki_chroma_acts_smoothed
297,4,38.656,85.216,46.559999999999995,81,178,97,ki_chroma_acts_smoothed
297,5,85.216,100.096,14.88000000000001,178,209,31,ki_chroma_acts_smoothed
297,6,100.096,114.496,14.399999999999991,209,239,30,ki_chroma_acts_smoothed
297,7,114.496,130.33599999999998,15.83999999999999,239,272,33,ki_chroma_acts_smoothed
297,8,130.33599999999998,145.696,15.360000000000014,272,304,32,ki_chroma_acts_smoothed
297,9,145.696,192.96,47.26400000000001,304,401,97,ki_chroma_acts_smoothed
298,1,0.0,6.506666666666667,6.506666666666667,0,14,14,chromagram
298,2,6.506666666666667,22.826666666666664,16.319999999999997,14,48,34,chromagram
298,3,22.826666666666664,42.026666666666664,19.2,48,88,40,chromagram
298,4,42.026666666666664,50.18666666666667,8.160000000000004,88,105,17,chromagram
298,5,50.18666666666667,82.82666666666667,32.64,105,173,68,chromagram
298,6,82.82666666666667,114.98666666666666,32.16,173,240,67,chromagram
298,7,114.98666666666666,121.70666666666666,6.719999999999999,240,254,14,chromagram
298,8,121.70666666666666,133.70666666666668,12.000000000000014,254,279,25,chromagram
298,9,133.70666666666668,191.986,58.27933333333331,279,399,120,chromagram
298,1,0.0,6.506666666666667,6.506666666666667,0,14,14,chroma_acts
298,2,6.506666666666667,35.78666666666666,29.279999999999994,14,75,61,chroma_acts
298,3,35.78666666666666,42.026666666666664,6.240000000000002,75,88,13,chroma_acts
298,4,42.026666666666664,50.18666666666667,8.160000000000004,88,105,17,chroma_acts
298,5,50.18666666666667,82.82666666666667,32.64,105,173,68,chroma_acts
298,6,82.82666666666667,114.98666666666666,32.16,173,240,67,chroma_acts
298,7,114.98666666666666,121.70666666666666,6.719999999999999,240,254,14,chroma_acts
298,8,121.70666666666666,134.18666666666667,12.480000000000004,254,280,26,chroma_acts
298,9,134.18666666666667,191.986,57.79933333333332,280,399,119,chroma_acts
298,1,0.0,6.506666666666667,6.506666666666667,0,14,14,chroma_acts_smoothed
298,2,6.506666666666667,22.826666666666664,16.319999999999997,14,48,34,chroma_acts_smoothed
298,3,22.826666666666664,35.78666666666666,12.959999999999997,48,75,27,chroma_acts_smoothed
298,4,35.78666666666666,42.026666666666664,6.240000000000002,75,88,13,chroma_acts_smoothed
298,5,42.026666666666664,82.82666666666667,40.800000000000004,88,173,85,chroma_acts_smoothed
298,6,82.82666666666667,114.98666666666666,32.16,173,240,67,chroma_acts_smoothed
298,7,114.98666666666666,122.18666666666667,7.200000000000003,240,255,15,chroma_acts_smoothed
298,8,122.18666666666667,134.18666666666667,12.0,255,280,25,chroma_acts_smoothed
298,9,134.18666666666667,191.986,57.79933333333332,280,399,119,chroma_acts_smoothed
298,1,0.0,6.506666666666667,6.506666666666667,0,14,14,ki_chroma
298,2,6.506666666666667,22.826666666666664,16.319999999999997,14,48,34,ki_chroma
298,3,22.826666666666664,42.026666666666664,19.2,48,88,40,ki_chroma
298,4,42.026666666666664,50.18666666666667,8.160000000000004,88,105,17,ki_chroma
298,5,50.18666666666667,82.82666666666667,32.64,105,173,68,ki_chroma
298,6,82.82666666666667,114.98666666666666,32.16,173,240,67,ki_chroma
298,7,114.98666666666666,121.70666666666666,6.719999999999999,240,254,14,ki_chroma
298,8,121.70666666666666,133.70666666666668,12.000000000000014,254,279,25,ki_chroma
298,9,133.70666666666668,191.986,58.27933333333331,279,399,120,ki_chroma
298,1,0.0,6.506666666666667,6.506666666666667,0,14,14,ki_chroma_acts
298,2,6.506666666666667,35.78666666666666,29.279999999999994,14,75,61,ki_chroma_acts
298,3,35.78666666666666,42.026666666666664,6.240000000000002,75,88,13,ki_chroma_acts
298,4,42.026666666666664,50.18666666666667,8.160000000000004,88,105,17,ki_chroma_acts
298,5,50.18666666666667,82.82666666666667,32.64,105,173,68,ki_chroma_acts
298,6,82.82666666666667,114.98666666666666,32.16,173,240,67,ki_chroma_acts
298,7,114.98666666666666,121.70666666666666,6.719999999999999,240,254,14,ki_chroma_acts
298,8,121.70666666666666,134.18666666666667,12.480000000000004,254,280,26,ki_chroma_acts
298,9,134.18666666666667,191.986,57.79933333333332,280,399,119,ki_chroma_acts
298,1,0.0,6.506666666666667,6.506666666666667,0,14,14,ki_chroma_acts_smoothed
298,2,6.506666666666667,22.826666666666664,16.319999999999997,14,48,34,ki_chroma_acts_smoothed
298,3,22.826666666666664,35.78666666666666,12.959999999999997,48,75,27,ki_chroma_acts_smoothed
298,4,35.78666666666666,42.026666666666664,6.240000000000002,75,88,13,ki_chroma_acts_smoothed
298,5,42.026666666666664,82.82666666666667,40.800000000000004,88,173,85,ki_chroma_acts_smoothed
298,6,82.82666666666667,114.98666666666666,32.16,173,240,67,ki_chroma_acts_smoothed
298,7,114.98666666666666,122.18666666666667,7.200000000000003,240,255,15,ki_chroma_acts_smoothed
298,8,122.18666666666667,134.18666666666667,12.0,255,280,25,ki_chroma_acts_smoothed
298,9,134.18666666666667,191.986,57.79933333333332,280,399,119,ki_chroma_acts_smoothed
299,1,0.0,14.901333333333332,14.901333333333332,0,32,32,chromagram
299,2,14.901333333333332,26.901333333333334,12.000000000000002,32,57,25,chromagram
299,3,26.901333333333334,60.98133333333333,34.08,57,128,71,chromagram
299,4,60.98133333333333,108.02133333333333,47.04,128,226,98,chromagram
299,5,108.02133333333333,120.98133333333332,12.959999999999994,226,253,27,chromagram
299,6,120.98133333333332,171.86133333333333,50.88000000000001,253,359,106,chromagram
299,7,171.86133333333333,241.94133333333332,70.07999999999998,359,505,146,chromagram
299,8,241.94133333333332,245.30133333333333,3.3600000000000136,505,512,7,chromagram
299,9,245.30133333333333,262.006,16.70466666666664,512,545,33,chromagram
299,1,0.0,14.901333333333332,14.901333333333332,0,32,32,chroma_acts
299,2,14.901333333333332,26.901333333333334,12.000000000000002,32,57,25,chroma_acts
299,3,26.901333333333334,34.58133333333333,7.68,57,73,16,chroma_acts
299,4,34.58133333333333,60.98133333333333,26.4,73,128,55,chroma_acts
299,5,60.98133333333333,108.02133333333333,47.04,128,226,98,chroma_acts
299,6,108.02133333333333,120.98133333333332,12.959999999999994,226,253,27,chroma_acts
299,7,120.98133333333332,171.86133333333333,50.88000000000001,253,359,106,chroma_acts
299,8,171.86133333333333,241.94133333333332,70.07999999999998,359,505,146,chroma_acts
299,9,241.94133333333332,262.006,20.064666666666653,505,545,40,chroma_acts
299,1,0.0,14.901333333333332,14.901333333333332,0,32,32,chroma_acts_smoothed
299,2,14.901333333333332,29.781333333333333,14.88,32,63,31,chroma_acts_smoothed
299,3,29.781333333333333,60.98133333333333,31.2,63,128,65,chroma_acts_smoothed
299,4,60.98133333333333,109.46133333333333,48.48,128,229,101,chroma_acts_smoothed
299,5,109.46133333333333,121.46133333333333,12.0,229,254,25,chroma_acts_smoothed
299,6,121.46133333333333,151.70133333333334,30.24000000000001,254,317,63,chroma_acts_smoothed
299,7,151.70133333333334,172.8213333333333,21.119999999999976,317,361,44,chroma_acts_smoothed
299,8,172.8213333333333,230.90133333333333,58.08000000000001,361,482,121,chroma_acts_smoothed
299,9,230.90133333333333,262.006,31.104666666666645,482,545,63,chroma_acts_smoothed
299,1,0.0,14.901333333333332,14.901333333333332,0,32,32,ki_chroma
299,2,14.901333333333332,26.901333333333334,12.000000000000002,32,57,25,ki_chroma
299,3,26.901333333333334,60.98133333333333,34.08,57,128,71,ki_chroma
299,4,60.98133333333333,108.02133333333333,47.04,128,226,98,ki_chroma
299,5,108.02133333333333,120.98133333333332,12.959999999999994,226,253,27,ki_chroma
299,6,120.98133333333332,171.86133333333333,50.88000000000001,253,359,106,ki_chroma
299,7,171.86133333333333,241.94133333333332,70.07999999999998,359,505,146,ki_chroma
299,8,241.94133333333332,245.30133333333333,3.3600000000000136,505,512,7,ki_chroma
299,9,245.30133333333333,262.006,16.70466666666664,512,545,33,ki_chroma
299,1,0.0,14.901333333333332,14.901333333333332,0,32,32,ki_chroma_acts
299,2,14.901333333333332,26.901333333333334,12.000000000000002,32,57,25,ki_chroma_acts
299,3,26.901333333333334,34.58133333333333,7.68,57,73,16,ki_chroma_acts
299,4,34.58133333333333,60.98133333333333,26.4,73,128,55,ki_chroma_acts
299,5,60.98133333333333,108.02133333333333,47.04,128,226,98,ki_chroma_acts
299,6,108.02133333333333,120.98133333333332,12.959999999999994,226,253,27,ki_chroma_acts
299,7,120.98133333333332,171.86133333333333,50.88000000000001,253,359,106,ki_chroma_acts
299,8,171.86133333333333,241.94133333333332,70.07999999999998,359,505,146,ki_chroma_acts
299,9,241.94133333333332,262.006,20.064666666666653,505,545,40,ki_chroma_acts
299,1,0.0,14.901333333333332,14.901333333333332,0,32,32,ki_chroma_acts_smoothed
299,2,14.901333333333332,29.781333333333333,14.88,32,63,31,ki_chroma_acts_smoothed
299,3,29.781333333333333,60.98133333333333,31.2,63,128,65,ki_chroma_acts_smoothed
299,4,60.98133333333333,109.46133333333333,48.48,128,229,101,ki_chroma_acts_smoothed
299,5,109.46133333333333,121.46133333333333,12.0,229,254,25,ki_chroma_acts_smoothed
299,6,121.46133333333333,151.70133333333334,30.24000000000001,254,317,63,ki_chroma_acts_smoothed
299,7,151.70133333333334,172.8213333333333,21.119999999999976,317,361,44,ki_chroma_acts_smoothed
299,8,172.8213333333333,230.90133333333333,58.08000000000001,361,482,121,ki_chroma_acts_smoothed
299,9,230.90133333333333,262.006,31.104666666666645,482,545,63,ki_chroma_acts_smoothed
300,1,0.0,8.842666666666666,8.842666666666666,0,19,19,chromagram
300,2,8.842666666666666,26.602666666666664,17.759999999999998,19,56,37,chromagram
300,3,26.602666666666664,53.00266666666666,26.4,56,111,55,chromagram
300,4,53.00266666666666,70.28266666666667,17.28000000000001,111,147,36,chromagram
300,5,70.28266666666667,84.20266666666666,13.919999999999987,147,176,29,chromagram
300,6,84.20266666666666,113.48266666666666,29.28,176,237,61,chromagram
300,7,113.48266666666666,133.16266666666667,19.680000000000007,237,278,41,chromagram
300,8,133.16266666666667,138.92266666666666,5.759999999999991,278,290,12,chromagram
300,9,138.92266666666666,169.587,30.66433333333333,290,352,62,chromagram
300,1,0.0,8.362666666666666,8.362666666666666,0,18,18,chroma_acts
300,2,8.362666666666666,26.602666666666664,18.24,18,56,38,chroma_acts
300,3,26.602666666666664,54.922666666666665,28.32,56,115,59,chroma_acts
300,4,54.922666666666665,72.20266666666666,17.279999999999994,115,151,36,chroma_acts
300,5,72.20266666666666,83.72266666666667,11.52000000000001,151,175,24,chroma_acts
300,6,83.72266666666667,115.88266666666667,32.16,175,242,67,chroma_acts
300,7,115.88266666666667,124.04266666666666,8.159999999999997,242,259,17,chroma_acts
300,8,124.04266666666666,136.04266666666666,12.0,259,284,25,chroma_acts
300,9,136.04266666666666,169.587,33.54433333333333,284,352,68,chroma_acts
300,1,0.0,8.362666666666666,8.362666666666666,0,18,18,chroma_acts_smoothed
300,2,8.362666666666666,27.082666666666665,18.72,18,57,39,chroma_acts_smoothed
300,3,27.082666666666665,55.40266666666666,28.319999999999997,57,116,59,chroma_acts_smoothed
300,4,55.40266666666666,70.76266666666666,15.36,116,148,32,chroma_acts_smoothed
300,5,70.76266666666666,83.72266666666667,12.960000000000008,148,175,27,chroma_acts_smoothed
300,6,83.72266666666667,113.48266666666666,29.75999999999999,175,237,62,chroma_acts_smoothed
300,7,113.48266666666666,124.04266666666666,10.560000000000002,237,259,22,chroma_acts_smoothed
300,8,124.04266666666666,136.04266666666666,12.0,259,284,25,chroma_acts_smoothed
300,9,136.04266666666666,169.587,33.54433333333333,284,352,68,chroma_acts_smoothed
300,1,0.0,8.842666666666666,8.842666666666666,0,19,19,ki_chroma
300,2,8.842666666666666,26.602666666666664,17.759999999999998,19,56,37,ki_chroma
300,3,26.602666666666664,53.00266666666666,26.4,56,111,55,ki_chroma
300,4,53.00266666666666,70.28266666666667,17.28000000000001,111,147,36,ki_chroma
300,5,70.28266666666667,84.20266666666666,13.919999999999987,147,176,29,ki_chroma
300,6,84.20266666666666,113.48266666666666,29.28,176,237,61,ki_chroma
300,7,113.48266666666666,133.16266666666667,19.680000000000007,237,278,41,ki_chroma
300,8,133.16266666666667,138.92266666666666,5.759999999999991,278,290,12,ki_chroma
300,9,138.92266666666666,169.587,30.66433333333333,290,352,62,ki_chroma
300,1,0.0,8.362666666666666,8.362666666666666,0,18,18,ki_chroma_acts
300,2,8.362666666666666,26.602666666666664,18.24,18,56,38,ki_chroma_acts
300,3,26.602666666666664,54.922666666666665,28.32,56,115,59,ki_chroma_acts
300,4,54.922666666666665,72.20266666666666,17.279999999999994,115,151,36,ki_chroma_acts
300,5,72.20266666666666,83.72266666666667,11.52000000000001,151,175,24,ki_chroma_acts
300,6,83.72266666666667,115.88266666666667,32.16,175,242,67,ki_chroma_acts
300,7,115.88266666666667,124.04266666666666,8.159999999999997,242,259,17,ki_chroma_acts
300,8,124.04266666666666,136.04266666666666,12.0,259,284,25,ki_chroma_acts
300,9,136.04266666666666,169.587,33.54433333333333,284,352,68,ki_chroma_acts
300,1,0.0,8.362666666666666,8.362666666666666,0,18,18,ki_chroma_acts_smoothed
300,2,8.362666666666666,27.082666666666665,18.72,18,57,39,ki_chroma_acts_smoothed
300,3,27.082666666666665,55.40266666666666,28.319999999999997,57,116,59,ki_chroma_acts_smoothed
300,4,55.40266666666666,70.76266666666666,15.36,116,148,32,ki_chroma_acts_smoothed
300,5,70.76266666666666,83.72266666666667,12.960000000000008,148,175,27,ki_chroma_acts_smoothed
300,6,83.72266666666667,113.48266666666666,29.75999999999999,175,237,62,ki_chroma_acts_smoothed
300,7,113.48266666666666,124.04266666666666,10.560000000000002,237,259,22,ki_chroma_acts_smoothed
300,8,124.04266666666666,136.04266666666666,12.0,259,284,25,ki_chroma_acts_smoothed
300,9,136.04266666666666,169.587,33.54433333333333,284,352,68,ki_chroma_acts_smoothed
301,1,0.0,28.842666666666666,28.842666666666666,0,61,61,chromagram
301,2,28.842666666666666,54.282666666666664,25.439999999999998,61,114,53,chromagram
301,3,54.282666666666664,120.04266666666666,65.75999999999999,114,251,137,chromagram
301,4,120.04266666666666,127.72266666666665,7.679999999999993,251,267,16,chromagram
301,5,127.72266666666665,154.60266666666666,26.88000000000001,267,323,56,chromagram
301,6,154.60266666666666,169.96266666666668,15.360000000000014,323,355,32,chromagram
301,7,169.96266666666668,209.32266666666666,39.359999999999985,355,437,82,chromagram
301,8,209.32266666666666,214.60266666666666,5.280000000000001,437,448,11,chromagram
301,9,214.60266666666666,279.682,65.07933333333335,448,582,134,chromagram
301,1,0.0,30.762666666666664,30.762666666666664,0,65,65,chroma_acts
301,2,30.762666666666664,65.32266666666666,34.56,65,137,72,chroma_acts
301,3,65.32266666666666,93.16266666666667,27.840000000000003,137,195,58,chroma_acts
301,4,93.16266666666667,120.52266666666667,27.36,195,252,57,chroma_acts
301,5,120.52266666666667,154.60266666666666,34.08,252,323,71,chroma_acts
301,6,154.60266666666666,169.96266666666668,15.360000000000014,323,355,32,chroma_acts
301,7,169.96266666666668,209.32266666666666,39.359999999999985,355,437,82,chroma_acts
301,8,209.32266666666666,214.60266666666666,5.280000000000001,437,448,11,chroma_acts
301,9,214.60266666666666,279.682,65.07933333333335,448,582,134,chroma_acts
301,1,0.0,31.242666666666665,31.242666666666665,0,66,66,chroma_acts_smoothed
301,2,31.242666666666665,54.76266666666666,23.519999999999996,66,115,49,chroma_acts_smoothed
301,3,54.76266666666666,120.04266666666666,65.28,115,251,136,chroma_acts_smoothed
301,4,120.04266666666666,127.72266666666665,7.679999999999993,251,267,16,chroma_acts_smoothed
301,5,127.72266666666665,153.64266666666668,25.92000000000003,267,321,54,chroma_acts_smoothed
301,6,153.64266666666668,169.96266666666668,16.319999999999993,321,355,34,chroma_acts_smoothed
301,7,169.96266666666668,208.84266666666667,38.879999999999995,355,436,81,chroma_acts_smoothed
301,8,208.84266666666667,214.60266666666666,5.759999999999991,436,448,12,chroma_acts_smoothed
301,9,214.60266666666666,279.682,65.07933333333335,448,582,134,chroma_acts_smoothed
301,1,0.0,28.842666666666666,28.842666666666666,0,61,61,ki_chroma
301,2,28.842666666666666,54.282666666666664,25.439999999999998,61,114,53,ki_chroma
301,3,54.282666666666664,120.04266666666666,65.75999999999999,114,251,137,ki_chroma
301,4,120.04266666666666,127.72266666666665,7.679999999999993,251,267,16,ki_chroma
301,5,127.72266666666665,154.60266666666666,26.88000000000001,267,323,56,ki_chroma
301,6,154.60266666666666,169.96266666666668,15.360000000000014,323,355,32,ki_chroma
301,7,169.96266666666668,209.32266666666666,39.359999999999985,355,437,82,ki_chroma
301,8,209.32266666666666,214.60266666666666,5.280000000000001,437,448,11,ki_chroma
301,9,214.60266666666666,279.682,65.07933333333335,448,582,134,ki_chroma
301,1,0.0,30.762666666666664,30.762666666666664,0,65,65,ki_chroma_acts
301,2,30.762666666666664,65.32266666666666,34.56,65,137,72,ki_chroma_acts
301,3,65.32266666666666,93.16266666666667,27.840000000000003,137,195,58,ki_chroma_acts
301,4,93.16266666666667,120.52266666666667,27.36,195,252,57,ki_chroma_acts
301,5,120.52266666666667,154.60266666666666,34.08,252,323,71,ki_chroma_acts
301,6,154.60266666666666,169.96266666666668,15.360000000000014,323,355,32,ki_chroma_acts
301,7,169.96266666666668,209.32266666666666,39.359999999999985,355,437,82,ki_chroma_acts
301,8,209.32266666666666,214.60266666666666,5.280000000000001,437,448,11,ki_chroma_acts
301,9,214.60266666666666,279.682,65.07933333333335,448,582,134,ki_chroma_acts
301,1,0.0,31.242666666666665,31.242666666666665,0,66,66,ki_chroma_acts_smoothed
301,2,31.242666666666665,54.76266666666666,23.519999999999996,66,115,49,ki_chroma_acts_smoothed
301,3,54.76266666666666,120.04266666666666,65.28,115,251,136,ki_chroma_acts_smoothed
301,4,120.04266666666666,127.72266666666665,7.679999999999993,251,267,16,ki_chroma_acts_smoothed
301,5,127.72266666666665,153.64266666666668,25.92000000000003,267,321,54,ki_chroma_acts_smoothed
301,6,153.64266666666668,169.96266666666668,16.319999999999993,321,355,34,ki_chroma_acts_smoothed
301,7,169.96266666666668,208.84266666666667,38.879999999999995,355,436,81,ki_chroma_acts_smoothed
301,8,208.84266666666667,214.60266666666666,5.759999999999991,436,448,12,ki_chroma_acts_smoothed
301,9,214.60266666666666,279.682,65.07933333333335,448,582,134,ki_chroma_acts_smoothed
302,1,0.0,15.402666666666665,15.402666666666665,0,33,33,chromagram
302,2,15.402666666666665,29.322666666666663,13.919999999999998,33,62,29,chromagram
302,3,29.322666666666663,34.602666666666664,5.280000000000001,62,73,11,chromagram
302,4,34.602666666666664,49.962666666666664,15.36,73,105,32,chromagram
302,5,49.962666666666664,76.84266666666666,26.879999999999995,105,161,56,chromagram
302,6,76.84266666666666,92.68266666666666,15.840000000000003,161,194,33,chromagram
302,7,92.68266666666666,108.52266666666667,15.840000000000003,194,227,33,chromagram
302,8,108.52266666666667,143.08266666666668,34.56000000000002,227,299,72,chromagram
302,9,143.08266666666668,186.542,43.45933333333332,299,388,89,chromagram
302,1,0.0,15.402666666666665,15.402666666666665,0,33,33,chroma_acts
302,2,15.402666666666665,29.322666666666663,13.919999999999998,33,62,29,chroma_acts
302,3,29.322666666666663,46.602666666666664,17.28,62,98,36,chroma_acts
302,4,46.602666666666664,49.962666666666664,3.3599999999999994,98,105,7,chroma_acts
302,5,49.962666666666664,77.80266666666667,27.840000000000003,105,163,58,chroma_acts
302,6,77.80266666666667,92.68266666666666,14.879999999999995,163,194,31,chroma_acts
302,7,92.68266666666666,108.52266666666667,15.840000000000003,194,227,33,chroma_acts
302,8,108.52266666666667,139.24266666666668,30.720000000000013,227,291,64,chroma_acts
302,9,139.24266666666668,186.542,47.29933333333332,291,388,97,chroma_acts
302,1,0.0,14.922666666666665,14.922666666666665,0,32,32,chroma_acts_smoothed
302,2,14.922666666666665,28.842666666666666,13.920000000000002,32,61,29,chroma_acts_smoothed
302,3,28.842666666666666,34.12266666666667,5.280000000000001,61,72,11,chroma_acts_smoothed
302,4,34.12266666666667,77.80266666666667,43.68,72,163,91,chroma_acts_smoothed
302,5,77.80266666666667,92.68266666666666,14.879999999999995,163,194,31,chroma_acts_smoothed
302,6,92.68266666666666,109.00266666666666,16.319999999999993,194,228,34,chroma_acts_smoothed
302,7,109.00266666666666,138.7626666666667,29.760000000000034,228,290,62,chroma_acts_smoothed
302,8,138.7626666666667,142.60266666666666,3.839999999999975,290,298,8,chroma_acts_smoothed
302,9,142.60266666666666,186.542,43.93933333333334,298,388,90,chroma_acts_smoothed
302,1,0.0,15.402666666666665,15.402666666666665,0,33,33,ki_chroma
302,2,15.402666666666665,29.322666666666663,13.919999999999998,33,62,29,ki_chroma
302,3,29.322666666666663,34.602666666666664,5.280000000000001,62,73,11,ki_chroma
302,4,34.602666666666664,49.962666666666664,15.36,73,105,32,ki_chroma
302,5,49.962666666666664,76.84266666666666,26.879999999999995,105,161,56,ki_chroma
302,6,76.84266666666666,92.68266666666666,15.840000000000003,161,194,33,ki_chroma
302,7,92.68266666666666,108.52266666666667,15.840000000000003,194,227,33,ki_chroma
302,8,108.52266666666667,143.08266666666668,34.56000000000002,227,299,72,ki_chroma
302,9,143.08266666666668,186.542,43.45933333333332,299,388,89,ki_chroma
302,1,0.0,15.402666666666665,15.402666666666665,0,33,33,ki_chroma_acts
302,2,15.402666666666665,29.322666666666663,13.919999999999998,33,62,29,ki_chroma_acts
302,3,29.322666666666663,46.602666666666664,17.28,62,98,36,ki_chroma_acts
302,4,46.602666666666664,49.962666666666664,3.3599999999999994,98,105,7,ki_chroma_acts
302,5,49.962666666666664,77.80266666666667,27.840000000000003,105,163,58,ki_chroma_acts
302,6,77.80266666666667,92.68266666666666,14.879999999999995,163,194,31,ki_chroma_acts
302,7,92.68266666666666,108.52266666666667,15.840000000000003,194,227,33,ki_chroma_acts
302,8,108.52266666666667,139.24266666666668,30.720000000000013,227,291,64,ki_chroma_acts
302,9,139.24266666666668,186.542,47.29933333333332,291,388,97,ki_chroma_acts
302,1,0.0,14.922666666666665,14.922666666666665,0,32,32,ki_chroma_acts_smoothed
302,2,14.922666666666665,28.842666666666666,13.920000000000002,32,61,29,ki_chroma_acts_smoothed
302,3,28.842666666666666,34.12266666666667,5.280000000000001,61,72,11,ki_chroma_acts_smoothed
302,4,34.12266666666667,77.80266666666667,43.68,72,163,91,ki_chroma_acts_smoothed
302,5,77.80266666666667,92.68266666666666,14.879999999999995,163,194,31,ki_chroma_acts_smoothed
302,6,92.68266666666666,109.00266666666666,16.319999999999993,194,228,34,ki_chroma_acts_smoothed
302,7,109.00266666666666,138.7626666666667,29.760000000000034,228,290,62,ki_chroma_acts_smoothed
302,8,138.7626666666667,142.60266666666666,3.839999999999975,290,298,8,ki_chroma_acts_smoothed
302,9,142.60266666666666,186.542,43.93933333333334,298,388,90,ki_chroma_acts_smoothed
303,1,0.0,7.648000000000001,7.648000000000001,0,22,22,chromagram
303,2,7.648000000000001,38.474666666666664,30.826666666666664,22,107,85,chromagram
303,3,38.474666666666664,83.44533333333334,44.97066666666667,107,231,124,chromagram
303,4,83.44533333333334,111.73333333333333,28.287999999999997,231,309,78,chromagram
303,5,111.73333333333333,116.44800000000001,4.714666666666673,309,322,13,chromagram
303,6,116.44800000000001,119.712,3.263999999999996,322,331,9,chromagram
303,7,119.712,130.9546666666667,11.242666666666693,331,362,31,chromagram
303,8,130.9546666666667,139.29600000000002,8.341333333333324,362,385,23,chromagram
303,9,139.29600000000002,194.521,55.224999999999966,385,536,151,chromagram
303,1,0.0,11.637333333333334,11.637333333333334,0,33,33,chroma_acts
303,2,11.637333333333334,38.112,26.474666666666668,33,106,73,chroma_acts
303,3,38.112,83.808,45.696000000000005,106,232,126,chroma_acts
303,4,83.808,108.46933333333334,24.66133333333333,232,300,68,chroma_acts
303,5,108.46933333333334,111.73333333333333,3.263999999999996,300,309,9,chroma_acts
303,6,111.73333333333333,116.81066666666668,5.077333333333343,309,323,14,chroma_acts
303,7,116.81066666666668,120.07466666666667,3.263999999999996,323,332,9,chroma_acts
303,8,120.07466666666667,139.29600000000002,19.221333333333348,332,385,53,chroma_acts
303,9,139.29600000000002,194.521,55.224999999999966,385,536,151,chroma_acts
303,1,0.0,11.274666666666668,11.274666666666668,0,32,32,chroma_acts_smoothed
303,2,11.274666666666668,38.83733333333333,27.562666666666665,32,108,76,chroma_acts_smoothed
303,3,38.83733333333333,83.44533333333334,44.608000000000004,108,231,123,chroma_acts_smoothed
303,4,83.44533333333334,112.096,28.650666666666666,231,310,79,chroma_acts_smoothed
303,5,112.096,116.44800000000001,4.352000000000004,310,322,12,chroma_acts_smoothed
303,6,116.44800000000001,122.61333333333334,6.165333333333336,322,339,17,chroma_acts_smoothed
303,7,122.61333333333334,130.9546666666667,8.341333333333353,339,362,23,chroma_acts_smoothed
303,8,130.9546666666667,139.65866666666668,8.70399999999998,362,386,24,chroma_acts_smoothed
303,9,139.65866666666668,194.521,54.86233333333331,386,536,150,chroma_acts_smoothed
303,1,0.0,7.648000000000001,7.648000000000001,0,22,22,ki_chroma
303,2,7.648000000000001,38.474666666666664,30.826666666666664,22,107,85,ki_chroma
303,3,38.474666666666664,83.44533333333334,44.97066666666667,107,231,124,ki_chroma
303,4,83.44533333333334,111.73333333333333,28.287999999999997,231,309,78,ki_chroma
303,5,111.73333333333333,116.44800000000001,4.714666666666673,309,322,13,ki_chroma
303,6,116.44800000000001,119.712,3.263999999999996,322,331,9,ki_chroma
303,7,119.712,130.9546666666667,11.242666666666693,331,362,31,ki_chroma
303,8,130.9546666666667,139.29600000000002,8.341333333333324,362,385,23,ki_chroma
303,9,139.29600000000002,194.521,55.224999999999966,385,536,151,ki_chroma
303,1,0.0,11.637333333333334,11.637333333333334,0,33,33,ki_chroma_acts
303,2,11.637333333333334,38.112,26.474666666666668,33,106,73,ki_chroma_acts
303,3,38.112,83.808,45.696000000000005,106,232,126,ki_chroma_acts
303,4,83.808,108.46933333333334,24.66133333333333,232,300,68,ki_chroma_acts
303,5,108.46933333333334,111.73333333333333,3.263999999999996,300,309,9,ki_chroma_acts
303,6,111.73333333333333,116.81066666666668,5.077333333333343,309,323,14,ki_chroma_acts
303,7,116.81066666666668,120.07466666666667,3.263999999999996,323,332,9,ki_chroma_acts
303,8,120.07466666666667,139.29600000000002,19.221333333333348,332,385,53,ki_chroma_acts
303,9,139.29600000000002,194.521,55.224999999999966,385,536,151,ki_chroma_acts
303,1,0.0,11.274666666666668,11.274666666666668,0,32,32,ki_chroma_acts_smoothed
303,2,11.274666666666668,38.83733333333333,27.562666666666665,32,108,76,ki_chroma_acts_smoothed
303,3,38.83733333333333,83.44533333333334,44.608000000000004,108,231,123,ki_chroma_acts_smoothed
303,4,83.44533333333334,112.096,28.650666666666666,231,310,79,ki_chroma_acts_smoothed
303,5,112.096,116.44800000000001,4.352000000000004,310,322,12,ki_chroma_acts_smoothed
303,6,116.44800000000001,122.61333333333334,6.165333333333336,322,339,17,ki_chroma_acts_smoothed
303,7,122.61333333333334,130.9546666666667,8.341333333333353,339,362,23,ki_chroma_acts_smoothed
303,8,130.9546666666667,139.65866666666668,8.70399999999998,362,386,24,ki_chroma_acts_smoothed
303,9,139.65866666666668,194.521,54.86233333333331,386,536,150,ki_chroma_acts_smoothed
304,1,0.0,14.837333333333333,14.837333333333333,0,32,32,chromagram
304,2,14.837333333333333,50.50666666666666,35.66933333333333,32,108,76,chromagram
304,3,50.50666666666666,75.38133333333333,24.87466666666667,108,161,53,chromagram
304,4,75.38133333333333,119.49866666666667,44.117333333333335,161,255,94,chromagram
304,5,119.49866666666667,126.53866666666666,7.039999999999992,255,270,15,chromagram
304,6,126.53866666666666,139.21066666666667,12.672000000000011,270,297,27,chromagram
304,7,139.21066666666667,143.4346666666667,4.224000000000018,297,306,9,chromagram
304,8,143.4346666666667,176.693,33.258333333333326,306,375,69,chromagram
304,1,0.0,14.837333333333333,14.837333333333333,0,32,32,chroma_acts
304,2,14.837333333333333,50.976,36.138666666666666,32,109,77,chroma_acts
304,3,50.976,75.38133333333333,24.40533333333333,109,161,52,chroma_acts
304,4,75.38133333333333,119.49866666666667,44.117333333333335,161,255,94,chroma_acts
304,5,119.49866666666667,126.53866666666666,7.039999999999992,255,270,15,chroma_acts
304,6,126.53866666666666,139.21066666666667,12.672000000000011,270,297,27,chroma_acts
304,7,139.21066666666667,143.4346666666667,4.224000000000018,297,306,9,chroma_acts
304,8,143.4346666666667,176.693,33.258333333333326,306,375,69,chroma_acts
304,1,0.0,14.837333333333333,14.837333333333333,0,32,32,chroma_acts_smoothed
304,2,14.837333333333333,50.50666666666666,35.66933333333333,32,108,76,chroma_acts_smoothed
304,3,50.50666666666666,75.38133333333333,24.87466666666667,108,161,53,chroma_acts_smoothed
304,4,75.38133333333333,119.02933333333333,43.647999999999996,161,254,93,chroma_acts_smoothed
304,5,119.02933333333333,127.008,7.978666666666669,254,271,17,chroma_acts_smoothed
304,6,127.008,138.74133333333333,11.733333333333334,271,296,25,chroma_acts_smoothed
304,7,138.74133333333333,143.4346666666667,4.6933333333333564,296,306,10,chroma_acts_smoothed
304,8,143.4346666666667,176.693,33.258333333333326,306,375,69,chroma_acts_smoothed
304,1,0.0,14.837333333333333,14.837333333333333,0,32,32,ki_chroma
304,2,14.837333333333333,50.50666666666666,35.66933333333333,32,108,76,ki_chroma
304,3,50.50666666666666,75.38133333333333,24.87466666666667,108,161,53,ki_chroma
304,4,75.38133333333333,119.49866666666667,44.117333333333335,161,255,94,ki_chroma
304,5,119.49866666666667,126.53866666666666,7.039999999999992,255,270,15,ki_chroma
304,6,126.53866666666666,139.21066666666667,12.672000000000011,270,297,27,ki_chroma
304,7,139.21066666666667,143.4346666666667,4.224000000000018,297,306,9,ki_chroma
304,8,143.4346666666667,176.693,33.258333333333326,306,375,69,ki_chroma
304,1,0.0,14.837333333333333,14.837333333333333,0,32,32,ki_chroma_acts
304,2,14.837333333333333,50.976,36.138666666666666,32,109,77,ki_chroma_acts
304,3,50.976,75.38133333333333,24.40533333333333,109,161,52,ki_chroma_acts
304,4,75.38133333333333,119.49866666666667,44.117333333333335,161,255,94,ki_chroma_acts
304,5,119.49866666666667,126.53866666666666,7.039999999999992,255,270,15,ki_chroma_acts
304,6,126.53866666666666,139.21066666666667,12.672000000000011,270,297,27,ki_chroma_acts
304,7,139.21066666666667,143.4346666666667,4.224000000000018,297,306,9,ki_chroma_acts
304,8,143.4346666666667,176.693,33.258333333333326,306,375,69,ki_chroma_acts
304,1,0.0,14.837333333333333,14.837333333333333,0,32,32,ki_chroma_acts_smoothed
304,2,14.837333333333333,50.50666666666666,35.66933333333333,32,108,76,ki_chroma_acts_smoothed
304,3,50.50666666666666,75.38133333333333,24.87466666666667,108,161,53,ki_chroma_acts_smoothed
304,4,75.38133333333333,119.02933333333333,43.647999999999996,161,254,93,ki_chroma_acts_smoothed
304,5,119.02933333333333,127.008,7.978666666666669,254,271,17,ki_chroma_acts_smoothed
304,6,127.008,138.74133333333333,11.733333333333334,271,296,25,ki_chroma_acts_smoothed
304,7,138.74133333333333,143.4346666666667,4.6933333333333564,296,306,10,ki_chroma_acts_smoothed
304,8,143.4346666666667,176.693,33.258333333333326,306,375,69,ki_chroma_acts_smoothed
305,1,0.0,8.192,8.192,0,18,18,chromagram
305,2,8.192,21.152,12.96,18,45,27,chromagram
305,3,21.152,38.912,17.759999999999998,45,82,37,chromagram
305,4,38.912,66.752,27.839999999999996,82,140,58,chromagram
305,5,66.752,75.872,9.120000000000005,140,159,19,chromagram
305,6,75.872,82.112,6.239999999999995,159,172,13,chromagram
305,7,82.112,99.872,17.760000000000005,172,209,37,chromagram
305,8,99.872,144.513,44.641000000000005,209,301,92,chromagram
305,1,0.0,8.192,8.192,0,18,18,chroma_acts
305,2,8.192,21.152,12.96,18,45,27,chroma_acts
305,3,21.152,38.912,17.759999999999998,45,82,37,chroma_acts
305,4,38.912,66.752,27.839999999999996,82,140,58,chroma_acts
305,5,66.752,75.872,9.120000000000005,140,159,19,chroma_acts
305,6,75.872,82.112,6.239999999999995,159,172,13,chroma_acts
305,7,82.112,99.872,17.760000000000005,172,209,37,chroma_acts
305,8,99.872,144.513,44.641000000000005,209,301,92,chroma_acts
305,1,0.0,8.192,8.192,0,18,18,chroma_acts_smoothed
305,2,8.192,21.152,12.96,18,45,27,chroma_acts_smoothed
305,3,21.152,38.912,17.759999999999998,45,82,37,chroma_acts_smoothed
305,4,38.912,66.752,27.839999999999996,82,140,58,chroma_acts_smoothed
305,5,66.752,75.872,9.120000000000005,140,159,19,chroma_acts_smoothed
305,6,75.872,82.112,6.239999999999995,159,172,13,chroma_acts_smoothed
305,7,82.112,99.872,17.760000000000005,172,209,37,chroma_acts_smoothed
305,8,99.872,144.513,44.641000000000005,209,301,92,chroma_acts_smoothed
305,1,0.0,8.192,8.192,0,18,18,ki_chroma
305,2,8.192,21.152,12.96,18,45,27,ki_chroma
305,3,21.152,38.912,17.759999999999998,45,82,37,ki_chroma
305,4,38.912,66.752,27.839999999999996,82,140,58,ki_chroma
305,5,66.752,75.872,9.120000000000005,140,159,19,ki_chroma
305,6,75.872,82.112,6.239999999999995,159,172,13,ki_chroma
305,7,82.112,99.872,17.760000000000005,172,209,37,ki_chroma
305,8,99.872,144.513,44.641000000000005,209,301,92,ki_chroma
305,1,0.0,8.192,8.192,0,18,18,ki_chroma_acts
305,2,8.192,21.152,12.96,18,45,27,ki_chroma_acts
305,3,21.152,38.912,17.759999999999998,45,82,37,ki_chroma_acts
305,4,38.912,66.752,27.839999999999996,82,140,58,ki_chroma_acts
305,5,66.752,75.872,9.120000000000005,140,159,19,ki_chroma_acts
305,6,75.872,82.112,6.239999999999995,159,172,13,ki_chroma_acts
305,7,82.112,99.872,17.760000000000005,172,209,37,ki_chroma_acts
305,8,99.872,144.513,44.641000000000005,209,301,92,ki_chroma_acts
305,1,0.0,8.192,8.192,0,18,18,ki_chroma_acts_smoothed
305,2,8.192,21.152,12.96,18,45,27,ki_chroma_acts_smoothed
305,3,21.152,38.912,17.759999999999998,45,82,37,ki_chroma_acts_smoothed
305,4,38.912,66.752,27.839999999999996,82,140,58,ki_chroma_acts_smoothed
305,5,66.752,75.872,9.120000000000005,140,159,19,ki_chroma_acts_smoothed
305,6,75.872,82.112,6.239999999999995,159,172,13,ki_chroma_acts_smoothed
305,7,82.112,99.872,17.760000000000005,172,209,37,ki_chroma_acts_smoothed
305,8,99.872,144.513,44.641000000000005,209,301,92,ki_chroma_acts_smoothed
306,1,0.0,16.725333333333335,16.725333333333335,0,35,35,chromagram
306,2,16.725333333333335,35.92533333333333,19.199999999999992,35,75,40,chromagram
306,3,35.92533333333333,93.04533333333333,57.120000000000005,75,194,119,chromagram
306,4,93.04533333333333,123.76533333333333,30.72,194,258,64,chromagram
306,5,123.76533333333333,139.60533333333333,15.840000000000003,258,291,33,chromagram
306,6,139.60533333333333,142.96533333333335,3.3600000000000136,291,298,7,chromagram
306,7,142.96533333333335,155.44533333333334,12.47999999999999,298,324,26,chromagram
306,8,155.44533333333334,160.24533333333335,4.800000000000011,324,334,10,chromagram
306,9,160.24533333333335,201.784,41.53866666666664,334,419,85,chromagram
306,1,0.0,16.725333333333335,16.725333333333335,0,35,35,chroma_acts
306,2,16.725333333333335,32.56533333333333,15.839999999999993,35,68,33,chroma_acts
306,3,32.56533333333333,92.56533333333333,60.0,68,193,125,chroma_acts
306,4,92.56533333333333,123.76533333333333,31.200000000000003,193,258,65,chroma_acts
306,5,123.76533333333333,139.12533333333334,15.360000000000014,258,290,32,chroma_acts
306,6,139.12533333333334,142.96533333333335,3.8400000000000034,290,298,8,chroma_acts
306,7,142.96533333333335,155.92533333333333,12.95999999999998,298,325,27,chroma_acts
306,8,155.92533333333333,159.76533333333333,3.8400000000000034,325,333,8,chroma_acts
306,9,159.76533333333333,201.784,42.01866666666666,333,419,86,chroma_acts
306,1,0.0,16.245333333333335,16.245333333333335,0,34,34,chroma_acts_smoothed
306,2,16.245333333333335,32.56533333333333,16.319999999999993,34,68,34,chroma_acts_smoothed
306,3,32.56533333333333,93.04533333333333,60.480000000000004,68,194,126,chroma_acts_smoothed
306,4,93.04533333333333,123.76533333333333,30.72,194,258,64,chroma_acts_smoothed
306,5,123.76533333333333,139.60533333333333,15.840000000000003,258,291,33,chroma_acts_smoothed
306,6,139.60533333333333,143.44533333333334,3.8400000000000034,291,299,8,chroma_acts_smoothed
306,7,143.44533333333334,155.44533333333334,12.0,299,324,25,chroma_acts_smoothed
306,8,155.44533333333334,159.28533333333334,3.8400000000000034,324,332,8,chroma_acts_smoothed
306,9,159.28533333333334,201.784,42.49866666666665,332,419,87,chroma_acts_smoothed
306,1,0.0,16.725333333333335,16.725333333333335,0,35,35,ki_chroma
306,2,16.725333333333335,35.92533333333333,19.199999999999992,35,75,40,ki_chroma
306,3,35.92533333333333,93.04533333333333,57.120000000000005,75,194,119,ki_chroma
306,4,93.04533333333333,123.76533333333333,30.72,194,258,64,ki_chroma
306,5,123.76533333333333,139.60533333333333,15.840000000000003,258,291,33,ki_chroma
306,6,139.60533333333333,142.96533333333335,3.3600000000000136,291,298,7,ki_chroma
306,7,142.96533333333335,155.44533333333334,12.47999999999999,298,324,26,ki_chroma
306,8,155.44533333333334,160.24533333333335,4.800000000000011,324,334,10,ki_chroma
306,9,160.24533333333335,201.784,41.53866666666664,334,419,85,ki_chroma
306,1,0.0,16.725333333333335,16.725333333333335,0,35,35,ki_chroma_acts
306,2,16.725333333333335,32.56533333333333,15.839999999999993,35,68,33,ki_chroma_acts
306,3,32.56533333333333,92.56533333333333,60.0,68,193,125,ki_chroma_acts
306,4,92.56533333333333,123.76533333333333,31.200000000000003,193,258,65,ki_chroma_acts
306,5,123.76533333333333,139.12533333333334,15.360000000000014,258,290,32,ki_chroma_acts
306,6,139.12533333333334,142.96533333333335,3.8400000000000034,290,298,8,ki_chroma_acts
306,7,142.96533333333335,155.92533333333333,12.95999999999998,298,325,27,ki_chroma_acts
306,8,155.92533333333333,159.76533333333333,3.8400000000000034,325,333,8,ki_chroma_acts
306,9,159.76533333333333,201.784,42.01866666666666,333,419,86,ki_chroma_acts
306,1,0.0,16.245333333333335,16.245333333333335,0,34,34,ki_chroma_acts_smoothed
306,2,16.245333333333335,32.56533333333333,16.319999999999993,34,68,34,ki_chroma_acts_smoothed
306,3,32.56533333333333,93.04533333333333,60.480000000000004,68,194,126,ki_chroma_acts_smoothed
306,4,93.04533333333333,123.76533333333333,30.72,194,258,64,ki_chroma_acts_smoothed
306,5,123.76533333333333,139.60533333333333,15.840000000000003,258,291,33,ki_chroma_acts_smoothed
306,6,139.60533333333333,143.44533333333334,3.8400000000000034,291,299,8,ki_chroma_acts_smoothed
306,7,143.44533333333334,155.44533333333334,12.0,299,324,25,ki_chroma_acts_smoothed
306,8,155.44533333333334,159.28533333333334,3.8400000000000034,324,332,8,ki_chroma_acts_smoothed
306,9,159.28533333333334,201.784,42.49866666666665,332,419,87,ki_chroma_acts_smoothed
307,1,0.0,14.698666666666666,14.698666666666666,0,31,31,chromagram
307,2,14.698666666666666,16.138666666666666,1.4399999999999995,31,34,3,chromagram
307,3,16.138666666666666,22.378666666666664,6.239999999999998,34,47,13,chromagram
307,4,22.378666666666664,39.65866666666667,17.280000000000005,47,83,36,chromagram
307,5,39.65866666666667,85.73866666666666,46.07999999999999,83,179,96,chromagram
307,6,85.73866666666666,101.09866666666666,15.36,179,211,32,chromagram
307,7,101.09866666666666,116.93866666666666,15.840000000000003,211,244,33,chromagram
307,8,116.93866666666666,133.25866666666667,16.320000000000007,244,278,34,chromagram
307,9,133.25866666666667,194.748,61.48933333333332,278,405,127,chromagram
307,1,0.0,14.698666666666666,14.698666666666666,0,31,31,chroma_acts
307,2,14.698666666666666,15.658666666666667,0.9600000000000009,31,33,2,chroma_acts
307,3,15.658666666666667,22.378666666666664,6.719999999999997,33,47,14,chroma_acts
307,4,22.378666666666664,39.65866666666667,17.280000000000005,47,83,36,chroma_acts
307,5,39.65866666666667,85.73866666666666,46.07999999999999,83,179,96,chroma_acts
307,6,85.73866666666666,101.09866666666666,15.36,179,211,32,chroma_acts
307,7,101.09866666666666,116.93866666666666,15.840000000000003,211,244,33,chroma_acts
307,8,116.93866666666666,133.25866666666667,16.320000000000007,244,278,34,chroma_acts
307,9,133.25866666666667,194.748,61.48933333333332,278,405,127,chroma_acts
307,1,0.0,22.378666666666664,22.378666666666664,0,47,47,chroma_acts_smoothed
307,2,22.378666666666664,27.178666666666665,4.800000000000001,47,57,10,chroma_acts_smoothed
307,3,27.178666666666665,36.778666666666666,9.600000000000001,57,77,20,chroma_acts_smoothed
307,4,36.778666666666666,40.138666666666666,3.3599999999999994,77,84,7,chroma_acts_smoothed
307,5,40.138666666666666,85.73866666666666,45.599999999999994,84,179,95,chroma_acts_smoothed
307,6,85.73866666666666,101.57866666666666,15.840000000000003,179,212,33,chroma_acts_smoothed
307,7,101.57866666666666,116.45866666666666,14.879999999999995,212,243,31,chroma_acts_smoothed
307,8,116.45866666666666,133.25866666666667,16.80000000000001,243,278,35,chroma_acts_smoothed
307,9,133.25866666666667,194.748,61.48933333333332,278,405,127,chroma_acts_smoothed
307,1,0.0,14.698666666666666,14.698666666666666,0,31,31,ki_chroma
307,2,14.698666666666666,16.138666666666666,1.4399999999999995,31,34,3,ki_chroma
307,3,16.138666666666666,22.378666666666664,6.239999999999998,34,47,13,ki_chroma
307,4,22.378666666666664,39.65866666666667,17.280000000000005,47,83,36,ki_chroma
307,5,39.65866666666667,85.73866666666666,46.07999999999999,83,179,96,ki_chroma
307,6,85.73866666666666,101.09866666666666,15.36,179,211,32,ki_chroma
307,7,101.09866666666666,116.93866666666666,15.840000000000003,211,244,33,ki_chroma
307,8,116.93866666666666,133.25866666666667,16.320000000000007,244,278,34,ki_chroma
307,9,133.25866666666667,194.748,61.48933333333332,278,405,127,ki_chroma
307,1,0.0,14.698666666666666,14.698666666666666,0,31,31,ki_chroma_acts
307,2,14.698666666666666,15.658666666666667,0.9600000000000009,31,33,2,ki_chroma_acts
307,3,15.658666666666667,22.378666666666664,6.719999999999997,33,47,14,ki_chroma_acts
307,4,22.378666666666664,39.65866666666667,17.280000000000005,47,83,36,ki_chroma_acts
307,5,39.65866666666667,85.73866666666666,46.07999999999999,83,179,96,ki_chroma_acts
307,6,85.73866666666666,101.09866666666666,15.36,179,211,32,ki_chroma_acts
307,7,101.09866666666666,116.93866666666666,15.840000000000003,211,244,33,ki_chroma_acts
307,8,116.93866666666666,133.25866666666667,16.320000000000007,244,278,34,ki_chroma_acts
307,9,133.25866666666667,194.748,61.48933333333332,278,405,127,ki_chroma_acts
307,1,0.0,22.378666666666664,22.378666666666664,0,47,47,ki_chroma_acts_smoothed
307,2,22.378666666666664,27.178666666666665,4.800000000000001,47,57,10,ki_chroma_acts_smoothed
307,3,27.178666666666665,36.778666666666666,9.600000000000001,57,77,20,ki_chroma_acts_smoothed
307,4,36.778666666666666,40.138666666666666,3.3599999999999994,77,84,7,ki_chroma_acts_smoothed
307,5,40.138666666666666,85.73866666666666,45.599999999999994,84,179,95,ki_chroma_acts_smoothed
307,6,85.73866666666666,101.57866666666666,15.840000000000003,179,212,33,ki_chroma_acts_smoothed
307,7,101.57866666666666,116.45866666666666,14.879999999999995,212,243,31,ki_chroma_acts_smoothed
307,8,116.45866666666666,133.25866666666667,16.80000000000001,243,278,35,ki_chroma_acts_smoothed
307,9,133.25866666666667,194.748,61.48933333333332,278,405,127,ki_chroma_acts_smoothed
308,1,0.0,6.048,6.048,0,13,13,chromagram
308,2,6.048,23.328,17.28,13,49,36,chromagram
308,3,23.328,38.687999999999995,15.359999999999996,49,81,32,chromagram
308,4,38.687999999999995,83.32799999999999,44.63999999999999,81,174,93,chromagram
308,5,83.32799999999999,100.128,16.80000000000001,174,209,35,chromagram
308,6,100.128,115.48799999999999,15.359999999999985,209,241,32,chromagram
308,7,115.48799999999999,146.68800000000002,31.20000000000003,241,306,65,chromagram
308,8,146.68800000000002,175.96800000000002,29.28,306,367,61,chromagram
308,9,175.96800000000002,223.45,47.48199999999997,367,464,97,chromagram
308,1,0.0,5.568,5.568,0,12,12,chroma_acts
308,2,5.568,23.328,17.759999999999998,12,49,37,chroma_acts
308,3,23.328,38.687999999999995,15.359999999999996,49,81,32,chroma_acts
308,4,38.687999999999995,83.32799999999999,44.63999999999999,81,174,93,chroma_acts
308,5,83.32799999999999,100.128,16.80000000000001,174,209,35,chroma_acts
308,6,100.128,115.48799999999999,15.359999999999985,209,241,32,chroma_acts
308,7,115.48799999999999,146.68800000000002,31.20000000000003,241,306,65,chroma_acts
308,8,146.68800000000002,177.888,31.19999999999999,306,371,65,chroma_acts
308,9,177.888,223.45,45.56199999999998,371,464,93,chroma_acts
308,1,0.0,6.048,6.048,0,13,13,chroma_acts_smoothed
308,2,6.048,23.328,17.28,13,49,36,chroma_acts_smoothed
308,3,23.328,39.16799999999999,15.839999999999993,49,82,33,chroma_acts_smoothed
308,4,39.16799999999999,83.32799999999999,44.16,82,174,92,chroma_acts_smoothed
308,5,83.32799999999999,99.16799999999999,15.840000000000003,174,207,33,chroma_acts_smoothed
308,6,99.16799999999999,115.48799999999999,16.319999999999993,207,241,34,chroma_acts_smoothed
308,7,115.48799999999999,146.68800000000002,31.20000000000003,241,306,65,chroma_acts_smoothed
308,8,146.68800000000002,177.888,31.19999999999999,306,371,65,chroma_acts_smoothed
308,9,177.888,223.45,45.56199999999998,371,464,93,chroma_acts_smoothed
308,1,0.0,6.048,6.048,0,13,13,ki_chroma
308,2,6.048,23.328,17.28,13,49,36,ki_chroma
308,3,23.328,38.687999999999995,15.359999999999996,49,81,32,ki_chroma
308,4,38.687999999999995,83.32799999999999,44.63999999999999,81,174,93,ki_chroma
308,5,83.32799999999999,100.128,16.80000000000001,174,209,35,ki_chroma
308,6,100.128,115.48799999999999,15.359999999999985,209,241,32,ki_chroma
308,7,115.48799999999999,146.68800000000002,31.20000000000003,241,306,65,ki_chroma
308,8,146.68800000000002,175.96800000000002,29.28,306,367,61,ki_chroma
308,9,175.96800000000002,223.45,47.48199999999997,367,464,97,ki_chroma
308,1,0.0,5.568,5.568,0,12,12,ki_chroma_acts
308,2,5.568,23.328,17.759999999999998,12,49,37,ki_chroma_acts
308,3,23.328,38.687999999999995,15.359999999999996,49,81,32,ki_chroma_acts
308,4,38.687999999999995,83.32799999999999,44.63999999999999,81,174,93,ki_chroma_acts
308,5,83.32799999999999,100.128,16.80000000000001,174,209,35,ki_chroma_acts
308,6,100.128,115.48799999999999,15.359999999999985,209,241,32,ki_chroma_acts
308,7,115.48799999999999,146.68800000000002,31.20000000000003,241,306,65,ki_chroma_acts
308,8,146.68800000000002,177.888,31.19999999999999,306,371,65,ki_chroma_acts
308,9,177.888,223.45,45.56199999999998,371,464,93,ki_chroma_acts
308,1,0.0,6.048,6.048,0,13,13,ki_chroma_acts_smoothed
308,2,6.048,23.328,17.28,13,49,36,ki_chroma_acts_smoothed
308,3,23.328,39.16799999999999,15.839999999999993,49,82,33,ki_chroma_acts_smoothed
308,4,39.16799999999999,83.32799999999999,44.16,82,174,92,ki_chroma_acts_smoothed
308,5,83.32799999999999,99.16799999999999,15.840000000000003,174,207,33,ki_chroma_acts_smoothed
308,6,99.16799999999999,115.48799999999999,16.319999999999993,207,241,34,ki_chroma_acts_smoothed
308,7,115.48799999999999,146.68800000000002,31.20000000000003,241,306,65,ki_chroma_acts_smoothed
308,8,146.68800000000002,177.888,31.19999999999999,306,371,65,ki_chroma_acts_smoothed
308,9,177.888,223.45,45.56199999999998,371,464,93,ki_chroma_acts_smoothed
309,1,0.0,17.866666666666667,17.866666666666667,0,38,38,chromagram
309,2,17.866666666666667,42.346666666666664,24.479999999999997,38,89,51,chromagram
309,3,42.346666666666664,45.70666666666666,3.3599999999999994,89,96,7,chromagram
309,4,45.70666666666666,105.22666666666667,59.52000000000001,96,220,124,chromagram
309,5,105.22666666666667,122.50666666666667,17.28,220,256,36,chromagram
309,6,122.50666666666667,138.34666666666666,15.83999999999999,256,289,33,chromagram
309,7,138.34666666666666,151.30666666666667,12.960000000000008,289,316,27,chromagram
309,8,151.30666666666667,215.846,64.53933333333333,316,449,133,chromagram
309,1,0.0,17.866666666666667,17.866666666666667,0,38,38,chroma_acts
309,2,17.866666666666667,42.346666666666664,24.479999999999997,38,89,51,chroma_acts
309,3,42.346666666666664,45.70666666666666,3.3599999999999994,89,96,7,chroma_acts
309,4,45.70666666666666,105.22666666666667,59.52000000000001,96,220,124,chroma_acts
309,5,105.22666666666667,137.86666666666667,32.64,220,288,68,chroma_acts
309,6,137.86666666666667,148.90666666666667,11.039999999999992,288,311,23,chroma_acts
309,7,148.90666666666667,152.26666666666668,3.3600000000000136,311,318,7,chroma_acts
309,8,152.26666666666668,215.846,63.579333333333324,318,449,131,chroma_acts
309,1,0.0,17.386666666666667,17.386666666666667,0,37,37,chroma_acts_smoothed
309,2,17.386666666666667,42.346666666666664,24.959999999999997,37,89,52,chroma_acts_smoothed
309,3,42.346666666666664,45.70666666666666,3.3599999999999994,89,96,7,chroma_acts_smoothed
309,4,45.70666666666666,105.22666666666667,59.52000000000001,96,220,124,chroma_acts_smoothed
309,5,105.22666666666667,122.98666666666666,17.75999999999999,220,257,37,chroma_acts_smoothed
309,6,122.98666666666666,137.86666666666667,14.88000000000001,257,288,31,chroma_acts_smoothed
309,7,137.86666666666667,152.74666666666667,14.879999999999995,288,319,31,chroma_acts_smoothed
309,8,152.74666666666667,215.846,63.099333333333334,319,449,130,chroma_acts_smoothed
309,1,0.0,17.866666666666667,17.866666666666667,0,38,38,ki_chroma
309,2,17.866666666666667,42.346666666666664,24.479999999999997,38,89,51,ki_chroma
309,3,42.346666666666664,45.70666666666666,3.3599999999999994,89,96,7,ki_chroma
309,4,45.70666666666666,105.22666666666667,59.52000000000001,96,220,124,ki_chroma
309,5,105.22666666666667,122.50666666666667,17.28,220,256,36,ki_chroma
309,6,122.50666666666667,138.34666666666666,15.83999999999999,256,289,33,ki_chroma
309,7,138.34666666666666,151.30666666666667,12.960000000000008,289,316,27,ki_chroma
309,8,151.30666666666667,215.846,64.53933333333333,316,449,133,ki_chroma
309,1,0.0,17.866666666666667,17.866666666666667,0,38,38,ki_chroma_acts
309,2,17.866666666666667,42.346666666666664,24.479999999999997,38,89,51,ki_chroma_acts
309,3,42.346666666666664,45.70666666666666,3.3599999999999994,89,96,7,ki_chroma_acts
309,4,45.70666666666666,105.22666666666667,59.52000000000001,96,220,124,ki_chroma_acts
309,5,105.22666666666667,137.86666666666667,32.64,220,288,68,ki_chroma_acts
309,6,137.86666666666667,148.90666666666667,11.039999999999992,288,311,23,ki_chroma_acts
309,7,148.90666666666667,152.26666666666668,3.3600000000000136,311,318,7,ki_chroma_acts
309,8,152.26666666666668,215.846,63.579333333333324,318,449,131,ki_chroma_acts
309,1,0.0,17.386666666666667,17.386666666666667,0,37,37,ki_chroma_acts_smoothed
309,2,17.386666666666667,42.346666666666664,24.959999999999997,37,89,52,ki_chroma_acts_smoothed
309,3,42.346666666666664,45.70666666666666,3.3599999999999994,89,96,7,ki_chroma_acts_smoothed
309,4,45.70666666666666,105.22666666666667,59.52000000000001,96,220,124,ki_chroma_acts_smoothed
309,5,105.22666666666667,122.98666666666666,17.75999999999999,220,257,37,ki_chroma_acts_smoothed
309,6,122.98666666666666,137.86666666666667,14.88000000000001,257,288,31,ki_chroma_acts_smoothed
309,7,137.86666666666667,152.74666666666667,14.879999999999995,288,319,31,ki_chroma_acts_smoothed
309,8,152.74666666666667,215.846,63.099333333333334,319,449,130,ki_chroma_acts_smoothed
310,1,0.0,15.946666666666667,15.946666666666667,0,34,34,chromagram
310,2,15.946666666666667,30.826666666666664,14.879999999999997,34,65,31,chromagram
310,3,30.826666666666664,59.626666666666665,28.8,65,125,60,chromagram
310,4,59.626666666666665,106.18666666666667,46.56,125,222,97,chromagram
310,5,106.18666666666667,121.06666666666666,14.879999999999995,222,253,31,chromagram
310,6,121.06666666666666,122.98666666666666,1.9200000000000017,253,257,4,chromagram
310,7,122.98666666666666,136.42666666666665,13.439999999999984,257,285,28,chromagram
310,8,136.42666666666665,182.98666666666665,46.56,285,382,97,chromagram
310,9,182.98666666666665,216.346,33.35933333333335,382,450,68,chromagram
310,1,0.0,15.946666666666667,15.946666666666667,0,34,34,chroma_acts
310,2,15.946666666666667,36.586666666666666,20.64,34,77,43,chroma_acts
310,3,36.586666666666666,38.50666666666667,1.9200000000000017,77,81,4,chroma_acts
310,4,38.50666666666667,44.266666666666666,5.759999999999998,81,93,12,chroma_acts
310,5,44.266666666666666,59.14666666666667,14.880000000000003,93,124,31,chroma_acts
310,6,59.14666666666667,106.18666666666667,47.04,124,222,98,chroma_acts
310,7,106.18666666666667,135.94666666666666,29.75999999999999,222,284,62,chroma_acts
310,8,135.94666666666666,182.98666666666665,47.03999999999999,284,382,98,chroma_acts
310,9,182.98666666666665,216.346,33.35933333333335,382,450,68,chroma_acts
310,1,0.0,15.946666666666667,15.946666666666667,0,34,34,chroma_acts_smoothed
310,2,15.946666666666667,30.826666666666664,14.879999999999997,34,65,31,chroma_acts_smoothed
310,3,30.826666666666664,59.14666666666667,28.320000000000004,65,124,59,chroma_acts_smoothed
310,4,59.14666666666667,90.82666666666667,31.68,124,190,66,chroma_acts_smoothed
310,5,90.82666666666667,94.18666666666667,3.3599999999999994,190,197,7,chroma_acts_smoothed
310,6,94.18666666666667,106.18666666666667,12.0,197,222,25,chroma_acts_smoothed
310,7,106.18666666666667,135.94666666666666,29.75999999999999,222,284,62,chroma_acts_smoothed
310,8,135.94666666666666,182.98666666666665,47.03999999999999,284,382,98,chroma_acts_smoothed
310,9,182.98666666666665,216.346,33.35933333333335,382,450,68,chroma_acts_smoothed
310,1,0.0,15.946666666666667,15.946666666666667,0,34,34,ki_chroma
310,2,15.946666666666667,30.826666666666664,14.879999999999997,34,65,31,ki_chroma
310,3,30.826666666666664,59.626666666666665,28.8,65,125,60,ki_chroma
310,4,59.626666666666665,106.18666666666667,46.56,125,222,97,ki_chroma
310,5,106.18666666666667,121.06666666666666,14.879999999999995,222,253,31,ki_chroma
310,6,121.06666666666666,122.98666666666666,1.9200000000000017,253,257,4,ki_chroma
310,7,122.98666666666666,136.42666666666665,13.439999999999984,257,285,28,ki_chroma
310,8,136.42666666666665,182.98666666666665,46.56,285,382,97,ki_chroma
310,9,182.98666666666665,216.346,33.35933333333335,382,450,68,ki_chroma
310,1,0.0,15.946666666666667,15.946666666666667,0,34,34,ki_chroma_acts
310,2,15.946666666666667,36.586666666666666,20.64,34,77,43,ki_chroma_acts
310,3,36.586666666666666,38.50666666666667,1.9200000000000017,77,81,4,ki_chroma_acts
310,4,38.50666666666667,44.266666666666666,5.759999999999998,81,93,12,ki_chroma_acts
310,5,44.266666666666666,59.14666666666667,14.880000000000003,93,124,31,ki_chroma_acts
310,6,59.14666666666667,106.18666666666667,47.04,124,222,98,ki_chroma_acts
310,7,106.18666666666667,135.94666666666666,29.75999999999999,222,284,62,ki_chroma_acts
310,8,135.94666666666666,182.98666666666665,47.03999999999999,284,382,98,ki_chroma_acts
310,9,182.98666666666665,216.346,33.35933333333335,382,450,68,ki_chroma_acts
310,1,0.0,15.946666666666667,15.946666666666667,0,34,34,ki_chroma_acts_smoothed
310,2,15.946666666666667,30.826666666666664,14.879999999999997,34,65,31,ki_chroma_acts_smoothed
310,3,30.826666666666664,59.14666666666667,28.320000000000004,65,124,59,ki_chroma_acts_smoothed
310,4,59.14666666666667,90.82666666666667,31.68,124,190,66,ki_chroma_acts_smoothed
310,5,90.82666666666667,94.18666666666667,3.3599999999999994,190,197,7,ki_chroma_acts_smoothed
310,6,94.18666666666667,106.18666666666667,12.0,197,222,25,ki_chroma_acts_smoothed
310,7,106.18666666666667,135.94666666666666,29.75999999999999,222,284,62,ki_chroma_acts_smoothed
310,8,135.94666666666666,182.98666666666665,47.03999999999999,284,382,98,ki_chroma_acts_smoothed
310,9,182.98666666666665,216.346,33.35933333333335,382,450,68,ki_chroma_acts_smoothed
311,1,0.0,28.842666666666666,28.842666666666666,0,61,61,chromagram
311,2,28.842666666666666,58.12266666666666,29.279999999999994,61,122,61,chromagram
311,3,58.12266666666666,108.52266666666667,50.400000000000006,122,227,105,chromagram
311,4,108.52266666666667,110.44266666666667,1.9200000000000017,227,231,4,chromagram
311,5,110.44266666666667,123.88266666666667,13.439999999999998,231,259,28,chromagram
311,6,123.88266666666667,151.24266666666668,27.360000000000014,259,316,57,chromagram
311,7,151.24266666666668,201.16266666666667,49.91999999999999,316,420,104,chromagram
311,8,201.16266666666667,235.828,34.665333333333336,420,491,71,chromagram
311,1,0.0,28.842666666666666,28.842666666666666,0,61,61,chroma_acts
311,2,28.842666666666666,60.04266666666666,31.199999999999996,61,126,65,chroma_acts
311,3,60.04266666666666,110.92266666666666,50.879999999999995,126,232,106,chroma_acts
311,4,110.92266666666666,123.88266666666667,12.960000000000008,232,259,27,chroma_acts
311,5,123.88266666666667,139.72266666666667,15.840000000000003,259,292,33,chroma_acts
311,6,139.72266666666667,153.16266666666667,13.439999999999998,292,320,28,chroma_acts
311,7,153.16266666666667,177.64266666666668,24.480000000000018,320,371,51,chroma_acts
311,8,177.64266666666668,235.828,58.18533333333332,371,491,120,chroma_acts
311,1,0.0,28.842666666666666,28.842666666666666,0,61,61,chroma_acts_smoothed
311,2,28.842666666666666,60.04266666666666,31.199999999999996,61,126,65,chroma_acts_smoothed
311,3,60.04266666666666,110.92266666666666,50.879999999999995,126,232,106,chroma_acts_smoothed
311,4,110.92266666666666,123.88266666666667,12.960000000000008,232,259,27,chroma_acts_smoothed
311,5,123.88266666666667,139.72266666666667,15.840000000000003,259,292,33,chroma_acts_smoothed
311,6,139.72266666666667,151.24266666666668,11.52000000000001,292,316,24,chroma_acts_smoothed
311,7,151.24266666666668,177.64266666666668,26.400000000000006,316,371,55,chroma_acts_smoothed
311,8,177.64266666666668,235.828,58.18533333333332,371,491,120,chroma_acts_smoothed
311,1,0.0,28.842666666666666,28.842666666666666,0,61,61,ki_chroma
311,2,28.842666666666666,58.12266666666666,29.279999999999994,61,122,61,ki_chroma
311,3,58.12266666666666,108.52266666666667,50.400000000000006,122,227,105,ki_chroma
311,4,108.52266666666667,110.44266666666667,1.9200000000000017,227,231,4,ki_chroma
311,5,110.44266666666667,123.88266666666667,13.439999999999998,231,259,28,ki_chroma
311,6,123.88266666666667,151.24266666666668,27.360000000000014,259,316,57,ki_chroma
311,7,151.24266666666668,201.16266666666667,49.91999999999999,316,420,104,ki_chroma
311,8,201.16266666666667,235.828,34.665333333333336,420,491,71,ki_chroma
311,1,0.0,28.842666666666666,28.842666666666666,0,61,61,ki_chroma_acts
311,2,28.842666666666666,60.04266666666666,31.199999999999996,61,126,65,ki_chroma_acts
311,3,60.04266666666666,110.92266666666666,50.879999999999995,126,232,106,ki_chroma_acts
311,4,110.92266666666666,123.88266666666667,12.960000000000008,232,259,27,ki_chroma_acts
311,5,123.88266666666667,139.72266666666667,15.840000000000003,259,292,33,ki_chroma_acts
311,6,139.72266666666667,153.16266666666667,13.439999999999998,292,320,28,ki_chroma_acts
311,7,153.16266666666667,177.64266666666668,24.480000000000018,320,371,51,ki_chroma_acts
311,8,177.64266666666668,235.828,58.18533333333332,371,491,120,ki_chroma_acts
311,1,0.0,28.842666666666666,28.842666666666666,0,61,61,ki_chroma_acts_smoothed
311,2,28.842666666666666,60.04266666666666,31.199999999999996,61,126,65,ki_chroma_acts_smoothed
311,3,60.04266666666666,110.92266666666666,50.879999999999995,126,232,106,ki_chroma_acts_smoothed
311,4,110.92266666666666,123.88266666666667,12.960000000000008,232,259,27,ki_chroma_acts_smoothed
311,5,123.88266666666667,139.72266666666667,15.840000000000003,259,292,33,ki_chroma_acts_smoothed
311,6,139.72266666666667,151.24266666666668,11.52000000000001,292,316,24,ki_chroma_acts_smoothed
311,7,151.24266666666668,177.64266666666668,26.400000000000006,316,371,55,ki_chroma_acts_smoothed
311,8,177.64266666666668,235.828,58.18533333333332,371,491,120,ki_chroma_acts_smoothed
313,1,0.0,14.911999999999999,14.911999999999999,0,32,32,chromagram
313,2,14.911999999999999,28.352,13.440000000000001,32,60,28,chromagram
313,3,28.352,60.992,32.64,60,128,68,chromagram
313,4,60.992,99.392,38.4,128,208,80,chromagram
313,5,99.392,102.752,3.3599999999999994,208,215,7,chromagram
313,6,102.752,137.31199999999998,34.55999999999999,215,287,72,chromagram
313,7,137.31199999999998,147.392,10.080000000000013,287,308,21,chromagram
313,8,147.392,168.512,21.120000000000005,308,352,44,chromagram
313,9,168.512,190.521,22.008999999999986,352,396,44,chromagram
313,1,0.0,13.472,13.472,0,29,29,chroma_acts
313,2,13.472,29.311999999999998,15.839999999999998,29,62,33,chroma_acts
313,3,29.311999999999998,54.272,24.96,62,114,52,chroma_acts
313,4,54.272,58.592,4.32,114,123,9,chroma_acts
313,5,58.592,99.392,40.8,123,208,85,chroma_acts
313,6,99.392,125.792,26.400000000000006,208,263,55,chroma_acts
313,7,125.792,137.31199999999998,11.519999999999982,263,287,24,chroma_acts
313,8,137.31199999999998,168.512,31.200000000000017,287,352,65,chroma_acts
313,9,168.512,190.521,22.008999999999986,352,396,44,chroma_acts
313,1,0.0,13.472,13.472,0,29,29,chroma_acts_smoothed
313,2,13.472,29.791999999999998,16.32,29,63,34,chroma_acts_smoothed
313,3,29.791999999999998,53.792,24.000000000000004,63,113,50,chroma_acts_smoothed
313,4,53.792,58.592,4.799999999999997,113,123,10,chroma_acts_smoothed
313,5,58.592,102.752,44.16,123,215,92,chroma_acts_smoothed
313,6,102.752,137.792,35.040000000000006,215,288,73,chroma_acts_smoothed
313,7,137.792,147.87199999999999,10.079999999999984,288,309,21,chroma_acts_smoothed
313,8,147.87199999999999,168.03199999999998,20.159999999999997,309,351,42,chroma_acts_smoothed
313,9,168.03199999999998,190.521,22.489000000000004,351,396,45,chroma_acts_smoothed
313,1,0.0,14.911999999999999,14.911999999999999,0,32,32,ki_chroma
313,2,14.911999999999999,28.352,13.440000000000001,32,60,28,ki_chroma
313,3,28.352,60.992,32.64,60,128,68,ki_chroma
313,4,60.992,99.392,38.4,128,208,80,ki_chroma
313,5,99.392,102.752,3.3599999999999994,208,215,7,ki_chroma
313,6,102.752,137.31199999999998,34.55999999999999,215,287,72,ki_chroma
313,7,137.31199999999998,147.392,10.080000000000013,287,308,21,ki_chroma
313,8,147.392,168.512,21.120000000000005,308,352,44,ki_chroma
313,9,168.512,190.521,22.008999999999986,352,396,44,ki_chroma
313,1,0.0,13.472,13.472,0,29,29,ki_chroma_acts
313,2,13.472,29.311999999999998,15.839999999999998,29,62,33,ki_chroma_acts
313,3,29.311999999999998,54.272,24.96,62,114,52,ki_chroma_acts
313,4,54.272,58.592,4.32,114,123,9,ki_chroma_acts
313,5,58.592,99.392,40.8,123,208,85,ki_chroma_acts
313,6,99.392,125.792,26.400000000000006,208,263,55,ki_chroma_acts
313,7,125.792,137.31199999999998,11.519999999999982,263,287,24,ki_chroma_acts
313,8,137.31199999999998,168.512,31.200000000000017,287,352,65,ki_chroma_acts
313,9,168.512,190.521,22.008999999999986,352,396,44,ki_chroma_acts
313,1,0.0,13.472,13.472,0,29,29,ki_chroma_acts_smoothed
313,2,13.472,29.791999999999998,16.32,29,63,34,ki_chroma_acts_smoothed
313,3,29.791999999999998,53.792,24.000000000000004,63,113,50,ki_chroma_acts_smoothed
313,4,53.792,58.592,4.799999999999997,113,123,10,ki_chroma_acts_smoothed
313,5,58.592,102.752,44.16,123,215,92,ki_chroma_acts_smoothed
313,6,102.752,137.792,35.040000000000006,215,288,73,ki_chroma_acts_smoothed
313,7,137.792,147.87199999999999,10.079999999999984,288,309,21,ki_chroma_acts_smoothed
313,8,147.87199999999999,168.03199999999998,20.159999999999997,309,351,42,ki_chroma_acts_smoothed
313,9,168.03199999999998,190.521,22.489000000000004,351,396,45,ki_chroma_acts_smoothed
314,1,0.0,8.970666666666666,8.970666666666666,0,20,20,chromagram
314,2,8.970666666666666,34.656,25.685333333333332,20,76,56,chromagram
314,3,34.656,44.288,9.631999999999998,76,97,21,chromagram
314,4,44.288,88.77866666666665,44.490666666666655,97,194,97,chromagram
314,5,88.77866666666665,115.83999999999999,27.061333333333337,194,253,59,chromagram
314,6,115.83999999999999,132.81066666666666,16.970666666666673,253,290,37,chromagram
314,7,132.81066666666666,136.93866666666665,4.127999999999986,290,299,9,chromagram
314,8,136.93866666666665,140.14933333333332,3.2106666666666683,299,306,7,chromagram
314,9,140.14933333333332,184.923,44.773666666666685,306,402,96,chromagram
314,1,0.0,8.970666666666666,8.970666666666666,0,20,20,chroma_acts
314,2,8.970666666666666,30.986666666666665,22.016,20,68,48,chroma_acts
314,3,30.986666666666665,33.279999999999994,2.2933333333333294,68,73,5,chroma_acts
314,4,33.279999999999994,34.656,1.3760000000000048,73,76,3,chroma_acts
314,5,34.656,44.288,9.631999999999998,76,97,21,chroma_acts
314,6,44.288,88.77866666666665,44.490666666666655,97,194,97,chroma_acts
314,7,88.77866666666665,115.83999999999999,27.061333333333337,194,253,59,chroma_acts
314,8,115.83999999999999,140.14933333333332,24.309333333333328,253,306,53,chroma_acts
314,9,140.14933333333332,184.923,44.773666666666685,306,402,96,chroma_acts
314,1,0.0,8.970666666666666,8.970666666666666,0,20,20,chroma_acts_smoothed
314,2,8.970666666666666,34.656,25.685333333333332,20,76,56,chroma_acts_smoothed
314,3,34.656,44.288,9.631999999999998,76,97,21,chroma_acts_smoothed
314,4,44.288,88.77866666666665,44.490666666666655,97,194,97,chroma_acts_smoothed
314,5,88.77866666666665,104.832,16.05333333333334,194,229,35,chroma_acts_smoothed
314,6,104.832,115.83999999999999,11.007999999999996,229,253,24,chroma_acts_smoothed
314,7,115.83999999999999,137.3973333333333,21.557333333333318,253,300,47,chroma_acts_smoothed
314,8,137.3973333333333,140.14933333333332,2.7520000000000095,300,306,6,chroma_acts_smoothed
314,9,140.14933333333332,184.923,44.773666666666685,306,402,96,chroma_acts_smoothed
314,1,0.0,8.970666666666666,8.970666666666666,0,20,20,ki_chroma
314,2,8.970666666666666,34.656,25.685333333333332,20,76,56,ki_chroma
314,3,34.656,44.288,9.631999999999998,76,97,21,ki_chroma
314,4,44.288,88.77866666666665,44.490666666666655,97,194,97,ki_chroma
314,5,88.77866666666665,115.83999999999999,27.061333333333337,194,253,59,ki_chroma
314,6,115.83999999999999,132.81066666666666,16.970666666666673,253,290,37,ki_chroma
314,7,132.81066666666666,136.93866666666665,4.127999999999986,290,299,9,ki_chroma
314,8,136.93866666666665,140.14933333333332,3.2106666666666683,299,306,7,ki_chroma
314,9,140.14933333333332,184.923,44.773666666666685,306,402,96,ki_chroma
314,1,0.0,8.970666666666666,8.970666666666666,0,20,20,ki_chroma_acts
314,2,8.970666666666666,30.986666666666665,22.016,20,68,48,ki_chroma_acts
314,3,30.986666666666665,33.279999999999994,2.2933333333333294,68,73,5,ki_chroma_acts
314,4,33.279999999999994,34.656,1.3760000000000048,73,76,3,ki_chroma_acts
314,5,34.656,44.288,9.631999999999998,76,97,21,ki_chroma_acts
314,6,44.288,88.77866666666665,44.490666666666655,97,194,97,ki_chroma_acts
314,7,88.77866666666665,115.83999999999999,27.061333333333337,194,253,59,ki_chroma_acts
314,8,115.83999999999999,140.14933333333332,24.309333333333328,253,306,53,ki_chroma_acts
314,9,140.14933333333332,184.923,44.773666666666685,306,402,96,ki_chroma_acts
314,1,0.0,8.970666666666666,8.970666666666666,0,20,20,ki_chroma_acts_smoothed
314,2,8.970666666666666,34.656,25.685333333333332,20,76,56,ki_chroma_acts_smoothed
314,3,34.656,44.288,9.631999999999998,76,97,21,ki_chroma_acts_smoothed
314,4,44.288,88.77866666666665,44.490666666666655,97,194,97,ki_chroma_acts_smoothed
314,5,88.77866666666665,104.832,16.05333333333334,194,229,35,ki_chroma_acts_smoothed
314,6,104.832,115.83999999999999,11.007999999999996,229,253,24,ki_chroma_acts_smoothed
314,7,115.83999999999999,137.3973333333333,21.557333333333318,253,300,47,ki_chroma_acts_smoothed
314,8,137.3973333333333,140.14933333333332,2.7520000000000095,300,306,6,ki_chroma_acts_smoothed
314,9,140.14933333333332,184.923,44.773666666666685,306,402,96,ki_chroma_acts_smoothed
317,1,0.0,31.498666666666665,31.498666666666665,0,68,68,chromagram
317,2,31.498666666666665,78.90133333333333,47.40266666666666,68,169,101,chromagram
317,3,78.90133333333333,91.57333333333334,12.672000000000011,169,196,27,chromagram
317,4,91.57333333333334,138.03733333333335,46.46400000000001,196,295,99,chromagram
317,5,138.03733333333335,152.11733333333333,14.079999999999984,295,325,30,chromagram
317,6,152.11733333333333,161.03466666666668,8.917333333333346,325,344,19,chromagram
317,7,161.03466666666668,168.07466666666667,7.039999999999992,344,359,15,chromagram
317,8,168.07466666666667,201.646,33.571333333333314,359,429,70,chromagram
317,1,0.0,33.376,33.376,0,72,72,chroma_acts
317,2,33.376,62.943999999999996,29.567999999999998,72,135,63,chroma_acts
317,3,62.943999999999996,78.90133333333333,15.957333333333331,135,169,34,chroma_acts
317,4,78.90133333333333,91.57333333333334,12.672000000000011,169,196,27,chroma_acts
317,5,91.57333333333334,138.5066666666667,46.93333333333335,196,296,100,chroma_acts
317,6,138.5066666666667,152.11733333333333,13.610666666666646,296,325,29,chroma_acts
317,7,152.11733333333333,161.03466666666668,8.917333333333346,325,344,19,chroma_acts
317,8,161.03466666666668,201.646,40.611333333333306,344,429,85,chroma_acts
317,1,0.0,34.31466666666667,34.31466666666667,0,74,74,chroma_acts_smoothed
317,2,34.31466666666667,62.943999999999996,28.629333333333328,74,135,61,chroma_acts_smoothed
317,3,62.943999999999996,78.432,15.488000000000007,135,168,33,chroma_acts_smoothed
317,4,78.432,92.04266666666666,13.61066666666666,168,197,29,chroma_acts_smoothed
317,5,92.04266666666666,138.5066666666667,46.46400000000003,197,296,99,chroma_acts_smoothed
317,6,138.5066666666667,151.64800000000002,13.141333333333336,296,324,28,chroma_acts_smoothed
317,7,151.64800000000002,161.03466666666668,9.386666666666656,324,344,20,chroma_acts_smoothed
317,8,161.03466666666668,201.646,40.611333333333306,344,429,85,chroma_acts_smoothed
317,1,0.0,31.498666666666665,31.498666666666665,0,68,68,ki_chroma
317,2,31.498666666666665,78.90133333333333,47.40266666666666,68,169,101,ki_chroma
317,3,78.90133333333333,91.57333333333334,12.672000000000011,169,196,27,ki_chroma
317,4,91.57333333333334,138.03733333333335,46.46400000000001,196,295,99,ki_chroma
317,5,138.03733333333335,152.11733333333333,14.079999999999984,295,325,30,ki_chroma
317,6,152.11733333333333,161.03466666666668,8.917333333333346,325,344,19,ki_chroma
317,7,161.03466666666668,168.07466666666667,7.039999999999992,344,359,15,ki_chroma
317,8,168.07466666666667,201.646,33.571333333333314,359,429,70,ki_chroma
317,1,0.0,33.376,33.376,0,72,72,ki_chroma_acts
317,2,33.376,62.943999999999996,29.567999999999998,72,135,63,ki_chroma_acts
317,3,62.943999999999996,78.90133333333333,15.957333333333331,135,169,34,ki_chroma_acts
317,4,78.90133333333333,91.57333333333334,12.672000000000011,169,196,27,ki_chroma_acts
317,5,91.57333333333334,138.5066666666667,46.93333333333335,196,296,100,ki_chroma_acts
317,6,138.5066666666667,152.11733333333333,13.610666666666646,296,325,29,ki_chroma_acts
317,7,152.11733333333333,161.03466666666668,8.917333333333346,325,344,19,ki_chroma_acts
317,8,161.03466666666668,201.646,40.611333333333306,344,429,85,ki_chroma_acts
317,1,0.0,34.31466666666667,34.31466666666667,0,74,74,ki_chroma_acts_smoothed
317,2,34.31466666666667,62.943999999999996,28.629333333333328,74,135,61,ki_chroma_acts_smoothed
317,3,62.943999999999996,78.432,15.488000000000007,135,168,33,ki_chroma_acts_smoothed
317,4,78.432,92.04266666666666,13.61066666666666,168,197,29,ki_chroma_acts_smoothed
317,5,92.04266666666666,138.5066666666667,46.46400000000003,197,296,99,ki_chroma_acts_smoothed
317,6,138.5066666666667,151.64800000000002,13.141333333333336,296,324,28,ki_chroma_acts_smoothed
317,7,151.64800000000002,161.03466666666668,9.386666666666656,324,344,20,ki_chroma_acts_smoothed
317,8,161.03466666666668,201.646,40.611333333333306,344,429,85,ki_chroma_acts_smoothed
321,1,0.0,7.957333333333333,7.957333333333333,0,17,17,chromagram
321,2,7.957333333333333,15.157333333333332,7.199999999999999,17,32,15,chromagram
321,3,15.157333333333332,45.87733333333333,30.72,32,96,64,chromagram
321,4,45.87733333333333,60.75733333333333,14.879999999999995,96,127,31,chromagram
321,5,60.75733333333333,78.99733333333333,18.240000000000002,127,165,38,chromagram
321,6,78.99733333333333,90.99733333333333,12.0,165,190,25,chromagram
321,7,90.99733333333333,137.0773333333333,46.079999999999984,190,286,96,chromagram
321,8,137.0773333333333,152.43733333333333,15.360000000000014,286,318,32,chromagram
321,9,152.43733333333333,198.141,45.70366666666666,318,412,94,chromagram
321,1,0.0,15.157333333333332,15.157333333333332,0,32,32,chroma_acts
321,2,15.157333333333332,45.87733333333333,30.72,32,96,64,chroma_acts
321,3,45.87733333333333,69.87733333333333,23.999999999999993,96,146,50,chroma_acts
321,4,69.87733333333333,73.71733333333333,3.8400000000000034,146,154,8,chroma_acts
321,5,73.71733333333333,90.51733333333333,16.799999999999997,154,189,35,chroma_acts
321,6,90.51733333333333,137.0773333333333,46.55999999999999,189,286,97,chroma_acts
321,7,137.0773333333333,150.5173333333333,13.439999999999998,286,314,28,chroma_acts
321,8,150.5173333333333,198.141,47.62366666666668,314,412,98,chroma_acts
321,1,0.0,15.157333333333332,15.157333333333332,0,32,32,chroma_acts_smoothed
321,2,15.157333333333332,46.35733333333333,31.199999999999996,32,97,65,chroma_acts_smoothed
321,3,46.35733333333333,69.87733333333333,23.519999999999996,97,146,49,chroma_acts_smoothed
321,4,69.87733333333333,73.71733333333333,3.8400000000000034,146,154,8,chroma_acts_smoothed
321,5,73.71733333333333,91.47733333333333,17.760000000000005,154,191,37,chroma_acts_smoothed
321,6,91.47733333333333,137.55733333333333,46.08,191,287,96,chroma_acts_smoothed
321,7,137.55733333333333,150.5173333333333,12.95999999999998,287,314,27,chroma_acts_smoothed
321,8,150.5173333333333,198.141,47.62366666666668,314,412,98,chroma_acts_smoothed
321,1,0.0,7.957333333333333,7.957333333333333,0,17,17,ki_chroma
321,2,7.957333333333333,15.157333333333332,7.199999999999999,17,32,15,ki_chroma
321,3,15.157333333333332,45.87733333333333,30.72,32,96,64,ki_chroma
321,4,45.87733333333333,60.75733333333333,14.879999999999995,96,127,31,ki_chroma
321,5,60.75733333333333,78.99733333333333,18.240000000000002,127,165,38,ki_chroma
321,6,78.99733333333333,90.99733333333333,12.0,165,190,25,ki_chroma
321,7,90.99733333333333,137.0773333333333,46.079999999999984,190,286,96,ki_chroma
321,8,137.0773333333333,152.43733333333333,15.360000000000014,286,318,32,ki_chroma
321,9,152.43733333333333,198.141,45.70366666666666,318,412,94,ki_chroma
321,1,0.0,15.157333333333332,15.157333333333332,0,32,32,ki_chroma_acts
321,2,15.157333333333332,45.87733333333333,30.72,32,96,64,ki_chroma_acts
321,3,45.87733333333333,69.87733333333333,23.999999999999993,96,146,50,ki_chroma_acts
321,4,69.87733333333333,73.71733333333333,3.8400000000000034,146,154,8,ki_chroma_acts
321,5,73.71733333333333,90.51733333333333,16.799999999999997,154,189,35,ki_chroma_acts
321,6,90.51733333333333,137.0773333333333,46.55999999999999,189,286,97,ki_chroma_acts
321,7,137.0773333333333,150.5173333333333,13.439999999999998,286,314,28,ki_chroma_acts
321,8,150.5173333333333,198.141,47.62366666666668,314,412,98,ki_chroma_acts
321,1,0.0,15.157333333333332,15.157333333333332,0,32,32,ki_chroma_acts_smoothed
321,2,15.157333333333332,46.35733333333333,31.199999999999996,32,97,65,ki_chroma_acts_smoothed
321,3,46.35733333333333,69.87733333333333,23.519999999999996,97,146,49,ki_chroma_acts_smoothed
321,4,69.87733333333333,73.71733333333333,3.8400000000000034,146,154,8,ki_chroma_acts_smoothed
321,5,73.71733333333333,91.47733333333333,17.760000000000005,154,191,37,ki_chroma_acts_smoothed
321,6,91.47733333333333,137.55733333333333,46.08,191,287,96,ki_chroma_acts_smoothed
321,7,137.55733333333333,150.5173333333333,12.95999999999998,287,314,27,ki_chroma_acts_smoothed
321,8,150.5173333333333,198.141,47.62366666666668,314,412,98,ki_chroma_acts_smoothed
324,1,0.0,31.33866666666667,31.33866666666667,0,64,64,chromagram
324,2,31.33866666666667,79.424,48.08533333333334,64,162,98,chromagram
324,3,79.424,94.63466666666667,15.210666666666668,162,193,31,chromagram
324,4,94.63466666666667,134.86933333333334,40.23466666666667,193,275,82,chromagram
324,5,134.86933333333334,176.576,41.70666666666665,275,360,85,chromagram
324,6,176.576,182.95466666666667,6.378666666666675,360,373,13,chromagram
324,7,182.95466666666667,184.42666666666668,1.4720000000000084,373,376,3,chromagram
324,8,184.42666666666668,235.714,51.28733333333332,376,479,103,chromagram
324,1,0.0,31.33866666666667,31.33866666666667,0,64,64,chroma_acts
324,2,31.33866666666667,79.424,48.08533333333334,64,162,98,chroma_acts
324,3,79.424,94.63466666666667,15.210666666666668,162,193,31,chroma_acts
324,4,94.63466666666667,134.86933333333334,40.23466666666667,193,275,82,chroma_acts
324,5,134.86933333333334,176.576,41.70666666666665,275,360,85,chroma_acts
324,6,176.576,182.95466666666667,6.378666666666675,360,373,13,chroma_acts
324,7,182.95466666666667,184.91733333333335,1.9626666666666779,373,377,4,chroma_acts
324,8,184.91733333333335,235.714,50.79666666666665,377,479,102,chroma_acts
324,1,0.0,31.33866666666667,31.33866666666667,0,64,64,chroma_acts_smoothed
324,2,31.33866666666667,79.424,48.08533333333334,64,162,98,chroma_acts_smoothed
324,3,79.424,94.63466666666667,15.210666666666668,162,193,31,chroma_acts_smoothed
324,4,94.63466666666667,134.37866666666667,39.744,193,274,81,chroma_acts_smoothed
324,5,134.37866666666667,176.576,42.19733333333332,274,360,86,chroma_acts_smoothed
324,6,176.576,182.95466666666667,6.378666666666675,360,373,13,chroma_acts_smoothed
324,7,182.95466666666667,184.91733333333335,1.9626666666666779,373,377,4,chroma_acts_smoothed
324,8,184.91733333333335,235.714,50.79666666666665,377,479,102,chroma_acts_smoothed
324,1,0.0,31.33866666666667,31.33866666666667,0,64,64,ki_chroma
324,2,31.33866666666667,79.424,48.08533333333334,64,162,98,ki_chroma
324,3,79.424,94.63466666666667,15.210666666666668,162,193,31,ki_chroma
324,4,94.63466666666667,134.86933333333334,40.23466666666667,193,275,82,ki_chroma
324,5,134.86933333333334,176.576,41.70666666666665,275,360,85,ki_chroma
324,6,176.576,182.95466666666667,6.378666666666675,360,373,13,ki_chroma
324,7,182.95466666666667,184.42666666666668,1.4720000000000084,373,376,3,ki_chroma
324,8,184.42666666666668,235.714,51.28733333333332,376,479,103,ki_chroma
324,1,0.0,31.33866666666667,31.33866666666667,0,64,64,ki_chroma_acts
324,2,31.33866666666667,79.424,48.08533333333334,64,162,98,ki_chroma_acts
324,3,79.424,94.63466666666667,15.210666666666668,162,193,31,ki_chroma_acts
324,4,94.63466666666667,134.86933333333334,40.23466666666667,193,275,82,ki_chroma_acts
324,5,134.86933333333334,176.576,41.70666666666665,275,360,85,ki_chroma_acts
324,6,176.576,182.95466666666667,6.378666666666675,360,373,13,ki_chroma_acts
324,7,182.95466666666667,184.91733333333335,1.9626666666666779,373,377,4,ki_chroma_acts
324,8,184.91733333333335,235.714,50.79666666666665,377,479,102,ki_chroma_acts
324,1,0.0,31.33866666666667,31.33866666666667,0,64,64,ki_chroma_acts_smoothed
324,2,31.33866666666667,79.424,48.08533333333334,64,162,98,ki_chroma_acts_smoothed
324,3,79.424,94.63466666666667,15.210666666666668,162,193,31,ki_chroma_acts_smoothed
324,4,94.63466666666667,134.37866666666667,39.744,193,274,81,ki_chroma_acts_smoothed
324,5,134.37866666666667,176.576,42.19733333333332,274,360,86,ki_chroma_acts_smoothed
324,6,176.576,182.95466666666667,6.378666666666675,360,373,13,ki_chroma_acts_smoothed
324,7,182.95466666666667,184.91733333333335,1.9626666666666779,373,377,4,ki_chroma_acts_smoothed
324,8,184.91733333333335,235.714,50.79666666666665,377,479,102,ki_chroma_acts_smoothed
326,1,0.0,32.44799999999999,32.44799999999999,0,68,68,chromagram
326,2,32.44799999999999,78.52799999999999,46.08,68,164,96,chromagram
326,3,78.52799999999999,90.04799999999999,11.519999999999996,164,188,24,chromagram
326,4,90.04799999999999,124.60799999999999,34.56,188,260,72,chromagram
326,5,124.60799999999999,151.488,26.88000000000001,260,316,56,chromagram
326,6,151.488,170.68800000000002,19.200000000000017,316,356,40,chromagram
326,7,170.68800000000002,203.54,32.851999999999975,356,423,67,chromagram
326,1,0.0,32.44799999999999,32.44799999999999,0,68,68,chroma_acts
326,2,32.44799999999999,73.24799999999999,40.8,68,153,85,chroma_acts
326,3,73.24799999999999,93.88799999999999,20.64,153,196,43,chroma_acts
326,4,93.88799999999999,123.648,29.760000000000005,196,258,62,chroma_acts
326,5,123.648,148.12800000000001,24.480000000000018,258,309,51,chroma_acts
326,6,148.12800000000001,151.488,3.359999999999985,309,316,7,chroma_acts
326,7,151.488,170.68800000000002,19.200000000000017,316,356,40,chroma_acts
326,8,170.68800000000002,203.54,32.851999999999975,356,423,67,chroma_acts
326,1,0.0,5.568,5.568,0,12,12,chroma_acts_smoothed
326,2,5.568,32.44799999999999,26.879999999999995,12,68,56,chroma_acts_smoothed
326,3,32.44799999999999,73.24799999999999,40.8,68,153,85,chroma_acts_smoothed
326,4,73.24799999999999,93.88799999999999,20.64,153,196,43,chroma_acts_smoothed
326,5,93.88799999999999,123.648,29.760000000000005,196,258,62,chroma_acts_smoothed
326,6,123.648,151.96800000000002,28.32000000000002,258,317,59,chroma_acts_smoothed
326,7,151.96800000000002,170.68800000000002,18.72,317,356,39,chroma_acts_smoothed
326,8,170.68800000000002,203.54,32.851999999999975,356,423,67,chroma_acts_smoothed
326,1,0.0,32.44799999999999,32.44799999999999,0,68,68,ki_chroma
326,2,32.44799999999999,78.52799999999999,46.08,68,164,96,ki_chroma
326,3,78.52799999999999,90.04799999999999,11.519999999999996,164,188,24,ki_chroma
326,4,90.04799999999999,124.60799999999999,34.56,188,260,72,ki_chroma
326,5,124.60799999999999,151.488,26.88000000000001,260,316,56,ki_chroma
326,6,151.488,170.68800000000002,19.200000000000017,316,356,40,ki_chroma
326,7,170.68800000000002,203.54,32.851999999999975,356,423,67,ki_chroma
326,1,0.0,32.44799999999999,32.44799999999999,0,68,68,ki_chroma_acts
326,2,32.44799999999999,73.24799999999999,40.8,68,153,85,ki_chroma_acts
326,3,73.24799999999999,93.88799999999999,20.64,153,196,43,ki_chroma_acts
326,4,93.88799999999999,123.648,29.760000000000005,196,258,62,ki_chroma_acts
326,5,123.648,148.12800000000001,24.480000000000018,258,309,51,ki_chroma_acts
326,6,148.12800000000001,151.488,3.359999999999985,309,316,7,ki_chroma_acts
326,7,151.488,170.68800000000002,19.200000000000017,316,356,40,ki_chroma_acts
326,8,170.68800000000002,203.54,32.851999999999975,356,423,67,ki_chroma_acts
326,1,0.0,5.568,5.568,0,12,12,ki_chroma_acts_smoothed
326,2,5.568,32.44799999999999,26.879999999999995,12,68,56,ki_chroma_acts_smoothed
326,3,32.44799999999999,73.24799999999999,40.8,68,153,85,ki_chroma_acts_smoothed
326,4,73.24799999999999,93.88799999999999,20.64,153,196,43,ki_chroma_acts_smoothed
326,5,93.88799999999999,123.648,29.760000000000005,196,258,62,ki_chroma_acts_smoothed
326,6,123.648,151.96800000000002,28.32000000000002,258,317,59,ki_chroma_acts_smoothed
326,7,151.96800000000002,170.68800000000002,18.72,317,356,39,ki_chroma_acts_smoothed
326,8,170.68800000000002,203.54,32.851999999999975,356,423,67,ki_chroma_acts_smoothed
327,1,0.0,29.301333333333332,29.301333333333332,0,62,62,chromagram
327,2,29.301333333333332,69.14133333333334,39.84,62,145,83,chromagram
327,3,69.14133333333334,75.38133333333333,6.239999999999995,145,158,13,chromagram
327,4,75.38133333333333,92.18133333333333,16.799999999999997,158,193,35,chromagram
327,5,92.18133333333333,108.50133333333332,16.319999999999993,193,227,34,chromagram
327,6,108.50133333333332,121.46133333333333,12.960000000000008,227,254,27,chromagram
327,7,121.46133333333333,156.218,34.75666666666666,254,325,71,chromagram
327,1,0.0,26.901333333333334,26.901333333333334,0,57,57,chroma_acts
327,2,26.901333333333334,29.301333333333332,2.3999999999999986,57,62,5,chroma_acts
327,3,29.301333333333332,69.14133333333334,39.84,62,145,83,chroma_acts
327,4,69.14133333333334,75.38133333333333,6.239999999999995,145,158,13,chroma_acts
327,5,75.38133333333333,92.18133333333333,16.799999999999997,158,193,35,chroma_acts
327,6,92.18133333333333,121.46133333333333,29.28,193,254,61,chroma_acts
327,7,121.46133333333333,156.218,34.75666666666666,254,325,71,chroma_acts
327,1,0.0,29.301333333333332,29.301333333333332,0,62,62,chroma_acts_smoothed
327,2,29.301333333333332,69.62133333333333,40.31999999999999,62,146,84,chroma_acts_smoothed
327,3,69.62133333333333,75.38133333333333,5.760000000000005,146,158,12,chroma_acts_smoothed
327,4,75.38133333333333,92.18133333333333,16.799999999999997,158,193,35,chroma_acts_smoothed
327,5,92.18133333333333,107.54133333333333,15.36,193,225,32,chroma_acts_smoothed
327,6,107.54133333333333,121.46133333333333,13.920000000000002,225,254,29,chroma_acts_smoothed
327,7,121.46133333333333,152.66133333333332,31.19999999999999,254,319,65,chroma_acts_smoothed
327,8,152.66133333333332,156.218,3.556666666666672,319,325,6,chroma_acts_smoothed
327,1,0.0,29.301333333333332,29.301333333333332,0,62,62,ki_chroma
327,2,29.301333333333332,69.14133333333334,39.84,62,145,83,ki_chroma
327,3,69.14133333333334,75.38133333333333,6.239999999999995,145,158,13,ki_chroma
327,4,75.38133333333333,92.18133333333333,16.799999999999997,158,193,35,ki_chroma
327,5,92.18133333333333,108.50133333333332,16.319999999999993,193,227,34,ki_chroma
327,6,108.50133333333332,121.46133333333333,12.960000000000008,227,254,27,ki_chroma
327,7,121.46133333333333,156.218,34.75666666666666,254,325,71,ki_chroma
327,1,0.0,26.901333333333334,26.901333333333334,0,57,57,ki_chroma_acts
327,2,26.901333333333334,29.301333333333332,2.3999999999999986,57,62,5,ki_chroma_acts
327,3,29.301333333333332,69.14133333333334,39.84,62,145,83,ki_chroma_acts
327,4,69.14133333333334,75.38133333333333,6.239999999999995,145,158,13,ki_chroma_acts
327,5,75.38133333333333,92.18133333333333,16.799999999999997,158,193,35,ki_chroma_acts
327,6,92.18133333333333,121.46133333333333,29.28,193,254,61,ki_chroma_acts
327,7,121.46133333333333,156.218,34.75666666666666,254,325,71,ki_chroma_acts
327,1,0.0,29.301333333333332,29.301333333333332,0,62,62,ki_chroma_acts_smoothed
327,2,29.301333333333332,69.62133333333333,40.31999999999999,62,146,84,ki_chroma_acts_smoothed
327,3,69.62133333333333,75.38133333333333,5.760000000000005,146,158,12,ki_chroma_acts_smoothed
327,4,75.38133333333333,92.18133333333333,16.799999999999997,158,193,35,ki_chroma_acts_smoothed
327,5,92.18133333333333,107.54133333333333,15.36,193,225,32,ki_chroma_acts_smoothed
327,6,107.54133333333333,121.46133333333333,13.920000000000002,225,254,29,ki_chroma_acts_smoothed
327,7,121.46133333333333,152.66133333333332,31.19999999999999,254,319,65,ki_chroma_acts_smoothed
327,8,152.66133333333332,156.218,3.556666666666672,319,325,6,ki_chroma_acts_smoothed
328,1,0.0,28.650666666666666,28.650666666666666,0,60,60,chromagram
328,2,28.650666666666666,31.050666666666665,2.3999999999999986,60,65,5,chromagram
328,3,31.050666666666665,44.010666666666665,12.96,65,92,27,chromagram
328,4,44.010666666666665,45.93066666666667,1.9200000000000017,92,96,4,chromagram
328,5,45.93066666666667,59.370666666666665,13.439999999999998,96,124,28,chromagram
328,6,59.370666666666665,92.01066666666667,32.64,124,192,68,chromagram
328,7,92.01066666666667,96.33066666666667,4.320000000000007,192,201,9,chromagram
328,8,96.33066666666667,100.17066666666668,3.8400000000000034,201,209,8,chromagram
328,9,100.17066666666668,131.561,31.39033333333333,209,273,64,chromagram
328,1,0.0,28.650666666666666,28.650666666666666,0,60,60,chroma_acts
328,2,28.650666666666666,31.050666666666665,2.3999999999999986,60,65,5,chroma_acts
328,3,31.050666666666665,44.010666666666665,12.96,65,92,27,chroma_acts
328,4,44.010666666666665,45.93066666666667,1.9200000000000017,92,96,4,chroma_acts
328,5,45.93066666666667,59.370666666666665,13.439999999999998,96,124,28,chroma_acts
328,6,59.370666666666665,92.49066666666667,33.120000000000005,124,193,69,chroma_acts
328,7,92.49066666666667,96.33066666666667,3.8400000000000034,193,201,8,chroma_acts
328,8,96.33066666666667,100.17066666666668,3.8400000000000034,201,209,8,chroma_acts
328,9,100.17066666666668,131.561,31.39033333333333,209,273,64,chroma_acts
328,1,0.0,28.650666666666666,28.650666666666666,0,60,60,chroma_acts_smoothed
328,2,28.650666666666666,31.050666666666665,2.3999999999999986,60,65,5,chroma_acts_smoothed
328,3,31.050666666666665,44.010666666666665,12.96,65,92,27,chroma_acts_smoothed
328,4,44.010666666666665,45.93066666666667,1.9200000000000017,92,96,4,chroma_acts_smoothed
328,5,45.93066666666667,59.370666666666665,13.439999999999998,96,124,28,chroma_acts_smoothed
328,6,59.370666666666665,92.49066666666667,33.120000000000005,124,193,69,chroma_acts_smoothed
328,7,92.49066666666667,95.85066666666667,3.3599999999999994,193,200,7,chroma_acts_smoothed
328,8,95.85066666666667,99.69066666666667,3.8400000000000034,200,208,8,chroma_acts_smoothed
328,9,99.69066666666667,131.561,31.870333333333335,208,273,65,chroma_acts_smoothed
328,1,0.0,28.650666666666666,28.650666666666666,0,60,60,ki_chroma
328,2,28.650666666666666,31.050666666666665,2.3999999999999986,60,65,5,ki_chroma
328,3,31.050666666666665,44.010666666666665,12.96,65,92,27,ki_chroma
328,4,44.010666666666665,45.93066666666667,1.9200000000000017,92,96,4,ki_chroma
328,5,45.93066666666667,59.370666666666665,13.439999999999998,96,124,28,ki_chroma
328,6,59.370666666666665,92.01066666666667,32.64,124,192,68,ki_chroma
328,7,92.01066666666667,96.33066666666667,4.320000000000007,192,201,9,ki_chroma
328,8,96.33066666666667,100.17066666666668,3.8400000000000034,201,209,8,ki_chroma
328,9,100.17066666666668,131.561,31.39033333333333,209,273,64,ki_chroma
328,1,0.0,28.650666666666666,28.650666666666666,0,60,60,ki_chroma_acts
328,2,28.650666666666666,31.050666666666665,2.3999999999999986,60,65,5,ki_chroma_acts
328,3,31.050666666666665,44.010666666666665,12.96,65,92,27,ki_chroma_acts
328,4,44.010666666666665,45.93066666666667,1.9200000000000017,92,96,4,ki_chroma_acts
328,5,45.93066666666667,59.370666666666665,13.439999999999998,96,124,28,ki_chroma_acts
328,6,59.370666666666665,92.49066666666667,33.120000000000005,124,193,69,ki_chroma_acts
328,7,92.49066666666667,96.33066666666667,3.8400000000000034,193,201,8,ki_chroma_acts
328,8,96.33066666666667,100.17066666666668,3.8400000000000034,201,209,8,ki_chroma_acts
328,9,100.17066666666668,131.561,31.39033333333333,209,273,64,ki_chroma_acts
328,1,0.0,28.650666666666666,28.650666666666666,0,60,60,ki_chroma_acts_smoothed
328,2,28.650666666666666,31.050666666666665,2.3999999999999986,60,65,5,ki_chroma_acts_smoothed
328,3,31.050666666666665,44.010666666666665,12.96,65,92,27,ki_chroma_acts_smoothed
328,4,44.010666666666665,45.93066666666667,1.9200000000000017,92,96,4,ki_chroma_acts_smoothed
328,5,45.93066666666667,59.370666666666665,13.439999999999998,96,124,28,ki_chroma_acts_smoothed
328,6,59.370666666666665,92.49066666666667,33.120000000000005,124,193,69,ki_chroma_acts_smoothed
328,7,92.49066666666667,95.85066666666667,3.3599999999999994,193,200,7,ki_chroma_acts_smoothed
328,8,95.85066666666667,99.69066666666667,3.8400000000000034,200,208,8,ki_chroma_acts_smoothed
328,9,99.69066666666667,131.561,31.870333333333335,208,273,65,ki_chroma_acts_smoothed
329,1,0.0,14.826666666666666,14.826666666666666,0,32,32,chromagram
329,2,14.826666666666666,19.050666666666668,4.224000000000002,32,41,9,chromagram
329,3,19.050666666666668,29.845333333333333,10.794666666666664,41,64,23,chromagram
329,4,29.845333333333333,34.06933333333333,4.224,64,73,9,chromagram
329,5,34.06933333333333,43.92533333333333,9.855999999999995,73,94,21,chromagram
329,6,43.92533333333333,105.408,61.482666666666674,94,225,131,chromagram
329,7,105.408,130.28266666666667,24.87466666666667,225,278,53,chromagram
329,8,130.28266666666667,149.99466666666666,19.71199999999999,278,320,42,chromagram
329,9,149.99466666666666,244.858,94.86333333333334,320,521,201,chromagram
329,1,0.0,14.826666666666666,14.826666666666666,0,32,32,chroma_acts
329,2,14.826666666666666,19.050666666666668,4.224000000000002,32,41,9,chroma_acts
329,3,19.050666666666668,29.845333333333333,10.794666666666664,41,64,23,chroma_acts
329,4,29.845333333333333,34.06933333333333,4.224,64,73,9,chroma_acts
329,5,34.06933333333333,43.92533333333333,9.855999999999995,73,94,21,chroma_acts
329,6,43.92533333333333,107.75466666666667,63.82933333333334,94,230,136,chroma_acts
329,7,107.75466666666667,149.99466666666666,42.239999999999995,230,320,90,chroma_acts
329,8,149.99466666666666,225.55733333333333,75.56266666666667,320,481,161,chroma_acts
329,9,225.55733333333333,244.858,19.30066666666667,481,521,40,chroma_acts
329,1,0.0,14.357333333333333,14.357333333333333,0,31,31,chroma_acts_smoothed
329,2,14.357333333333333,19.52,5.1626666666666665,31,42,11,chroma_acts_smoothed
329,3,19.52,29.376,9.856000000000002,42,63,21,chroma_acts_smoothed
329,4,29.376,34.06933333333333,4.693333333333332,63,73,10,chroma_acts_smoothed
329,5,34.06933333333333,43.92533333333333,9.855999999999995,73,94,21,chroma_acts_smoothed
329,6,43.92533333333333,107.75466666666667,63.82933333333334,94,230,136,chroma_acts_smoothed
329,7,107.75466666666667,149.99466666666666,42.239999999999995,230,320,90,chroma_acts_smoothed
329,8,149.99466666666666,224.61866666666666,74.624,320,479,159,chroma_acts_smoothed
329,9,224.61866666666666,244.858,20.23933333333335,479,521,42,chroma_acts_smoothed
329,1,0.0,14.826666666666666,14.826666666666666,0,32,32,ki_chroma
329,2,14.826666666666666,19.050666666666668,4.224000000000002,32,41,9,ki_chroma
329,3,19.050666666666668,29.845333333333333,10.794666666666664,41,64,23,ki_chroma
329,4,29.845333333333333,34.06933333333333,4.224,64,73,9,ki_chroma
329,5,34.06933333333333,43.92533333333333,9.855999999999995,73,94,21,ki_chroma
329,6,43.92533333333333,105.408,61.482666666666674,94,225,131,ki_chroma
329,7,105.408,130.28266666666667,24.87466666666667,225,278,53,ki_chroma
329,8,130.28266666666667,149.99466666666666,19.71199999999999,278,320,42,ki_chroma
329,9,149.99466666666666,244.858,94.86333333333334,320,521,201,ki_chroma
329,1,0.0,14.826666666666666,14.826666666666666,0,32,32,ki_chroma_acts
329,2,14.826666666666666,19.050666666666668,4.224000000000002,32,41,9,ki_chroma_acts
329,3,19.050666666666668,29.845333333333333,10.794666666666664,41,64,23,ki_chroma_acts
329,4,29.845333333333333,34.06933333333333,4.224,64,73,9,ki_chroma_acts
329,5,34.06933333333333,43.92533333333333,9.855999999999995,73,94,21,ki_chroma_acts
329,6,43.92533333333333,107.75466666666667,63.82933333333334,94,230,136,ki_chroma_acts
329,7,107.75466666666667,149.99466666666666,42.239999999999995,230,320,90,ki_chroma_acts
329,8,149.99466666666666,225.55733333333333,75.56266666666667,320,481,161,ki_chroma_acts
329,9,225.55733333333333,244.858,19.30066666666667,481,521,40,ki_chroma_acts
329,1,0.0,14.357333333333333,14.357333333333333,0,31,31,ki_chroma_acts_smoothed
329,2,14.357333333333333,19.52,5.1626666666666665,31,42,11,ki_chroma_acts_smoothed
329,3,19.52,29.376,9.856000000000002,42,63,21,ki_chroma_acts_smoothed
329,4,29.376,34.06933333333333,4.693333333333332,63,73,10,ki_chroma_acts_smoothed
329,5,34.06933333333333,43.92533333333333,9.855999999999995,73,94,21,ki_chroma_acts_smoothed
329,6,43.92533333333333,107.75466666666667,63.82933333333334,94,230,136,ki_chroma_acts_smoothed
329,7,107.75466666666667,149.99466666666666,42.239999999999995,230,320,90,ki_chroma_acts_smoothed
329,8,149.99466666666666,224.61866666666666,74.624,320,479,159,ki_chroma_acts_smoothed
329,9,224.61866666666666,244.858,20.23933333333335,479,521,42,ki_chroma_acts_smoothed
331,1,0.0,3.861333333333333,3.861333333333333,0,9,9,chromagram
331,2,3.861333333333333,7.1466666666666665,3.2853333333333334,9,16,7,chromagram
331,3,7.1466666666666665,37.653333333333336,30.506666666666668,16,81,65,chromagram
331,4,37.653333333333336,67.69066666666667,30.037333333333336,81,145,64,chromagram
331,5,67.69066666666667,81.77066666666667,14.079999999999998,145,175,30,chromagram
331,6,81.77066666666667,97.728,15.957333333333324,175,209,34,chromagram
331,7,97.728,126.82666666666667,29.098666666666674,209,271,62,chromagram
331,8,126.82666666666667,159.576,32.749333333333325,271,339,68,chromagram
331,1,0.0,3.861333333333333,3.861333333333333,0,9,9,chroma_acts
331,2,3.861333333333333,41.408,37.54666666666667,9,89,80,chroma_acts
331,3,41.408,45.16266666666667,3.7546666666666653,89,97,8,chroma_acts
331,4,45.16266666666667,48.91733333333333,3.7546666666666653,97,105,8,chroma_acts
331,5,48.91733333333333,81.77066666666667,32.85333333333334,105,175,70,chroma_acts
331,6,81.77066666666667,97.728,15.957333333333324,175,209,34,chroma_acts
331,7,97.728,101.48266666666667,3.7546666666666795,209,217,8,chroma_acts
331,8,101.48266666666667,127.76533333333333,26.282666666666657,217,273,56,chroma_acts
331,9,127.76533333333333,159.576,31.810666666666663,273,339,66,chroma_acts
331,1,0.0,3.861333333333333,3.861333333333333,0,9,9,chroma_acts_smoothed
331,2,3.861333333333333,41.408,37.54666666666667,9,89,80,chroma_acts_smoothed
331,3,41.408,45.16266666666667,3.7546666666666653,89,97,8,chroma_acts_smoothed
331,4,45.16266666666667,48.91733333333333,3.7546666666666653,97,105,8,chroma_acts_smoothed
331,5,48.91733333333333,82.70933333333333,33.792,105,177,72,chroma_acts_smoothed
331,6,82.70933333333333,97.728,15.018666666666661,177,209,32,chroma_acts_smoothed
331,7,97.728,108.992,11.26400000000001,209,233,24,chroma_acts_smoothed
331,8,108.992,127.76533333333333,18.773333333333326,233,273,40,chroma_acts_smoothed
331,9,127.76533333333333,159.576,31.810666666666663,273,339,66,chroma_acts_smoothed
331,1,0.0,3.861333333333333,3.861333333333333,0,9,9,ki_chroma
331,2,3.861333333333333,7.1466666666666665,3.2853333333333334,9,16,7,ki_chroma
331,3,7.1466666666666665,37.653333333333336,30.506666666666668,16,81,65,ki_chroma
331,4,37.653333333333336,67.69066666666667,30.037333333333336,81,145,64,ki_chroma
331,5,67.69066666666667,81.77066666666667,14.079999999999998,145,175,30,ki_chroma
331,6,81.77066666666667,97.728,15.957333333333324,175,209,34,ki_chroma
331,7,97.728,126.82666666666667,29.098666666666674,209,271,62,ki_chroma
331,8,126.82666666666667,159.576,32.749333333333325,271,339,68,ki_chroma
331,1,0.0,3.861333333333333,3.861333333333333,0,9,9,ki_chroma_acts
331,2,3.861333333333333,41.408,37.54666666666667,9,89,80,ki_chroma_acts
331,3,41.408,45.16266666666667,3.7546666666666653,89,97,8,ki_chroma_acts
331,4,45.16266666666667,48.91733333333333,3.7546666666666653,97,105,8,ki_chroma_acts
331,5,48.91733333333333,81.77066666666667,32.85333333333334,105,175,70,ki_chroma_acts
331,6,81.77066666666667,97.728,15.957333333333324,175,209,34,ki_chroma_acts
331,7,97.728,101.48266666666667,3.7546666666666795,209,217,8,ki_chroma_acts
331,8,101.48266666666667,127.76533333333333,26.282666666666657,217,273,56,ki_chroma_acts
331,9,127.76533333333333,159.576,31.810666666666663,273,339,66,ki_chroma_acts
331,1,0.0,3.861333333333333,3.861333333333333,0,9,9,ki_chroma_acts_smoothed
331,2,3.861333333333333,41.408,37.54666666666667,9,89,80,ki_chroma_acts_smoothed
331,3,41.408,45.16266666666667,3.7546666666666653,89,97,8,ki_chroma_acts_smoothed
331,4,45.16266666666667,48.91733333333333,3.7546666666666653,97,105,8,ki_chroma_acts_smoothed
331,5,48.91733333333333,82.70933333333333,33.792,105,177,72,ki_chroma_acts_smoothed
331,6,82.70933333333333,97.728,15.018666666666661,177,209,32,ki_chroma_acts_smoothed
331,7,97.728,108.992,11.26400000000001,209,233,24,ki_chroma_acts_smoothed
331,8,108.992,127.76533333333333,18.773333333333326,233,273,40,ki_chroma_acts_smoothed
331,9,127.76533333333333,159.576,31.810666666666663,273,339,66,ki_chroma_acts_smoothed
334,1,0.0,36.96,36.96,0,73,73,chromagram
334,2,36.96,55.391999999999996,18.431999999999995,73,109,36,chromagram
334,3,55.391999999999996,118.88000000000001,63.488000000000014,109,233,124,chromagram
334,4,118.88000000000001,122.976,4.095999999999989,233,241,8,chromagram
334,5,122.976,137.312,14.336000000000013,241,269,28,chromagram
334,6,137.312,172.12800000000001,34.816,269,337,68,chromagram
334,7,172.12800000000001,206.43200000000002,34.304,337,404,67,chromagram
334,8,206.43200000000002,239.71200000000002,33.28,404,469,65,chromagram
334,9,239.71200000000002,256.792,17.079999999999956,469,501,32,chromagram
334,1,0.0,36.96,36.96,0,73,73,chroma_acts
334,2,36.96,55.391999999999996,18.431999999999995,73,109,36,chroma_acts
334,3,55.391999999999996,118.88000000000001,63.488000000000014,109,233,124,chroma_acts
334,4,118.88000000000001,122.976,4.095999999999989,233,241,8,chroma_acts
334,5,122.976,137.824,14.848000000000013,241,270,29,chroma_acts
334,6,137.824,172.12800000000001,34.304,270,337,67,chroma_acts
334,7,172.12800000000001,206.43200000000002,34.304,337,404,67,chroma_acts
334,8,206.43200000000002,239.71200000000002,33.28,404,469,65,chroma_acts
334,9,239.71200000000002,256.792,17.079999999999956,469,501,32,chroma_acts
334,1,0.0,36.96,36.96,0,73,73,chroma_acts_smoothed
334,2,36.96,56.928,19.967999999999996,73,112,39,chroma_acts_smoothed
334,3,56.928,118.88000000000001,61.95200000000001,112,233,121,chroma_acts_smoothed
334,4,118.88000000000001,137.824,18.944000000000003,233,270,37,chroma_acts_smoothed
334,5,137.824,172.12800000000001,34.304,270,337,67,chroma_acts_smoothed
334,6,172.12800000000001,205.92000000000002,33.792,337,403,66,chroma_acts_smoothed
334,7,205.92000000000002,211.55200000000002,5.632000000000005,403,414,11,chroma_acts_smoothed
334,8,211.55200000000002,240.22400000000002,28.671999999999997,414,470,56,chroma_acts_smoothed
334,9,240.22400000000002,256.792,16.567999999999955,470,501,31,chroma_acts_smoothed
334,1,0.0,36.96,36.96,0,73,73,ki_chroma
334,2,36.96,55.391999999999996,18.431999999999995,73,109,36,ki_chroma
334,3,55.391999999999996,118.88000000000001,63.488000000000014,109,233,124,ki_chroma
334,4,118.88000000000001,122.976,4.095999999999989,233,241,8,ki_chroma
334,5,122.976,137.312,14.336000000000013,241,269,28,ki_chroma
334,6,137.312,172.12800000000001,34.816,269,337,68,ki_chroma
334,7,172.12800000000001,206.43200000000002,34.304,337,404,67,ki_chroma
334,8,206.43200000000002,239.71200000000002,33.28,404,469,65,ki_chroma
334,9,239.71200000000002,256.792,17.079999999999956,469,501,32,ki_chroma
334,1,0.0,36.96,36.96,0,73,73,ki_chroma_acts
334,2,36.96,55.391999999999996,18.431999999999995,73,109,36,ki_chroma_acts
334,3,55.391999999999996,118.88000000000001,63.488000000000014,109,233,124,ki_chroma_acts
334,4,118.88000000000001,122.976,4.095999999999989,233,241,8,ki_chroma_acts
334,5,122.976,137.824,14.848000000000013,241,270,29,ki_chroma_acts
334,6,137.824,172.12800000000001,34.304,270,337,67,ki_chroma_acts
334,7,172.12800000000001,206.43200000000002,34.304,337,404,67,ki_chroma_acts
334,8,206.43200000000002,239.71200000000002,33.28,404,469,65,ki_chroma_acts
334,9,239.71200000000002,256.792,17.079999999999956,469,501,32,ki_chroma_acts
334,1,0.0,36.96,36.96,0,73,73,ki_chroma_acts_smoothed
334,2,36.96,56.928,19.967999999999996,73,112,39,ki_chroma_acts_smoothed
334,3,56.928,118.88000000000001,61.95200000000001,112,233,121,ki_chroma_acts_smoothed
334,4,118.88000000000001,137.824,18.944000000000003,233,270,37,ki_chroma_acts_smoothed
334,5,137.824,172.12800000000001,34.304,270,337,67,ki_chroma_acts_smoothed
334,6,172.12800000000001,205.92000000000002,33.792,337,403,66,ki_chroma_acts_smoothed
334,7,205.92000000000002,211.55200000000002,5.632000000000005,403,414,11,ki_chroma_acts_smoothed
334,8,211.55200000000002,240.22400000000002,28.671999999999997,414,470,56,ki_chroma_acts_smoothed
334,9,240.22400000000002,256.792,16.567999999999955,470,501,31,ki_chroma_acts_smoothed
336,1,0.0,7.669333333333333,7.669333333333333,0,11,11,chromagram
336,2,7.669333333333333,53.408,45.73866666666667,11,75,64,chromagram
336,3,53.408,84.13866666666667,30.730666666666664,75,118,43,chromagram
336,4,84.13866666666667,91.28533333333333,7.146666666666661,118,128,10,chromagram
336,5,91.28533333333333,99.14666666666666,7.861333333333334,128,139,11,chromagram
336,6,99.14666666666666,130.592,31.445333333333352,139,183,44,chromagram
336,7,130.592,144.17066666666668,13.578666666666663,183,202,19,chromagram
336,8,144.17066666666668,193.648,49.47733333333332,202,270,68,chromagram
336,1,0.0,7.669333333333333,7.669333333333333,0,11,11,chroma_acts
336,2,7.669333333333333,52.693333333333335,45.024,11,74,63,chroma_acts
336,3,52.693333333333335,84.13866666666667,31.44533333333333,74,118,44,chroma_acts
336,4,84.13866666666667,91.28533333333333,7.146666666666661,118,128,10,chroma_acts
336,5,91.28533333333333,99.14666666666666,7.861333333333334,128,139,11,chroma_acts
336,6,99.14666666666666,130.592,31.445333333333352,139,183,44,chroma_acts
336,7,130.592,144.17066666666668,13.578666666666663,183,202,19,chroma_acts
336,8,144.17066666666668,193.648,49.47733333333332,202,270,68,chroma_acts
336,1,0.0,7.669333333333333,7.669333333333333,0,11,11,chroma_acts_smoothed
336,2,7.669333333333333,52.693333333333335,45.024,11,74,63,chroma_acts_smoothed
336,3,52.693333333333335,83.424,30.73066666666667,74,117,43,chroma_acts_smoothed
336,4,83.424,90.57066666666667,7.146666666666661,117,127,10,chroma_acts_smoothed
336,5,90.57066666666667,98.432,7.861333333333334,127,138,11,chroma_acts_smoothed
336,6,98.432,129.1626666666667,30.730666666666693,138,181,43,chroma_acts_smoothed
336,7,129.1626666666667,144.17066666666668,15.007999999999981,181,202,21,chroma_acts_smoothed
336,8,144.17066666666668,193.648,49.47733333333332,202,270,68,chroma_acts_smoothed
336,1,0.0,7.669333333333333,7.669333333333333,0,11,11,ki_chroma
336,2,7.669333333333333,53.408,45.73866666666667,11,75,64,ki_chroma
336,3,53.408,84.13866666666667,30.730666666666664,75,118,43,ki_chroma
336,4,84.13866666666667,91.28533333333333,7.146666666666661,118,128,10,ki_chroma
336,5,91.28533333333333,99.14666666666666,7.861333333333334,128,139,11,ki_chroma
336,6,99.14666666666666,130.592,31.445333333333352,139,183,44,ki_chroma
336,7,130.592,144.17066666666668,13.578666666666663,183,202,19,ki_chroma
336,8,144.17066666666668,193.648,49.47733333333332,202,270,68,ki_chroma
336,1,0.0,7.669333333333333,7.669333333333333,0,11,11,ki_chroma_acts
336,2,7.669333333333333,52.693333333333335,45.024,11,74,63,ki_chroma_acts
336,3,52.693333333333335,84.13866666666667,31.44533333333333,74,118,44,ki_chroma_acts
336,4,84.13866666666667,91.28533333333333,7.146666666666661,118,128,10,ki_chroma_acts
336,5,91.28533333333333,99.14666666666666,7.861333333333334,128,139,11,ki_chroma_acts
336,6,99.14666666666666,130.592,31.445333333333352,139,183,44,ki_chroma_acts
336,7,130.592,144.17066666666668,13.578666666666663,183,202,19,ki_chroma_acts
336,8,144.17066666666668,193.648,49.47733333333332,202,270,68,ki_chroma_acts
336,1,0.0,7.669333333333333,7.669333333333333,0,11,11,ki_chroma_acts_smoothed
336,2,7.669333333333333,52.693333333333335,45.024,11,74,63,ki_chroma_acts_smoothed
336,3,52.693333333333335,83.424,30.73066666666667,74,117,43,ki_chroma_acts_smoothed
336,4,83.424,90.57066666666667,7.146666666666661,117,127,10,ki_chroma_acts_smoothed
336,5,90.57066666666667,98.432,7.861333333333334,127,138,11,ki_chroma_acts_smoothed
336,6,98.432,129.1626666666667,30.730666666666693,138,181,43,ki_chroma_acts_smoothed
336,7,129.1626666666667,144.17066666666668,15.007999999999981,181,202,21,ki_chroma_acts_smoothed
336,8,144.17066666666668,193.648,49.47733333333332,202,270,68,ki_chroma_acts_smoothed
341,1,0.0,31.200000000000003,31.200000000000003,0,64,64,chromagram
341,2,31.200000000000003,94.00533333333334,62.80533333333334,64,192,128,chromagram
341,3,94.00533333333334,125.89866666666667,31.89333333333333,192,257,65,chromagram
341,4,125.89866666666667,157.30133333333336,31.40266666666669,257,321,64,chromagram
341,5,157.30133333333336,187.23200000000003,29.930666666666667,321,382,61,chromagram
341,6,187.23200000000003,188.704,1.47199999999998,382,385,3,chromagram
341,7,188.704,267.70133333333337,78.99733333333336,385,546,161,chromagram
341,8,267.70133333333337,285.509,17.80766666666665,546,581,35,chromagram
341,1,0.0,31.200000000000003,31.200000000000003,0,64,64,chroma_acts
341,2,31.200000000000003,94.00533333333334,62.80533333333334,64,192,128,chroma_acts
341,3,94.00533333333334,127.86133333333333,33.855999999999995,192,261,69,chroma_acts
341,4,127.86133333333333,157.30133333333336,29.440000000000026,261,321,60,chroma_acts
341,5,157.30133333333336,187.23200000000003,29.930666666666667,321,382,61,chroma_acts
341,6,187.23200000000003,188.704,1.47199999999998,382,385,3,chroma_acts
341,7,188.704,267.70133333333337,78.99733333333336,385,546,161,chroma_acts
341,8,267.70133333333337,285.509,17.80766666666665,546,581,35,chroma_acts
341,1,0.0,31.200000000000003,31.200000000000003,0,64,64,chroma_acts_smoothed
341,2,31.200000000000003,94.496,63.29599999999999,64,193,129,chroma_acts_smoothed
341,3,94.496,126.88000000000001,32.384000000000015,193,259,66,chroma_acts_smoothed
341,4,126.88000000000001,157.30133333333336,30.42133333333335,259,321,62,chroma_acts_smoothed
341,5,157.30133333333336,187.23200000000003,29.930666666666667,321,382,61,chroma_acts_smoothed
341,6,187.23200000000003,188.704,1.47199999999998,382,385,3,chroma_acts_smoothed
341,7,188.704,268.192,79.488,385,547,162,chroma_acts_smoothed
341,8,268.192,285.509,17.317000000000007,547,581,34,chroma_acts_smoothed
341,1,0.0,31.200000000000003,31.200000000000003,0,64,64,ki_chroma
341,2,31.200000000000003,94.00533333333334,62.80533333333334,64,192,128,ki_chroma
341,3,94.00533333333334,125.89866666666667,31.89333333333333,192,257,65,ki_chroma
341,4,125.89866666666667,157.30133333333336,31.40266666666669,257,321,64,ki_chroma
341,5,157.30133333333336,187.23200000000003,29.930666666666667,321,382,61,ki_chroma
341,6,187.23200000000003,188.704,1.47199999999998,382,385,3,ki_chroma
341,7,188.704,267.70133333333337,78.99733333333336,385,546,161,ki_chroma
341,8,267.70133333333337,285.509,17.80766666666665,546,581,35,ki_chroma
341,1,0.0,31.200000000000003,31.200000000000003,0,64,64,ki_chroma_acts
341,2,31.200000000000003,94.00533333333334,62.80533333333334,64,192,128,ki_chroma_acts
341,3,94.00533333333334,127.86133333333333,33.855999999999995,192,261,69,ki_chroma_acts
341,4,127.86133333333333,157.30133333333336,29.440000000000026,261,321,60,ki_chroma_acts
341,5,157.30133333333336,187.23200000000003,29.930666666666667,321,382,61,ki_chroma_acts
341,6,187.23200000000003,188.704,1.47199999999998,382,385,3,ki_chroma_acts
341,7,188.704,267.70133333333337,78.99733333333336,385,546,161,ki_chroma_acts
341,8,267.70133333333337,285.509,17.80766666666665,546,581,35,ki_chroma_acts
341,1,0.0,31.200000000000003,31.200000000000003,0,64,64,ki_chroma_acts_smoothed
341,2,31.200000000000003,94.496,63.29599999999999,64,193,129,ki_chroma_acts_smoothed
341,3,94.496,126.88000000000001,32.384000000000015,193,259,66,ki_chroma_acts_smoothed
341,4,126.88000000000001,157.30133333333336,30.42133333333335,259,321,62,ki_chroma_acts_smoothed
341,5,157.30133333333336,187.23200000000003,29.930666666666667,321,382,61,ki_chroma_acts_smoothed
341,6,187.23200000000003,188.704,1.47199999999998,382,385,3,ki_chroma_acts_smoothed
341,7,188.704,268.192,79.488,385,547,162,ki_chroma_acts_smoothed
341,8,268.192,285.509,17.317000000000007,547,581,34,ki_chroma_acts_smoothed
347,1,0.0,3.936,3.936,0,9,9,chromagram
347,2,3.936,33.696,29.759999999999998,9,71,62,chromagram
347,3,33.696,48.57599999999999,14.879999999999995,71,102,31,chromagram
347,4,48.57599999999999,62.976,14.400000000000006,102,132,30,chromagram
347,5,62.976,93.696,30.72,132,196,64,chromagram
347,6,93.696,96.096,2.4000000000000057,196,201,5,chromagram
347,7,96.096,110.976,14.879999999999995,201,232,31,chromagram
347,8,110.976,122.976,12.0,232,257,25,chromagram
347,9,122.976,173.521,50.54499999999999,257,361,104,chromagram
347,1,0.0,3.936,3.936,0,9,9,chroma_acts
347,2,3.936,62.495999999999995,58.559999999999995,9,131,122,chroma_acts
347,3,62.495999999999995,64.416,1.9200000000000017,131,135,4,chroma_acts
347,4,64.416,93.21600000000001,28.80000000000001,135,195,60,chroma_acts
347,5,93.21600000000001,96.096,2.8799999999999955,195,201,6,chroma_acts
347,6,96.096,112.416,16.319999999999993,201,235,34,chroma_acts
347,7,112.416,123.936,11.52000000000001,235,259,24,chroma_acts
347,8,123.936,125.856,1.9199999999999875,259,263,4,chroma_acts
347,9,125.856,173.521,47.66499999999999,263,361,98,chroma_acts
347,1,0.0,3.936,3.936,0,9,9,chroma_acts_smoothed
347,2,3.936,33.696,29.759999999999998,9,71,62,chroma_acts_smoothed
347,3,33.696,49.535999999999994,15.839999999999996,71,104,33,chroma_acts_smoothed
347,4,49.535999999999994,62.495999999999995,12.96,104,131,27,chroma_acts_smoothed
347,5,62.495999999999995,93.21600000000001,30.720000000000013,131,195,64,chroma_acts_smoothed
347,6,93.21600000000001,96.57600000000001,3.3599999999999994,195,202,7,chroma_acts_smoothed
347,7,96.57600000000001,113.376,16.799999999999997,202,237,35,chroma_acts_smoothed
347,8,113.376,122.976,9.599999999999994,237,257,20,chroma_acts_smoothed
347,9,122.976,173.521,50.54499999999999,257,361,104,chroma_acts_smoothed
347,1,0.0,3.936,3.936,0,9,9,ki_chroma
347,2,3.936,33.696,29.759999999999998,9,71,62,ki_chroma
347,3,33.696,48.57599999999999,14.879999999999995,71,102,31,ki_chroma
347,4,48.57599999999999,62.976,14.400000000000006,102,132,30,ki_chroma
347,5,62.976,93.696,30.72,132,196,64,ki_chroma
347,6,93.696,96.096,2.4000000000000057,196,201,5,ki_chroma
347,7,96.096,110.976,14.879999999999995,201,232,31,ki_chroma
347,8,110.976,122.976,12.0,232,257,25,ki_chroma
347,9,122.976,173.521,50.54499999999999,257,361,104,ki_chroma
347,1,0.0,3.936,3.936,0,9,9,ki_chroma_acts
347,2,3.936,62.495999999999995,58.559999999999995,9,131,122,ki_chroma_acts
347,3,62.495999999999995,64.416,1.9200000000000017,131,135,4,ki_chroma_acts
347,4,64.416,93.21600000000001,28.80000000000001,135,195,60,ki_chroma_acts
347,5,93.21600000000001,96.096,2.8799999999999955,195,201,6,ki_chroma_acts
347,6,96.096,112.416,16.319999999999993,201,235,34,ki_chroma_acts
347,7,112.416,123.936,11.52000000000001,235,259,24,ki_chroma_acts
347,8,123.936,125.856,1.9199999999999875,259,263,4,ki_chroma_acts
347,9,125.856,173.521,47.66499999999999,263,361,98,ki_chroma_acts
347,1,0.0,3.936,3.936,0,9,9,ki_chroma_acts_smoothed
347,2,3.936,33.696,29.759999999999998,9,71,62,ki_chroma_acts_smoothed
347,3,33.696,49.535999999999994,15.839999999999996,71,104,33,ki_chroma_acts_smoothed
347,4,49.535999999999994,62.495999999999995,12.96,104,131,27,ki_chroma_acts_smoothed
347,5,62.495999999999995,93.21600000000001,30.720000000000013,131,195,64,ki_chroma_acts_smoothed
347,6,93.21600000000001,96.57600000000001,3.3599999999999994,195,202,7,ki_chroma_acts_smoothed
347,7,96.57600000000001,113.376,16.799999999999997,202,237,35,ki_chroma_acts_smoothed
347,8,113.376,122.976,9.599999999999994,237,257,20,ki_chroma_acts_smoothed
347,9,122.976,173.521,50.54499999999999,257,361,104,ki_chroma_acts_smoothed
348,1,0.0,15.072,15.072,0,33,33,chromagram
348,2,15.072,48.864,33.792,33,105,72,chromagram
348,3,48.864,58.25066666666667,9.38666666666667,105,125,20,chromagram
348,4,58.25066666666667,89.696,31.44533333333333,125,192,67,chromagram
348,5,89.696,105.184,15.488,192,225,33,chromagram
348,6,105.184,108.93866666666666,3.7546666666666653,225,233,8,chromagram
348,7,108.93866666666666,121.61066666666666,12.671999999999997,233,260,27,chromagram
348,8,121.61066666666666,166.19733333333335,44.58666666666669,260,355,95,chromagram
348,9,166.19733333333335,180.0,13.802666666666653,355,383,28,chromagram
348,1,0.0,14.602666666666666,14.602666666666666,0,32,32,chroma_acts
348,2,14.602666666666666,48.864,34.26133333333333,32,105,73,chroma_acts
348,3,48.864,58.25066666666667,9.38666666666667,105,125,20,chroma_acts
348,4,58.25066666666667,89.696,31.44533333333333,125,192,67,chroma_acts
348,5,89.696,105.184,15.488,192,225,33,chroma_acts
348,6,105.184,108.93866666666666,3.7546666666666653,225,233,8,chroma_acts
348,7,108.93866666666666,121.61066666666666,12.671999999999997,233,260,27,chroma_acts
348,8,121.61066666666666,165.25866666666667,43.64800000000001,260,353,93,chroma_acts
348,9,165.25866666666667,180.0,14.74133333333333,353,383,30,chroma_acts
348,1,0.0,15.072,15.072,0,33,33,chroma_acts_smoothed
348,2,15.072,48.864,33.792,33,105,72,chroma_acts_smoothed
348,3,48.864,58.25066666666667,9.38666666666667,105,125,20,chroma_acts_smoothed
348,4,58.25066666666667,89.696,31.44533333333333,125,192,67,chroma_acts_smoothed
348,5,89.696,104.71466666666666,15.018666666666661,192,224,32,chroma_acts_smoothed
348,6,104.71466666666666,108.93866666666666,4.224000000000004,224,233,9,chroma_acts_smoothed
348,7,108.93866666666666,121.61066666666666,12.671999999999997,233,260,27,chroma_acts_smoothed
348,8,121.61066666666666,166.19733333333335,44.58666666666669,260,355,95,chroma_acts_smoothed
348,9,166.19733333333335,180.0,13.802666666666653,355,383,28,chroma_acts_smoothed
348,1,0.0,15.072,15.072,0,33,33,ki_chroma
348,2,15.072,48.864,33.792,33,105,72,ki_chroma
348,3,48.864,58.25066666666667,9.38666666666667,105,125,20,ki_chroma
348,4,58.25066666666667,89.696,31.44533333333333,125,192,67,ki_chroma
348,5,89.696,105.184,15.488,192,225,33,ki_chroma
348,6,105.184,108.93866666666666,3.7546666666666653,225,233,8,ki_chroma
348,7,108.93866666666666,121.61066666666666,12.671999999999997,233,260,27,ki_chroma
348,8,121.61066666666666,166.19733333333335,44.58666666666669,260,355,95,ki_chroma
348,9,166.19733333333335,180.0,13.802666666666653,355,383,28,ki_chroma
348,1,0.0,14.602666666666666,14.602666666666666,0,32,32,ki_chroma_acts
348,2,14.602666666666666,48.864,34.26133333333333,32,105,73,ki_chroma_acts
348,3,48.864,58.25066666666667,9.38666666666667,105,125,20,ki_chroma_acts
348,4,58.25066666666667,89.696,31.44533333333333,125,192,67,ki_chroma_acts
348,5,89.696,105.184,15.488,192,225,33,ki_chroma_acts
348,6,105.184,108.93866666666666,3.7546666666666653,225,233,8,ki_chroma_acts
348,7,108.93866666666666,121.61066666666666,12.671999999999997,233,260,27,ki_chroma_acts
348,8,121.61066666666666,165.25866666666667,43.64800000000001,260,353,93,ki_chroma_acts
348,9,165.25866666666667,180.0,14.74133333333333,353,383,30,ki_chroma_acts
348,1,0.0,15.072,15.072,0,33,33,ki_chroma_acts_smoothed
348,2,15.072,48.864,33.792,33,105,72,ki_chroma_acts_smoothed
348,3,48.864,58.25066666666667,9.38666666666667,105,125,20,ki_chroma_acts_smoothed
348,4,58.25066666666667,89.696,31.44533333333333,125,192,67,ki_chroma_acts_smoothed
348,5,89.696,104.71466666666666,15.018666666666661,192,224,32,ki_chroma_acts_smoothed
348,6,104.71466666666666,108.93866666666666,4.224000000000004,224,233,9,ki_chroma_acts_smoothed
348,7,108.93866666666666,121.61066666666666,12.671999999999997,233,260,27,ki_chroma_acts_smoothed
348,8,121.61066666666666,166.19733333333335,44.58666666666669,260,355,95,ki_chroma_acts_smoothed
348,9,166.19733333333335,180.0,13.802666666666653,355,383,28,ki_chroma_acts_smoothed
349,1,0.0,53.32266666666666,53.32266666666666,0,112,112,chromagram
349,2,53.32266666666666,85.96266666666666,32.64,112,180,68,chromagram
349,3,85.96266666666666,98.92266666666666,12.959999999999994,180,207,27,chromagram
349,4,98.92266666666666,116.20266666666666,17.28,207,243,36,chromagram
349,5,116.20266666666666,120.04266666666666,3.8400000000000034,243,251,8,chromagram
349,6,120.04266666666666,123.88266666666667,3.8400000000000034,251,259,8,chromagram
349,7,123.88266666666667,127.72266666666665,3.839999999999989,259,267,8,chromagram
349,8,127.72266666666665,162.28266666666667,34.56000000000002,267,339,72,chromagram
349,9,162.28266666666667,175.038,12.75533333333334,339,364,25,chromagram
349,1,0.0,57.16266666666667,57.16266666666667,0,120,120,chroma_acts
349,2,57.16266666666667,60.522666666666666,3.3599999999999994,120,127,7,chroma_acts
349,3,60.522666666666666,64.84266666666666,4.319999999999993,127,136,9,chroma_acts
349,4,64.84266666666666,68.20266666666666,3.3599999999999994,136,143,7,chroma_acts
349,5,68.20266666666666,72.52266666666667,4.320000000000007,143,152,9,chroma_acts
349,6,72.52266666666667,75.88266666666667,3.3599999999999994,152,159,7,chroma_acts
349,7,75.88266666666667,80.20266666666666,4.319999999999993,159,168,9,chroma_acts
349,8,80.20266666666666,98.92266666666666,18.72,168,207,39,chroma_acts
349,9,98.92266666666666,175.038,76.11533333333335,207,364,157,chroma_acts
349,1,0.0,53.32266666666666,53.32266666666666,0,112,112,chroma_acts_smoothed
349,2,53.32266666666666,80.20266666666666,26.879999999999995,112,168,56,chroma_acts_smoothed
349,3,80.20266666666666,99.40266666666666,19.200000000000003,168,208,40,chroma_acts_smoothed
349,4,99.40266666666666,102.76266666666666,3.3599999999999994,208,215,7,chroma_acts_smoothed
349,5,102.76266666666666,106.60266666666666,3.8400000000000034,215,223,8,chroma_acts_smoothed
349,6,106.60266666666666,110.44266666666667,3.8400000000000034,223,231,8,chroma_acts_smoothed
349,7,110.44266666666667,129.16266666666667,18.72,231,270,39,chroma_acts_smoothed
349,8,129.16266666666667,175.038,45.875333333333344,270,364,94,chroma_acts_smoothed
349,1,0.0,53.32266666666666,53.32266666666666,0,112,112,ki_chroma
349,2,53.32266666666666,85.96266666666666,32.64,112,180,68,ki_chroma
349,3,85.96266666666666,98.92266666666666,12.959999999999994,180,207,27,ki_chroma
349,4,98.92266666666666,116.20266666666666,17.28,207,243,36,ki_chroma
349,5,116.20266666666666,120.04266666666666,3.8400000000000034,243,251,8,ki_chroma
349,6,120.04266666666666,123.88266666666667,3.8400000000000034,251,259,8,ki_chroma
349,7,123.88266666666667,127.72266666666665,3.839999999999989,259,267,8,ki_chroma
349,8,127.72266666666665,162.28266666666667,34.56000000000002,267,339,72,ki_chroma
349,9,162.28266666666667,175.038,12.75533333333334,339,364,25,ki_chroma
349,1,0.0,68.20266666666666,68.20266666666666,0,143,143,ki_chroma_acts
349,2,68.20266666666666,80.20266666666666,12.0,143,168,25,ki_chroma_acts
349,3,80.20266666666666,98.92266666666666,18.72,168,207,39,ki_chroma_acts
349,4,98.92266666666666,110.44266666666667,11.52000000000001,207,231,24,ki_chroma_acts
349,5,110.44266666666667,129.64266666666668,19.200000000000017,231,271,40,ki_chroma_acts
349,6,129.64266666666668,133.4826666666667,3.8400000000000034,271,279,8,ki_chroma_acts
349,7,133.4826666666667,135.40266666666668,1.9199999999999875,279,283,4,ki_chroma_acts
349,8,135.40266666666668,139.24266666666668,3.8400000000000034,283,291,8,ki_chroma_acts
349,9,139.24266666666668,175.038,35.79533333333333,291,364,73,ki_chroma_acts
349,1,0.0,53.32266666666666,53.32266666666666,0,112,112,ki_chroma_acts_smoothed
349,2,53.32266666666666,80.20266666666666,26.879999999999995,112,168,56,ki_chroma_acts_smoothed
349,3,80.20266666666666,99.40266666666666,19.200000000000003,168,208,40,ki_chroma_acts_smoothed
349,4,99.40266666666666,102.76266666666666,3.3599999999999994,208,215,7,ki_chroma_acts_smoothed
349,5,102.76266666666666,106.60266666666666,3.8400000000000034,215,223,8,ki_chroma_acts_smoothed
349,6,106.60266666666666,110.44266666666667,3.8400000000000034,223,231,8,ki_chroma_acts_smoothed
349,7,110.44266666666667,129.16266666666667,18.72,231,270,39,ki_chroma_acts_smoothed
349,8,129.16266666666667,175.038,45.875333333333344,270,364,94,ki_chroma_acts_smoothed
350,1,0.0,15.68,15.68,0,33,33,chromagram
350,2,15.68,46.4,30.72,33,97,64,chromagram
350,3,46.4,61.28,14.880000000000003,97,128,31,chromagram
350,4,61.28,108.79999999999998,47.51999999999998,128,227,99,chromagram
350,5,108.79999999999998,123.67999999999999,14.88000000000001,227,258,31,chromagram
350,6,123.67999999999999,153.44,29.760000000000005,258,320,62,chromagram
350,7,153.44,186.55999999999997,33.119999999999976,320,389,69,chromagram
350,8,186.55999999999997,200.95999999999998,14.400000000000006,389,419,30,chromagram
350,9,200.95999999999998,263.226,62.26600000000002,419,547,128,chromagram
350,1,0.0,22.88,22.88,0,48,48,chroma_acts
350,2,22.88,61.28,38.400000000000006,48,128,80,chroma_acts
350,3,61.28,108.32,47.03999999999999,128,226,98,chroma_acts
350,4,108.32,123.67999999999999,15.36,226,258,32,chroma_acts
350,5,123.67999999999999,153.92,30.239999999999995,258,321,63,chroma_acts
350,6,153.92,185.6,31.680000000000007,321,387,66,chroma_acts
350,7,185.6,200.95999999999998,15.359999999999985,387,419,32,chroma_acts
350,8,200.95999999999998,231.67999999999998,30.72,419,483,64,chroma_acts
350,9,231.67999999999998,263.226,31.54600000000002,483,547,64,chroma_acts
350,1,0.0,23.36,23.36,0,49,49,chroma_acts_smoothed
350,2,23.36,61.76,38.4,49,129,80,chroma_acts_smoothed
350,3,61.76,108.79999999999998,47.039999999999985,129,227,98,chroma_acts_smoothed
350,4,108.79999999999998,123.67999999999999,14.88000000000001,227,258,31,chroma_acts_smoothed
350,5,123.67999999999999,154.39999999999998,30.719999999999985,258,322,64,chroma_acts_smoothed
350,6,154.39999999999998,186.07999999999998,31.680000000000007,322,388,66,chroma_acts_smoothed
350,7,186.07999999999998,200.48,14.400000000000006,388,418,30,chroma_acts_smoothed
350,8,200.48,231.67999999999998,31.19999999999999,418,483,65,chroma_acts_smoothed
350,9,231.67999999999998,263.226,31.54600000000002,483,547,64,chroma_acts_smoothed
350,1,0.0,15.68,15.68,0,33,33,ki_chroma
350,2,15.68,46.4,30.72,33,97,64,ki_chroma
350,3,46.4,61.28,14.880000000000003,97,128,31,ki_chroma
350,4,61.28,108.79999999999998,47.51999999999998,128,227,99,ki_chroma
350,5,108.79999999999998,123.67999999999999,14.88000000000001,227,258,31,ki_chroma
350,6,123.67999999999999,153.44,29.760000000000005,258,320,62,ki_chroma
350,7,153.44,186.55999999999997,33.119999999999976,320,389,69,ki_chroma
350,8,186.55999999999997,200.95999999999998,14.400000000000006,389,419,30,ki_chroma
350,9,200.95999999999998,263.226,62.26600000000002,419,547,128,ki_chroma
350,1,0.0,22.88,22.88,0,48,48,ki_chroma_acts
350,2,22.88,61.28,38.400000000000006,48,128,80,ki_chroma_acts
350,3,61.28,108.32,47.03999999999999,128,226,98,ki_chroma_acts
350,4,108.32,123.67999999999999,15.36,226,258,32,ki_chroma_acts
350,5,123.67999999999999,153.92,30.239999999999995,258,321,63,ki_chroma_acts
350,6,153.92,185.6,31.680000000000007,321,387,66,ki_chroma_acts
350,7,185.6,200.95999999999998,15.359999999999985,387,419,32,ki_chroma_acts
350,8,200.95999999999998,231.67999999999998,30.72,419,483,64,ki_chroma_acts
350,9,231.67999999999998,263.226,31.54600000000002,483,547,64,ki_chroma_acts
350,1,0.0,23.36,23.36,0,49,49,ki_chroma_acts_smoothed
350,2,23.36,61.76,38.4,49,129,80,ki_chroma_acts_smoothed
350,3,61.76,108.79999999999998,47.039999999999985,129,227,98,ki_chroma_acts_smoothed
350,4,108.79999999999998,123.67999999999999,14.88000000000001,227,258,31,ki_chroma_acts_smoothed
350,5,123.67999999999999,154.39999999999998,30.719999999999985,258,322,64,ki_chroma_acts_smoothed
350,6,154.39999999999998,186.07999999999998,31.680000000000007,322,388,66,ki_chroma_acts_smoothed
350,7,186.07999999999998,200.48,14.400000000000006,388,418,30,ki_chroma_acts_smoothed
350,8,200.48,231.67999999999998,31.19999999999999,418,483,65,ki_chroma_acts_smoothed
350,9,231.67999999999998,263.226,31.54600000000002,483,547,64,ki_chroma_acts_smoothed
351,1,0.0,3.6266666666666665,3.6266666666666665,0,8,8,chromagram
351,2,3.6266666666666665,18.986666666666665,15.359999999999998,8,40,32,chromagram
351,3,18.986666666666665,34.346666666666664,15.36,40,72,32,chromagram
351,4,34.346666666666664,79.94666666666666,45.599999999999994,72,167,95,chromagram
351,5,79.94666666666666,94.82666666666667,14.88000000000001,167,198,31,chromagram
351,6,94.82666666666667,113.06666666666666,18.239999999999995,198,236,38,chromagram
351,7,113.06666666666666,125.54666666666667,12.480000000000004,236,262,26,chromagram
351,8,125.54666666666667,175.632,50.08533333333334,262,365,103,chromagram
351,1,0.0,3.6266666666666665,3.6266666666666665,0,8,8,chroma_acts
351,2,3.6266666666666665,19.466666666666665,15.839999999999998,8,41,33,chroma_acts
351,3,19.466666666666665,32.42666666666666,12.959999999999997,41,68,27,chroma_acts
351,4,32.42666666666666,34.346666666666664,1.9200000000000017,68,72,4,chroma_acts
351,5,34.346666666666664,79.94666666666666,45.599999999999994,72,167,95,chroma_acts
351,6,79.94666666666666,111.62666666666667,31.680000000000007,167,233,66,chroma_acts
351,7,111.62666666666667,125.54666666666667,13.920000000000002,233,262,29,chroma_acts
351,8,125.54666666666667,175.632,50.08533333333334,262,365,103,chroma_acts
351,1,0.0,19.466666666666665,19.466666666666665,0,41,41,chroma_acts_smoothed
351,2,19.466666666666665,34.346666666666664,14.879999999999999,41,72,31,chroma_acts_smoothed
351,3,34.346666666666664,79.94666666666666,45.599999999999994,72,167,95,chroma_acts_smoothed
351,4,79.94666666666666,94.34666666666666,14.400000000000006,167,197,30,chroma_acts_smoothed
351,5,94.34666666666666,111.62666666666667,17.28,197,233,36,chroma_acts_smoothed
351,6,111.62666666666667,125.54666666666667,13.920000000000002,233,262,29,chroma_acts_smoothed
351,7,125.54666666666667,175.632,50.08533333333334,262,365,103,chroma_acts_smoothed
351,1,0.0,3.6266666666666665,3.6266666666666665,0,8,8,ki_chroma
351,2,3.6266666666666665,18.986666666666665,15.359999999999998,8,40,32,ki_chroma
351,3,18.986666666666665,34.346666666666664,15.36,40,72,32,ki_chroma
351,4,34.346666666666664,79.94666666666666,45.599999999999994,72,167,95,ki_chroma
351,5,79.94666666666666,94.82666666666667,14.88000000000001,167,198,31,ki_chroma
351,6,94.82666666666667,113.06666666666666,18.239999999999995,198,236,38,ki_chroma
351,7,113.06666666666666,125.54666666666667,12.480000000000004,236,262,26,ki_chroma
351,8,125.54666666666667,175.632,50.08533333333334,262,365,103,ki_chroma
351,1,0.0,3.6266666666666665,3.6266666666666665,0,8,8,ki_chroma_acts
351,2,3.6266666666666665,19.466666666666665,15.839999999999998,8,41,33,ki_chroma_acts
351,3,19.466666666666665,32.42666666666666,12.959999999999997,41,68,27,ki_chroma_acts
351,4,32.42666666666666,34.346666666666664,1.9200000000000017,68,72,4,ki_chroma_acts
351,5,34.346666666666664,79.94666666666666,45.599999999999994,72,167,95,ki_chroma_acts
351,6,79.94666666666666,111.62666666666667,31.680000000000007,167,233,66,ki_chroma_acts
351,7,111.62666666666667,125.54666666666667,13.920000000000002,233,262,29,ki_chroma_acts
351,8,125.54666666666667,175.632,50.08533333333334,262,365,103,ki_chroma_acts
351,1,0.0,19.466666666666665,19.466666666666665,0,41,41,ki_chroma_acts_smoothed
351,2,19.466666666666665,34.346666666666664,14.879999999999999,41,72,31,ki_chroma_acts_smoothed
351,3,34.346666666666664,79.94666666666666,45.599999999999994,72,167,95,ki_chroma_acts_smoothed
351,4,79.94666666666666,94.34666666666666,14.400000000000006,167,197,30,ki_chroma_acts_smoothed
351,5,94.34666666666666,111.62666666666667,17.28,197,233,36,ki_chroma_acts_smoothed
351,6,111.62666666666667,125.54666666666667,13.920000000000002,233,262,29,ki_chroma_acts_smoothed
351,7,125.54666666666667,175.632,50.08533333333334,262,365,103,ki_chroma_acts_smoothed
352,1,0.0,14.314666666666666,14.314666666666666,0,30,30,chromagram
352,2,14.314666666666666,38.794666666666664,24.479999999999997,30,81,51,chromagram
352,3,38.794666666666664,46.474666666666664,7.68,81,97,16,chromagram
352,4,46.474666666666664,93.03466666666667,46.56,97,194,97,chromagram
352,5,93.03466666666667,101.19466666666666,8.159999999999997,194,211,17,chromagram
352,6,101.19466666666666,123.27466666666666,22.08,211,257,46,chromagram
352,7,123.27466666666666,139.11466666666666,15.840000000000003,257,290,33,chromagram
352,8,139.11466666666666,175.59466666666665,36.47999999999999,290,366,76,chromagram
352,9,175.59466666666665,218.71,43.11533333333335,366,454,88,chromagram
352,1,0.0,30.634666666666664,30.634666666666664,0,64,64,chroma_acts
352,2,30.634666666666664,38.794666666666664,8.16,64,81,17,chroma_acts
352,3,38.794666666666664,46.474666666666664,7.68,81,97,16,chroma_acts
352,4,46.474666666666664,93.03466666666667,46.56,97,194,97,chroma_acts
352,5,93.03466666666667,101.19466666666666,8.159999999999997,194,211,17,chroma_acts
352,6,101.19466666666666,123.75466666666667,22.560000000000002,211,258,47,chroma_acts
352,7,123.75466666666667,139.11466666666666,15.36,258,290,32,chroma_acts
352,8,139.11466666666666,175.59466666666665,36.47999999999999,290,366,76,chroma_acts
352,9,175.59466666666665,218.71,43.11533333333335,366,454,88,chroma_acts
352,1,0.0,31.114666666666665,31.114666666666665,0,65,65,chroma_acts_smoothed
352,2,31.114666666666665,38.794666666666664,7.68,65,81,16,chroma_acts_smoothed
352,3,38.794666666666664,46.474666666666664,7.68,81,97,16,chroma_acts_smoothed
352,4,46.474666666666664,93.03466666666667,46.56,97,194,97,chroma_acts_smoothed
352,5,93.03466666666667,101.19466666666666,8.159999999999997,194,211,17,chroma_acts_smoothed
352,6,101.19466666666666,123.75466666666667,22.560000000000002,211,258,47,chroma_acts_smoothed
352,7,123.75466666666667,139.11466666666666,15.36,258,290,32,chroma_acts_smoothed
352,8,139.11466666666666,175.59466666666665,36.47999999999999,290,366,76,chroma_acts_smoothed
352,9,175.59466666666665,218.71,43.11533333333335,366,454,88,chroma_acts_smoothed
352,1,0.0,14.314666666666666,14.314666666666666,0,30,30,ki_chroma
352,2,14.314666666666666,38.794666666666664,24.479999999999997,30,81,51,ki_chroma
352,3,38.794666666666664,46.474666666666664,7.68,81,97,16,ki_chroma
352,4,46.474666666666664,93.03466666666667,46.56,97,194,97,ki_chroma
352,5,93.03466666666667,101.19466666666666,8.159999999999997,194,211,17,ki_chroma
352,6,101.19466666666666,123.27466666666666,22.08,211,257,46,ki_chroma
352,7,123.27466666666666,139.11466666666666,15.840000000000003,257,290,33,ki_chroma
352,8,139.11466666666666,175.59466666666665,36.47999999999999,290,366,76,ki_chroma
352,9,175.59466666666665,218.71,43.11533333333335,366,454,88,ki_chroma
352,1,0.0,30.634666666666664,30.634666666666664,0,64,64,ki_chroma_acts
352,2,30.634666666666664,38.794666666666664,8.16,64,81,17,ki_chroma_acts
352,3,38.794666666666664,46.474666666666664,7.68,81,97,16,ki_chroma_acts
352,4,46.474666666666664,93.03466666666667,46.56,97,194,97,ki_chroma_acts
352,5,93.03466666666667,101.19466666666666,8.159999999999997,194,211,17,ki_chroma_acts
352,6,101.19466666666666,123.75466666666667,22.560000000000002,211,258,47,ki_chroma_acts
352,7,123.75466666666667,139.11466666666666,15.36,258,290,32,ki_chroma_acts
352,8,139.11466666666666,175.59466666666665,36.47999999999999,290,366,76,ki_chroma_acts
352,9,175.59466666666665,218.71,43.11533333333335,366,454,88,ki_chroma_acts
352,1,0.0,31.114666666666665,31.114666666666665,0,65,65,ki_chroma_acts_smoothed
352,2,31.114666666666665,38.794666666666664,7.68,65,81,16,ki_chroma_acts_smoothed
352,3,38.794666666666664,46.474666666666664,7.68,81,97,16,ki_chroma_acts_smoothed
352,4,46.474666666666664,93.03466666666667,46.56,97,194,97,ki_chroma_acts_smoothed
352,5,93.03466666666667,101.19466666666666,8.159999999999997,194,211,17,ki_chroma_acts_smoothed
352,6,101.19466666666666,123.75466666666667,22.560000000000002,211,258,47,ki_chroma_acts_smoothed
352,7,123.75466666666667,139.11466666666666,15.36,258,290,32,ki_chroma_acts_smoothed
352,8,139.11466666666666,175.59466666666665,36.47999999999999,290,366,76,ki_chroma_acts_smoothed
352,9,175.59466666666665,218.71,43.11533333333335,366,454,88,ki_chroma_acts_smoothed
353,1,0.0,31.264,31.264,0,66,66,chromagram
353,2,31.264,44.70399999999999,13.439999999999994,66,94,28,chromagram
353,3,44.70399999999999,75.904,31.200000000000003,94,159,65,chromagram
353,4,75.904,93.184,17.28,159,195,36,chromagram
353,5,93.184,123.904,30.72,195,259,64,chromagram
353,6,123.904,139.264,15.360000000000014,259,291,32,chromagram
353,7,139.264,153.184,13.919999999999987,291,320,29,chromagram
353,8,153.184,199.744,46.56,320,417,97,chromagram
353,9,199.744,217.667,17.923000000000002,417,453,36,chromagram
353,1,0.0,29.343999999999998,29.343999999999998,0,62,62,chroma_acts
353,2,29.343999999999998,46.623999999999995,17.279999999999998,62,98,36,chroma_acts
353,3,46.623999999999995,75.904,29.28,98,159,61,chroma_acts
353,4,75.904,93.184,17.28,159,195,36,chroma_acts
353,5,93.184,123.904,30.72,195,259,64,chroma_acts
353,6,123.904,139.744,15.840000000000003,259,292,33,chroma_acts
353,7,139.744,155.104,15.360000000000014,292,324,32,chroma_acts
353,8,155.104,199.744,44.639999999999986,324,417,93,chroma_acts
353,9,199.744,217.667,17.923000000000002,417,453,36,chroma_acts
353,1,0.0,31.264,31.264,0,66,66,chroma_acts_smoothed
353,2,31.264,46.623999999999995,15.359999999999996,66,98,32,chroma_acts_smoothed
353,3,46.623999999999995,75.42399999999999,28.799999999999997,98,158,60,chroma_acts_smoothed
353,4,75.42399999999999,93.184,17.760000000000005,158,195,37,chroma_acts_smoothed
353,5,93.184,123.904,30.72,195,259,64,chroma_acts_smoothed
353,6,123.904,140.22400000000002,16.32000000000002,259,293,34,chroma_acts_smoothed
353,7,140.22400000000002,155.104,14.879999999999995,293,324,31,chroma_acts_smoothed
353,8,155.104,199.744,44.639999999999986,324,417,93,chroma_acts_smoothed
353,9,199.744,217.667,17.923000000000002,417,453,36,chroma_acts_smoothed
353,1,0.0,31.264,31.264,0,66,66,ki_chroma
353,2,31.264,44.70399999999999,13.439999999999994,66,94,28,ki_chroma
353,3,44.70399999999999,75.904,31.200000000000003,94,159,65,ki_chroma
353,4,75.904,93.184,17.28,159,195,36,ki_chroma
353,5,93.184,123.904,30.72,195,259,64,ki_chroma
353,6,123.904,139.264,15.360000000000014,259,291,32,ki_chroma
353,7,139.264,153.184,13.919999999999987,291,320,29,ki_chroma
353,8,153.184,199.744,46.56,320,417,97,ki_chroma
353,9,199.744,217.667,17.923000000000002,417,453,36,ki_chroma
353,1,0.0,29.343999999999998,29.343999999999998,0,62,62,ki_chroma_acts
353,2,29.343999999999998,46.623999999999995,17.279999999999998,62,98,36,ki_chroma_acts
353,3,46.623999999999995,75.904,29.28,98,159,61,ki_chroma_acts
353,4,75.904,93.184,17.28,159,195,36,ki_chroma_acts
353,5,93.184,123.904,30.72,195,259,64,ki_chroma_acts
353,6,123.904,139.744,15.840000000000003,259,292,33,ki_chroma_acts
353,7,139.744,155.104,15.360000000000014,292,324,32,ki_chroma_acts
353,8,155.104,199.744,44.639999999999986,324,417,93,ki_chroma_acts
353,9,199.744,217.667,17.923000000000002,417,453,36,ki_chroma_acts
353,1,0.0,31.264,31.264,0,66,66,ki_chroma_acts_smoothed
353,2,31.264,46.623999999999995,15.359999999999996,66,98,32,ki_chroma_acts_smoothed
353,3,46.623999999999995,75.42399999999999,28.799999999999997,98,158,60,ki_chroma_acts_smoothed
353,4,75.42399999999999,93.184,17.760000000000005,158,195,37,ki_chroma_acts_smoothed
353,5,93.184,123.904,30.72,195,259,64,ki_chroma_acts_smoothed
353,6,123.904,140.22400000000002,16.32000000000002,259,293,34,ki_chroma_acts_smoothed
353,7,140.22400000000002,155.104,14.879999999999995,293,324,31,ki_chroma_acts_smoothed
353,8,155.104,199.744,44.639999999999986,324,417,93,ki_chroma_acts_smoothed
353,9,199.744,217.667,17.923000000000002,417,453,36,ki_chroma_acts_smoothed
354,1,0.0,17.642666666666667,17.642666666666667,0,37,37,chromagram
354,2,17.642666666666667,46.922666666666665,29.279999999999998,37,98,61,chromagram
354,3,46.922666666666665,56.522666666666666,9.600000000000001,98,118,20,chromagram
354,4,56.522666666666666,63.72266666666666,7.199999999999996,118,133,15,chromagram
354,5,63.72266666666666,93.00266666666667,29.28000000000001,133,194,61,chromagram
354,6,93.00266666666667,107.88266666666667,14.879999999999995,194,225,31,chromagram
354,7,107.88266666666667,125.16266666666667,17.28,225,261,36,chromagram
354,8,125.16266666666667,158.116,32.95333333333335,261,328,67,chromagram
354,1,0.0,17.642666666666667,17.642666666666667,0,37,37,chroma_acts
354,2,17.642666666666667,46.922666666666665,29.279999999999998,37,98,61,chroma_acts
354,3,46.922666666666665,56.522666666666666,9.600000000000001,98,118,20,chroma_acts
354,4,56.522666666666666,63.72266666666666,7.199999999999996,118,133,15,chroma_acts
354,5,63.72266666666666,93.00266666666667,29.28000000000001,133,194,61,chroma_acts
354,6,93.00266666666667,107.88266666666667,14.879999999999995,194,225,31,chroma_acts
354,7,107.88266666666667,125.16266666666667,17.28,225,261,36,chroma_acts
354,8,125.16266666666667,158.116,32.95333333333335,261,328,67,chroma_acts
354,1,0.0,17.642666666666667,17.642666666666667,0,37,37,chroma_acts_smoothed
354,2,17.642666666666667,46.44266666666667,28.8,37,97,60,chroma_acts_smoothed
354,3,46.44266666666667,56.04266666666666,9.599999999999994,97,117,20,chroma_acts_smoothed
354,4,56.04266666666666,63.72266666666666,7.68,117,133,16,chroma_acts_smoothed
354,5,63.72266666666666,92.52266666666667,28.800000000000004,133,193,60,chroma_acts_smoothed
354,6,92.52266666666667,107.88266666666667,15.36,193,225,32,chroma_acts_smoothed
354,7,107.88266666666667,125.16266666666667,17.28,225,261,36,chroma_acts_smoothed
354,8,125.16266666666667,158.116,32.95333333333335,261,328,67,chroma_acts_smoothed
354,1,0.0,17.642666666666667,17.642666666666667,0,37,37,ki_chroma
354,2,17.642666666666667,46.922666666666665,29.279999999999998,37,98,61,ki_chroma
354,3,46.922666666666665,56.522666666666666,9.600000000000001,98,118,20,ki_chroma
354,4,56.522666666666666,63.72266666666666,7.199999999999996,118,133,15,ki_chroma
354,5,63.72266666666666,93.00266666666667,29.28000000000001,133,194,61,ki_chroma
354,6,93.00266666666667,107.88266666666667,14.879999999999995,194,225,31,ki_chroma
354,7,107.88266666666667,125.16266666666667,17.28,225,261,36,ki_chroma
354,8,125.16266666666667,158.116,32.95333333333335,261,328,67,ki_chroma
354,1,0.0,17.642666666666667,17.642666666666667,0,37,37,ki_chroma_acts
354,2,17.642666666666667,46.922666666666665,29.279999999999998,37,98,61,ki_chroma_acts
354,3,46.922666666666665,56.522666666666666,9.600000000000001,98,118,20,ki_chroma_acts
354,4,56.522666666666666,63.72266666666666,7.199999999999996,118,133,15,ki_chroma_acts
354,5,63.72266666666666,93.00266666666667,29.28000000000001,133,194,61,ki_chroma_acts
354,6,93.00266666666667,107.88266666666667,14.879999999999995,194,225,31,ki_chroma_acts
354,7,107.88266666666667,125.16266666666667,17.28,225,261,36,ki_chroma_acts
354,8,125.16266666666667,158.116,32.95333333333335,261,328,67,ki_chroma_acts
354,1,0.0,17.642666666666667,17.642666666666667,0,37,37,ki_chroma_acts_smoothed
354,2,17.642666666666667,46.44266666666667,28.8,37,97,60,ki_chroma_acts_smoothed
354,3,46.44266666666667,56.04266666666666,9.599999999999994,97,117,20,ki_chroma_acts_smoothed
354,4,56.04266666666666,63.72266666666666,7.68,117,133,16,ki_chroma_acts_smoothed
354,5,63.72266666666666,92.52266666666667,28.800000000000004,133,193,60,ki_chroma_acts_smoothed
354,6,92.52266666666667,107.88266666666667,15.36,193,225,32,ki_chroma_acts_smoothed
354,7,107.88266666666667,125.16266666666667,17.28,225,261,36,ki_chroma_acts_smoothed
354,8,125.16266666666667,158.116,32.95333333333335,261,328,67,ki_chroma_acts_smoothed
355,1,0.0,27.253333333333334,27.253333333333334,0,59,59,chromagram
355,2,27.253333333333334,30.069333333333333,2.815999999999999,59,65,6,chromagram
355,3,30.069333333333333,60.10666666666667,30.037333333333336,65,129,64,chromagram
355,4,60.10666666666667,72.30933333333333,12.202666666666659,129,155,26,chromagram
355,5,72.30933333333333,75.12533333333333,2.8160000000000025,155,161,6,chromagram
355,6,75.12533333333333,118.77333333333333,43.647999999999996,161,254,93,chromagram
355,7,118.77333333333333,143.17866666666666,24.40533333333333,254,306,52,chromagram
355,8,143.17866666666666,150.21866666666665,7.039999999999992,306,321,15,chromagram
355,9,150.21866666666665,191.179,40.96033333333335,321,407,86,chromagram
355,1,0.0,15.989333333333333,15.989333333333333,0,35,35,chroma_acts
355,2,15.989333333333333,27.253333333333334,11.264000000000001,35,59,24,chroma_acts
355,3,27.253333333333334,30.069333333333333,2.815999999999999,59,65,6,chroma_acts
355,4,30.069333333333333,61.04533333333333,30.976,65,131,66,chroma_acts
355,5,61.04533333333333,75.59466666666667,14.549333333333337,131,162,31,chroma_acts
355,6,75.59466666666667,120.18133333333333,44.58666666666666,162,257,95,chroma_acts
355,7,120.18133333333333,143.17866666666666,22.99733333333333,257,306,49,chroma_acts
355,8,143.17866666666666,150.21866666666665,7.039999999999992,306,321,15,chroma_acts
355,9,150.21866666666665,191.179,40.96033333333335,321,407,86,chroma_acts
355,1,0.0,15.989333333333333,15.989333333333333,0,35,35,chroma_acts_smoothed
355,2,15.989333333333333,30.069333333333333,14.08,35,65,30,chroma_acts_smoothed
355,3,30.069333333333333,61.04533333333333,30.976,65,131,66,chroma_acts_smoothed
355,4,61.04533333333333,71.84,10.794666666666672,131,154,23,chroma_acts_smoothed
355,5,71.84,75.59466666666667,3.7546666666666653,154,162,8,chroma_acts_smoothed
355,6,75.59466666666667,119.24266666666666,43.647999999999996,162,255,93,chroma_acts_smoothed
355,7,119.24266666666666,143.17866666666666,23.935999999999993,255,306,51,chroma_acts_smoothed
355,8,143.17866666666666,149.7493333333333,6.5706666666666536,306,320,14,chroma_acts_smoothed
355,9,149.7493333333333,191.179,41.42966666666669,320,407,87,chroma_acts_smoothed
355,1,0.0,27.253333333333334,27.253333333333334,0,59,59,ki_chroma
355,2,27.253333333333334,30.069333333333333,2.815999999999999,59,65,6,ki_chroma
355,3,30.069333333333333,60.10666666666667,30.037333333333336,65,129,64,ki_chroma
355,4,60.10666666666667,72.30933333333333,12.202666666666659,129,155,26,ki_chroma
355,5,72.30933333333333,75.12533333333333,2.8160000000000025,155,161,6,ki_chroma
355,6,75.12533333333333,118.77333333333333,43.647999999999996,161,254,93,ki_chroma
355,7,118.77333333333333,143.17866666666666,24.40533333333333,254,306,52,ki_chroma
355,8,143.17866666666666,150.21866666666665,7.039999999999992,306,321,15,ki_chroma
355,9,150.21866666666665,191.179,40.96033333333335,321,407,86,ki_chroma
355,1,0.0,15.989333333333333,15.989333333333333,0,35,35,ki_chroma_acts
355,2,15.989333333333333,27.253333333333334,11.264000000000001,35,59,24,ki_chroma_acts
355,3,27.253333333333334,30.069333333333333,2.815999999999999,59,65,6,ki_chroma_acts
355,4,30.069333333333333,61.04533333333333,30.976,65,131,66,ki_chroma_acts
355,5,61.04533333333333,75.59466666666667,14.549333333333337,131,162,31,ki_chroma_acts
355,6,75.59466666666667,120.18133333333333,44.58666666666666,162,257,95,ki_chroma_acts
355,7,120.18133333333333,143.17866666666666,22.99733333333333,257,306,49,ki_chroma_acts
355,8,143.17866666666666,150.21866666666665,7.039999999999992,306,321,15,ki_chroma_acts
355,9,150.21866666666665,191.179,40.96033333333335,321,407,86,ki_chroma_acts
355,1,0.0,15.989333333333333,15.989333333333333,0,35,35,ki_chroma_acts_smoothed
355,2,15.989333333333333,30.069333333333333,14.08,35,65,30,ki_chroma_acts_smoothed
355,3,30.069333333333333,61.04533333333333,30.976,65,131,66,ki_chroma_acts_smoothed
355,4,61.04533333333333,71.84,10.794666666666672,131,154,23,ki_chroma_acts_smoothed
355,5,71.84,75.59466666666667,3.7546666666666653,154,162,8,ki_chroma_acts_smoothed
355,6,75.59466666666667,119.24266666666666,43.647999999999996,162,255,93,ki_chroma_acts_smoothed
355,7,119.24266666666666,143.17866666666666,23.935999999999993,255,306,51,ki_chroma_acts_smoothed
355,8,143.17866666666666,149.7493333333333,6.5706666666666536,306,320,14,ki_chroma_acts_smoothed
355,9,149.7493333333333,191.179,41.42966666666669,320,407,87,ki_chroma_acts_smoothed
356,1,0.0,31.008000000000003,31.008000000000003,0,67,67,chromagram
356,2,31.008000000000003,59.63733333333333,28.629333333333328,67,128,61,chromagram
356,3,59.63733333333333,76.06400000000001,16.426666666666677,128,163,35,chromagram
356,4,76.06400000000001,106.57066666666667,30.50666666666666,163,228,65,chromagram
356,5,106.57066666666667,130.03733333333332,23.466666666666654,228,278,50,chromagram
356,6,130.03733333333332,143.648,13.610666666666674,278,307,29,chromagram
356,7,143.648,157.25866666666664,13.610666666666646,307,336,29,chromagram
356,8,157.25866666666664,158.19733333333332,0.938666666666677,336,338,2,chromagram
356,9,158.19733333333332,190.781,32.58366666666669,338,406,68,chromagram
356,1,0.0,17.866666666666667,17.866666666666667,0,39,39,chroma_acts
356,2,17.866666666666667,31.008000000000003,13.141333333333336,39,67,28,chroma_acts
356,3,31.008000000000003,59.63733333333333,28.629333333333328,67,128,61,chroma_acts
356,4,59.63733333333333,76.06400000000001,16.426666666666677,128,163,35,chroma_acts
356,5,76.06400000000001,106.57066666666667,30.50666666666666,163,228,65,chroma_acts
356,6,106.57066666666667,126.752,20.181333333333328,228,271,43,chroma_acts
356,7,126.752,144.1173333333333,17.36533333333331,271,308,37,chroma_acts
356,8,144.1173333333333,158.66666666666666,14.549333333333351,308,339,31,chroma_acts
356,9,158.66666666666666,190.781,32.11433333333335,339,406,67,chroma_acts
356,1,0.0,17.866666666666667,17.866666666666667,0,39,39,chroma_acts_smoothed
356,2,17.866666666666667,31.008000000000003,13.141333333333336,39,67,28,chroma_acts_smoothed
356,3,31.008000000000003,59.168,28.159999999999997,67,127,60,chroma_acts_smoothed
356,4,59.168,74.656,15.488000000000007,127,160,33,chroma_acts_smoothed
356,5,74.656,106.57066666666667,31.914666666666662,160,228,68,chroma_acts_smoothed
356,6,106.57066666666667,126.752,20.181333333333328,228,271,43,chroma_acts_smoothed
356,7,126.752,144.1173333333333,17.36533333333331,271,308,37,chroma_acts_smoothed
356,8,144.1173333333333,158.66666666666666,14.549333333333351,308,339,31,chroma_acts_smoothed
356,9,158.66666666666666,190.781,32.11433333333335,339,406,67,chroma_acts_smoothed
356,1,0.0,31.008000000000003,31.008000000000003,0,67,67,ki_chroma
356,2,31.008000000000003,59.63733333333333,28.629333333333328,67,128,61,ki_chroma
356,3,59.63733333333333,76.06400000000001,16.426666666666677,128,163,35,ki_chroma
356,4,76.06400000000001,106.57066666666667,30.50666666666666,163,228,65,ki_chroma
356,5,106.57066666666667,130.03733333333332,23.466666666666654,228,278,50,ki_chroma
356,6,130.03733333333332,143.648,13.610666666666674,278,307,29,ki_chroma
356,7,143.648,157.25866666666664,13.610666666666646,307,336,29,ki_chroma
356,8,157.25866666666664,158.19733333333332,0.938666666666677,336,338,2,ki_chroma
356,9,158.19733333333332,190.781,32.58366666666669,338,406,68,ki_chroma
356,1,0.0,17.866666666666667,17.866666666666667,0,39,39,ki_chroma_acts
356,2,17.866666666666667,31.008000000000003,13.141333333333336,39,67,28,ki_chroma_acts
356,3,31.008000000000003,59.63733333333333,28.629333333333328,67,128,61,ki_chroma_acts
356,4,59.63733333333333,76.06400000000001,16.426666666666677,128,163,35,ki_chroma_acts
356,5,76.06400000000001,106.57066666666667,30.50666666666666,163,228,65,ki_chroma_acts
356,6,106.57066666666667,126.752,20.181333333333328,228,271,43,ki_chroma_acts
356,7,126.752,144.1173333333333,17.36533333333331,271,308,37,ki_chroma_acts
356,8,144.1173333333333,158.66666666666666,14.549333333333351,308,339,31,ki_chroma_acts
356,9,158.66666666666666,190.781,32.11433333333335,339,406,67,ki_chroma_acts
356,1,0.0,17.866666666666667,17.866666666666667,0,39,39,ki_chroma_acts_smoothed
356,2,17.866666666666667,31.008000000000003,13.141333333333336,39,67,28,ki_chroma_acts_smoothed
356,3,31.008000000000003,59.168,28.159999999999997,67,127,60,ki_chroma_acts_smoothed
356,4,59.168,74.656,15.488000000000007,127,160,33,ki_chroma_acts_smoothed
356,5,74.656,106.57066666666667,31.914666666666662,160,228,68,ki_chroma_acts_smoothed
356,6,106.57066666666667,126.752,20.181333333333328,228,271,43,ki_chroma_acts_smoothed
356,7,126.752,144.1173333333333,17.36533333333331,271,308,37,ki_chroma_acts_smoothed
356,8,144.1173333333333,158.66666666666666,14.549333333333351,308,339,31,ki_chroma_acts_smoothed
356,9,158.66666666666666,190.781,32.11433333333335,339,406,67,ki_chroma_acts_smoothed
357,1,0.0,32.266666666666666,32.266666666666666,0,68,68,chromagram
357,2,32.266666666666666,77.38666666666667,45.120000000000005,68,162,94,chromagram
357,3,77.38666666666667,78.34666666666666,0.9599999999999937,162,164,2,chromagram
357,4,78.34666666666666,93.22666666666666,14.879999999999995,164,195,31,chromagram
357,5,93.22666666666666,125.86666666666666,32.64,195,263,68,chromagram
357,6,125.86666666666666,138.34666666666666,12.480000000000004,263,289,26,chromagram
357,7,138.34666666666666,140.74666666666664,2.3999999999999773,289,294,5,chromagram
357,8,140.74666666666664,189.274,48.52733333333336,294,394,100,chromagram
357,1,0.0,32.266666666666666,32.266666666666666,0,68,68,chroma_acts
357,2,32.266666666666666,77.38666666666667,45.120000000000005,68,162,94,chroma_acts
357,3,77.38666666666667,78.34666666666666,0.9599999999999937,162,164,2,chroma_acts
357,4,78.34666666666666,93.22666666666666,14.879999999999995,164,195,31,chroma_acts
357,5,93.22666666666666,125.86666666666666,32.64,195,263,68,chroma_acts
357,6,125.86666666666666,138.34666666666666,12.480000000000004,263,289,26,chroma_acts
357,7,138.34666666666666,140.74666666666664,2.3999999999999773,289,294,5,chroma_acts
357,8,140.74666666666664,189.274,48.52733333333336,294,394,100,chroma_acts
357,1,0.0,22.186666666666664,22.186666666666664,0,47,47,chroma_acts_smoothed
357,2,22.186666666666664,32.266666666666666,10.080000000000002,47,68,21,chroma_acts_smoothed
357,3,32.266666666666666,95.62666666666667,63.36,68,200,132,chroma_acts_smoothed
357,4,95.62666666666667,125.86666666666666,30.239999999999995,200,263,63,chroma_acts_smoothed
357,5,125.86666666666666,138.82666666666665,12.959999999999994,263,290,27,chroma_acts_smoothed
357,6,138.82666666666665,140.74666666666664,1.9199999999999875,290,294,4,chroma_acts_smoothed
357,7,140.74666666666664,189.274,48.52733333333336,294,394,100,chroma_acts_smoothed
357,1,0.0,32.266666666666666,32.266666666666666,0,68,68,ki_chroma
357,2,32.266666666666666,77.38666666666667,45.120000000000005,68,162,94,ki_chroma
357,3,77.38666666666667,78.34666666666666,0.9599999999999937,162,164,2,ki_chroma
357,4,78.34666666666666,93.22666666666666,14.879999999999995,164,195,31,ki_chroma
357,5,93.22666666666666,125.86666666666666,32.64,195,263,68,ki_chroma
357,6,125.86666666666666,138.34666666666666,12.480000000000004,263,289,26,ki_chroma
357,7,138.34666666666666,140.74666666666664,2.3999999999999773,289,294,5,ki_chroma
357,8,140.74666666666664,189.274,48.52733333333336,294,394,100,ki_chroma
357,1,0.0,32.266666666666666,32.266666666666666,0,68,68,ki_chroma_acts
357,2,32.266666666666666,77.38666666666667,45.120000000000005,68,162,94,ki_chroma_acts
357,3,77.38666666666667,78.34666666666666,0.9599999999999937,162,164,2,ki_chroma_acts
357,4,78.34666666666666,93.22666666666666,14.879999999999995,164,195,31,ki_chroma_acts
357,5,93.22666666666666,125.86666666666666,32.64,195,263,68,ki_chroma_acts
357,6,125.86666666666666,138.34666666666666,12.480000000000004,263,289,26,ki_chroma_acts
357,7,138.34666666666666,140.74666666666664,2.3999999999999773,289,294,5,ki_chroma_acts
357,8,140.74666666666664,189.274,48.52733333333336,294,394,100,ki_chroma_acts
357,1,0.0,22.186666666666664,22.186666666666664,0,47,47,ki_chroma_acts_smoothed
357,2,22.186666666666664,32.266666666666666,10.080000000000002,47,68,21,ki_chroma_acts_smoothed
357,3,32.266666666666666,95.62666666666667,63.36,68,200,132,ki_chroma_acts_smoothed
357,4,95.62666666666667,125.86666666666666,30.239999999999995,200,263,63,ki_chroma_acts_smoothed
357,5,125.86666666666666,138.82666666666665,12.959999999999994,263,290,27,ki_chroma_acts_smoothed
357,6,138.82666666666665,140.74666666666664,1.9199999999999875,290,294,4,ki_chroma_acts_smoothed
357,7,140.74666666666664,189.274,48.52733333333336,294,394,100,ki_chroma_acts_smoothed
358,1,0.0,15.061333333333334,15.061333333333334,0,33,33,chromagram
358,2,15.061333333333334,29.610666666666667,14.549333333333333,33,64,31,chromagram
358,3,29.610666666666667,60.117333333333335,30.506666666666668,64,129,65,chromagram
358,4,60.117333333333335,74.66666666666667,14.549333333333337,129,160,31,chromagram
358,5,74.66666666666667,103.29599999999999,28.62933333333332,160,221,61,chromagram
358,6,103.29599999999999,142.25066666666666,38.95466666666667,221,304,83,chromagram
358,7,142.25066666666666,149.76,7.5093333333333305,304,320,16,chromagram
358,8,149.76,172.75733333333332,22.99733333333333,320,369,49,chromagram
358,9,172.75733333333332,180.805,8.047666666666686,369,385,16,chromagram
358,1,0.0,15.061333333333334,15.061333333333334,0,33,33,chroma_acts
358,2,15.061333333333334,28.202666666666666,13.141333333333332,33,61,28,chroma_acts
358,3,28.202666666666666,60.586666666666666,32.384,61,130,69,chroma_acts
358,4,60.586666666666666,74.66666666666667,14.080000000000005,130,160,30,chroma_acts
358,5,74.66666666666667,105.64266666666667,30.976,160,226,66,chroma_acts
358,6,105.64266666666667,142.72,37.07733333333333,226,305,79,chroma_acts
358,7,142.72,149.76,7.039999999999992,305,320,15,chroma_acts
358,8,149.76,172.75733333333332,22.99733333333333,320,369,49,chroma_acts
358,9,172.75733333333332,180.805,8.047666666666686,369,385,16,chroma_acts
358,1,0.0,15.061333333333334,15.061333333333334,0,33,33,chroma_acts_smoothed
358,2,15.061333333333334,28.202666666666666,13.141333333333332,33,61,28,chroma_acts_smoothed
358,3,28.202666666666666,60.586666666666666,32.384,61,130,69,chroma_acts_smoothed
358,4,60.586666666666666,74.66666666666667,14.080000000000005,130,160,30,chroma_acts_smoothed
358,5,74.66666666666667,105.64266666666667,30.976,160,226,66,chroma_acts_smoothed
358,6,105.64266666666667,142.25066666666666,36.60799999999999,226,304,78,chroma_acts_smoothed
358,7,142.25066666666666,149.76,7.5093333333333305,304,320,16,chroma_acts_smoothed
358,8,149.76,172.75733333333332,22.99733333333333,320,369,49,chroma_acts_smoothed
358,9,172.75733333333332,180.805,8.047666666666686,369,385,16,chroma_acts_smoothed
358,1,0.0,15.061333333333334,15.061333333333334,0,33,33,ki_chroma
358,2,15.061333333333334,29.610666666666667,14.549333333333333,33,64,31,ki_chroma
358,3,29.610666666666667,60.117333333333335,30.506666666666668,64,129,65,ki_chroma
358,4,60.117333333333335,74.66666666666667,14.549333333333337,129,160,31,ki_chroma
358,5,74.66666666666667,103.29599999999999,28.62933333333332,160,221,61,ki_chroma
358,6,103.29599999999999,142.25066666666666,38.95466666666667,221,304,83,ki_chroma
358,7,142.25066666666666,149.76,7.5093333333333305,304,320,16,ki_chroma
358,8,149.76,172.75733333333332,22.99733333333333,320,369,49,ki_chroma
358,9,172.75733333333332,180.805,8.047666666666686,369,385,16,ki_chroma
358,1,0.0,15.061333333333334,15.061333333333334,0,33,33,ki_chroma_acts
358,2,15.061333333333334,28.202666666666666,13.141333333333332,33,61,28,ki_chroma_acts
358,3,28.202666666666666,60.586666666666666,32.384,61,130,69,ki_chroma_acts
358,4,60.586666666666666,74.66666666666667,14.080000000000005,130,160,30,ki_chroma_acts
358,5,74.66666666666667,105.64266666666667,30.976,160,226,66,ki_chroma_acts
358,6,105.64266666666667,142.72,37.07733333333333,226,305,79,ki_chroma_acts
358,7,142.72,149.76,7.039999999999992,305,320,15,ki_chroma_acts
358,8,149.76,172.75733333333332,22.99733333333333,320,369,49,ki_chroma_acts
358,9,172.75733333333332,180.805,8.047666666666686,369,385,16,ki_chroma_acts
358,1,0.0,15.061333333333334,15.061333333333334,0,33,33,ki_chroma_acts_smoothed
358,2,15.061333333333334,28.202666666666666,13.141333333333332,33,61,28,ki_chroma_acts_smoothed
358,3,28.202666666666666,60.586666666666666,32.384,61,130,69,ki_chroma_acts_smoothed
358,4,60.586666666666666,74.66666666666667,14.080000000000005,130,160,30,ki_chroma_acts_smoothed
358,5,74.66666666666667,105.64266666666667,30.976,160,226,66,ki_chroma_acts_smoothed
358,6,105.64266666666667,142.25066666666666,36.60799999999999,226,304,78,ki_chroma_acts_smoothed
358,7,142.25066666666666,149.76,7.5093333333333305,304,320,16,ki_chroma_acts_smoothed
358,8,149.76,172.75733333333332,22.99733333333333,320,369,49,ki_chroma_acts_smoothed
358,9,172.75733333333332,180.805,8.047666666666686,369,385,16,ki_chroma_acts_smoothed
360,1,0.0,15.701333333333332,15.701333333333332,0,32,32,chromagram
360,2,15.701333333333332,61.82399999999999,46.12266666666666,32,124,92,chromagram
360,3,61.82399999999999,72.85333333333332,11.029333333333334,124,146,22,chromagram
360,4,72.85333333333332,109.95199999999998,37.09866666666666,146,220,74,chromagram
360,5,109.95199999999998,115.46666666666665,5.51466666666667,220,231,11,chromagram
360,6,115.46666666666665,116.46933333333332,1.00266666666667,231,233,2,chromagram
360,7,116.46933333333332,172.306,55.83666666666669,233,343,110,chromagram
360,1,0.0,4.672,4.672,0,10,10,chroma_acts
360,2,4.672,15.701333333333332,11.029333333333334,10,32,22,chroma_acts
360,3,15.701333333333332,65.83466666666666,50.13333333333333,32,132,100,chroma_acts
360,4,65.83466666666666,109.95199999999998,44.11733333333332,132,220,88,chroma_acts
360,5,109.95199999999998,112.96,3.0080000000000098,220,226,6,chroma_acts
360,6,112.96,116.46933333333332,3.5093333333333305,226,233,7,chroma_acts
360,7,116.46933333333332,172.306,55.83666666666669,233,343,110,chroma_acts
360,1,0.0,11.690666666666665,11.690666666666665,0,24,24,chroma_acts_smoothed
360,2,11.690666666666665,15.701333333333332,4.010666666666667,24,32,8,chroma_acts_smoothed
360,3,15.701333333333332,61.82399999999999,46.12266666666666,32,124,92,chroma_acts_smoothed
360,4,61.82399999999999,81.87733333333333,20.053333333333335,124,164,40,chroma_acts_smoothed
360,5,81.87733333333333,109.95199999999998,28.07466666666666,164,220,56,chroma_acts_smoothed
360,6,109.95199999999998,112.96,3.0080000000000098,220,226,6,chroma_acts_smoothed
360,7,112.96,116.46933333333332,3.5093333333333305,226,233,7,chroma_acts_smoothed
360,8,116.46933333333332,164.09599999999998,47.62666666666665,233,328,95,chroma_acts_smoothed
360,9,164.09599999999998,172.306,8.210000000000036,328,343,15,chroma_acts_smoothed
360,1,0.0,15.701333333333332,15.701333333333332,0,32,32,ki_chroma
360,2,15.701333333333332,61.82399999999999,46.12266666666666,32,124,92,ki_chroma
360,3,61.82399999999999,72.85333333333332,11.029333333333334,124,146,22,ki_chroma
360,4,72.85333333333332,109.95199999999998,37.09866666666666,146,220,74,ki_chroma
360,5,109.95199999999998,115.46666666666665,5.51466666666667,220,231,11,ki_chroma
360,6,115.46666666666665,116.46933333333332,1.00266666666667,231,233,2,ki_chroma
360,7,116.46933333333332,172.306,55.83666666666669,233,343,110,ki_chroma
360,1,0.0,4.672,4.672,0,10,10,ki_chroma_acts
360,2,4.672,15.701333333333332,11.029333333333334,10,32,22,ki_chroma_acts
360,3,15.701333333333332,65.83466666666666,50.13333333333333,32,132,100,ki_chroma_acts
360,4,65.83466666666666,109.95199999999998,44.11733333333332,132,220,88,ki_chroma_acts
360,5,109.95199999999998,112.96,3.0080000000000098,220,226,6,ki_chroma_acts
360,6,112.96,116.46933333333332,3.5093333333333305,226,233,7,ki_chroma_acts
360,7,116.46933333333332,172.306,55.83666666666669,233,343,110,ki_chroma_acts
360,1,0.0,11.690666666666665,11.690666666666665,0,24,24,ki_chroma_acts_smoothed
360,2,11.690666666666665,15.701333333333332,4.010666666666667,24,32,8,ki_chroma_acts_smoothed
360,3,15.701333333333332,61.82399999999999,46.12266666666666,32,124,92,ki_chroma_acts_smoothed
360,4,61.82399999999999,81.87733333333333,20.053333333333335,124,164,40,ki_chroma_acts_smoothed
360,5,81.87733333333333,109.95199999999998,28.07466666666666,164,220,56,ki_chroma_acts_smoothed
360,6,109.95199999999998,112.96,3.0080000000000098,220,226,6,ki_chroma_acts_smoothed
360,7,112.96,116.46933333333332,3.5093333333333305,226,233,7,ki_chroma_acts_smoothed
360,8,116.46933333333332,164.09599999999998,47.62666666666665,233,328,95,ki_chroma_acts_smoothed
360,9,164.09599999999998,172.306,8.210000000000036,328,343,15,ki_chroma_acts_smoothed
362,1,0.0,31.146666666666665,31.146666666666665,0,63,63,chromagram
362,2,31.146666666666665,174.02666666666667,142.88,63,348,285,chromagram
362,3,174.02666666666667,188.064,14.037333333333322,348,376,28,chromagram
362,4,188.064,191.57333333333332,3.5093333333333305,376,383,7,chromagram
362,5,191.57333333333332,195.584,4.01066666666668,383,391,8,chromagram
362,6,195.584,205.61066666666667,10.02666666666667,391,411,20,chromagram
362,7,205.61066666666667,207.61599999999999,2.0053333333333114,411,415,4,chromagram
362,8,207.61599999999999,223.15733333333333,15.541333333333341,415,446,31,chromagram
362,9,223.15733333333333,272.472,49.31466666666665,446,543,97,chromagram
362,1,0.0,31.146666666666665,31.146666666666665,0,63,63,chroma_acts
362,2,31.146666666666665,76.76799999999999,45.621333333333325,63,154,91,chroma_acts
362,3,76.76799999999999,79.77599999999998,3.0079999999999956,154,160,6,chroma_acts
362,4,79.77599999999998,174.02666666666667,94.25066666666669,160,348,188,chroma_acts
362,5,174.02666666666667,188.064,14.037333333333322,348,376,28,chroma_acts
362,6,188.064,191.57333333333332,3.5093333333333305,376,383,7,chroma_acts
362,7,191.57333333333332,195.584,4.01066666666668,383,391,8,chroma_acts
362,8,195.584,223.65866666666665,28.074666666666644,391,447,56,chroma_acts
362,9,223.65866666666665,272.472,48.81333333333333,447,543,96,chroma_acts
362,1,0.0,30.645333333333333,30.645333333333333,0,62,62,chroma_acts_smoothed
362,2,30.645333333333333,139.936,109.29066666666668,62,280,218,chroma_acts_smoothed
362,3,139.936,144.448,4.5120000000000005,280,289,9,chroma_acts_smoothed
362,4,144.448,173.52533333333332,29.077333333333314,289,347,58,chroma_acts_smoothed
362,5,173.52533333333332,195.584,22.05866666666668,347,391,44,chroma_acts_smoothed
362,6,195.584,220.14933333333332,24.565333333333314,391,440,49,chroma_acts_smoothed
362,7,220.14933333333332,240.20266666666666,20.05333333333334,440,480,40,chroma_acts_smoothed
362,8,240.20266666666666,272.472,32.26933333333332,480,543,63,chroma_acts_smoothed
362,1,0.0,31.146666666666665,31.146666666666665,0,63,63,ki_chroma
362,2,31.146666666666665,174.02666666666667,142.88,63,348,285,ki_chroma
362,3,174.02666666666667,188.064,14.037333333333322,348,376,28,ki_chroma
362,4,188.064,191.57333333333332,3.5093333333333305,376,383,7,ki_chroma
362,5,191.57333333333332,195.584,4.01066666666668,383,391,8,ki_chroma
362,6,195.584,205.61066666666667,10.02666666666667,391,411,20,ki_chroma
362,7,205.61066666666667,207.61599999999999,2.0053333333333114,411,415,4,ki_chroma
362,8,207.61599999999999,223.15733333333333,15.541333333333341,415,446,31,ki_chroma
362,9,223.15733333333333,272.472,49.31466666666665,446,543,97,ki_chroma
362,1,0.0,31.146666666666665,31.146666666666665,0,63,63,ki_chroma_acts
362,2,31.146666666666665,76.76799999999999,45.621333333333325,63,154,91,ki_chroma_acts
362,3,76.76799999999999,79.77599999999998,3.0079999999999956,154,160,6,ki_chroma_acts
362,4,79.77599999999998,174.02666666666667,94.25066666666669,160,348,188,ki_chroma_acts
362,5,174.02666666666667,188.064,14.037333333333322,348,376,28,ki_chroma_acts
362,6,188.064,191.57333333333332,3.5093333333333305,376,383,7,ki_chroma_acts
362,7,191.57333333333332,195.584,4.01066666666668,383,391,8,ki_chroma_acts
362,8,195.584,223.65866666666665,28.074666666666644,391,447,56,ki_chroma_acts
362,9,223.65866666666665,272.472,48.81333333333333,447,543,96,ki_chroma_acts
362,1,0.0,30.645333333333333,30.645333333333333,0,62,62,ki_chroma_acts_smoothed
362,2,30.645333333333333,139.936,109.29066666666668,62,280,218,ki_chroma_acts_smoothed
362,3,139.936,144.448,4.5120000000000005,280,289,9,ki_chroma_acts_smoothed
362,4,144.448,173.52533333333332,29.077333333333314,289,347,58,ki_chroma_acts_smoothed
362,5,173.52533333333332,195.584,22.05866666666668,347,391,44,ki_chroma_acts_smoothed
362,6,195.584,220.14933333333332,24.565333333333314,391,440,49,ki_chroma_acts_smoothed
362,7,220.14933333333332,240.20266666666666,20.05333333333334,440,480,40,ki_chroma_acts_smoothed
362,8,240.20266666666666,272.472,32.26933333333332,480,543,63,ki_chroma_acts_smoothed
363,1,0.0,21.152,21.152,0,44,44,chromagram
363,2,21.152,62.368,41.216,44,128,84,chromagram
363,3,62.368,92.78933333333333,30.42133333333333,128,190,62,chromagram
363,4,92.78933333333333,130.57066666666668,37.78133333333335,190,267,77,chromagram
363,5,130.57066666666668,158.5386666666667,27.968000000000018,267,324,57,chromagram
363,6,158.5386666666667,166.38933333333335,7.850666666666655,324,340,16,chromagram
363,7,166.38933333333335,176.2026666666667,9.813333333333333,340,360,20,chromagram
363,8,176.2026666666667,205.64266666666668,29.439999999999998,360,420,60,chromagram
363,9,205.64266666666668,221.726,16.083333333333314,420,451,31,chromagram
363,1,0.0,9.376000000000001,9.376000000000001,0,20,20,chroma_acts
363,2,9.376000000000001,29.493333333333336,20.117333333333335,20,61,41,chroma_acts
363,3,29.493333333333336,62.368,32.87466666666667,61,128,67,chroma_acts
363,4,62.368,96.71466666666667,34.34666666666667,128,198,70,chroma_acts
363,5,96.71466666666667,130.57066666666668,33.85600000000001,198,267,69,chroma_acts
363,6,130.57066666666668,160.50133333333335,29.930666666666667,267,328,61,chroma_acts
363,7,160.50133333333335,166.38933333333335,5.888000000000005,328,340,12,chroma_acts
363,8,166.38933333333335,206.13333333333335,39.744,340,421,81,chroma_acts
363,9,206.13333333333335,221.726,15.592666666666645,421,451,30,chroma_acts
363,1,0.0,9.376000000000001,9.376000000000001,0,20,20,chroma_acts_smoothed
363,2,9.376000000000001,29.00266666666667,19.62666666666667,20,60,40,chroma_acts_smoothed
363,3,29.00266666666667,62.368,33.36533333333333,60,128,68,chroma_acts_smoothed
363,4,62.368,96.71466666666667,34.34666666666667,128,198,70,chroma_acts_smoothed
363,5,96.71466666666667,130.57066666666668,33.85600000000001,198,267,69,chroma_acts_smoothed
363,6,130.57066666666668,160.50133333333335,29.930666666666667,267,328,61,chroma_acts_smoothed
363,7,160.50133333333335,176.2026666666667,15.701333333333338,328,360,32,chroma_acts_smoothed
363,8,176.2026666666667,206.13333333333335,29.930666666666667,360,421,61,chroma_acts_smoothed
363,9,206.13333333333335,221.726,15.592666666666645,421,451,30,chroma_acts_smoothed
363,1,0.0,21.152,21.152,0,44,44,ki_chroma
363,2,21.152,62.368,41.216,44,128,84,ki_chroma
363,3,62.368,92.78933333333333,30.42133333333333,128,190,62,ki_chroma
363,4,92.78933333333333,130.57066666666668,37.78133333333335,190,267,77,ki_chroma
363,5,130.57066666666668,158.5386666666667,27.968000000000018,267,324,57,ki_chroma
363,6,158.5386666666667,166.38933333333335,7.850666666666655,324,340,16,ki_chroma
363,7,166.38933333333335,176.2026666666667,9.813333333333333,340,360,20,ki_chroma
363,8,176.2026666666667,205.64266666666668,29.439999999999998,360,420,60,ki_chroma
363,9,205.64266666666668,221.726,16.083333333333314,420,451,31,ki_chroma
363,1,0.0,9.376000000000001,9.376000000000001,0,20,20,ki_chroma_acts
363,2,9.376000000000001,29.493333333333336,20.117333333333335,20,61,41,ki_chroma_acts
363,3,29.493333333333336,62.368,32.87466666666667,61,128,67,ki_chroma_acts
363,4,62.368,96.71466666666667,34.34666666666667,128,198,70,ki_chroma_acts
363,5,96.71466666666667,130.57066666666668,33.85600000000001,198,267,69,ki_chroma_acts
363,6,130.57066666666668,160.50133333333335,29.930666666666667,267,328,61,ki_chroma_acts
363,7,160.50133333333335,166.38933333333335,5.888000000000005,328,340,12,ki_chroma_acts
363,8,166.38933333333335,206.13333333333335,39.744,340,421,81,ki_chroma_acts
363,9,206.13333333333335,221.726,15.592666666666645,421,451,30,ki_chroma_acts
363,1,0.0,9.376000000000001,9.376000000000001,0,20,20,ki_chroma_acts_smoothed
363,2,9.376000000000001,29.00266666666667,19.62666666666667,20,60,40,ki_chroma_acts_smoothed
363,3,29.00266666666667,62.368,33.36533333333333,60,128,68,ki_chroma_acts_smoothed
363,4,62.368,96.71466666666667,34.34666666666667,128,198,70,ki_chroma_acts_smoothed
363,5,96.71466666666667,130.57066666666668,33.85600000000001,198,267,69,ki_chroma_acts_smoothed
363,6,130.57066666666668,160.50133333333335,29.930666666666667,267,328,61,ki_chroma_acts_smoothed
363,7,160.50133333333335,176.2026666666667,15.701333333333338,328,360,32,ki_chroma_acts_smoothed
363,8,176.2026666666667,206.13333333333335,29.930666666666667,360,421,61,ki_chroma_acts_smoothed
363,9,206.13333333333335,221.726,15.592666666666645,421,451,30,ki_chroma_acts_smoothed
366,1,0.0,16.81066666666667,16.81066666666667,0,38,38,chromagram
366,2,16.81066666666667,29.80266666666667,12.992,38,67,29,chromagram
366,3,29.80266666666667,72.81066666666668,43.00800000000001,67,163,96,chromagram
366,4,72.81066666666668,77.73866666666667,4.927999999999997,163,174,11,chromagram
366,5,77.73866666666667,88.93866666666668,11.200000000000003,174,199,25,chromagram
366,6,88.93866666666668,106.41066666666669,17.47200000000001,199,238,39,chromagram
366,7,106.41066666666669,130.15466666666669,23.744,238,291,53,chromagram
366,8,130.15466666666669,163.623,33.468333333333305,291,364,73,chromagram
366,1,0.0,16.81066666666667,16.81066666666667,0,38,38,chroma_acts
366,2,16.81066666666667,29.80266666666667,12.992,38,67,29,chroma_acts
366,3,29.80266666666667,72.81066666666668,43.00800000000001,67,163,96,chroma_acts
366,4,72.81066666666668,77.29066666666668,4.480000000000004,163,173,10,chroma_acts
366,5,77.29066666666668,88.93866666666668,11.647999999999996,173,199,26,chroma_acts
366,6,88.93866666666668,105.51466666666668,16.576000000000008,199,236,37,chroma_acts
366,7,105.51466666666668,130.15466666666669,24.64,236,291,55,chroma_acts
366,8,130.15466666666669,163.623,33.468333333333305,291,364,73,chroma_acts
366,1,0.0,16.81066666666667,16.81066666666667,0,38,38,chroma_acts_smoothed
366,2,16.81066666666667,29.80266666666667,12.992,38,67,29,chroma_acts_smoothed
366,3,29.80266666666667,73.25866666666667,43.456,67,164,97,chroma_acts_smoothed
366,4,73.25866666666667,77.29066666666668,4.032000000000011,164,173,9,chroma_acts_smoothed
366,5,77.29066666666668,88.93866666666668,11.647999999999996,173,199,26,chroma_acts_smoothed
366,6,88.93866666666668,105.96266666666668,17.024,199,237,38,chroma_acts_smoothed
366,7,105.96266666666668,130.15466666666669,24.192000000000007,237,291,54,chroma_acts_smoothed
366,8,130.15466666666669,163.623,33.468333333333305,291,364,73,chroma_acts_smoothed
366,1,0.0,16.81066666666667,16.81066666666667,0,38,38,ki_chroma
366,2,16.81066666666667,29.80266666666667,12.992,38,67,29,ki_chroma
366,3,29.80266666666667,72.81066666666668,43.00800000000001,67,163,96,ki_chroma
366,4,72.81066666666668,77.73866666666667,4.927999999999997,163,174,11,ki_chroma
366,5,77.73866666666667,88.93866666666668,11.200000000000003,174,199,25,ki_chroma
366,6,88.93866666666668,106.41066666666669,17.47200000000001,199,238,39,ki_chroma
366,7,106.41066666666669,130.15466666666669,23.744,238,291,53,ki_chroma
366,8,130.15466666666669,163.623,33.468333333333305,291,364,73,ki_chroma
366,1,0.0,16.81066666666667,16.81066666666667,0,38,38,ki_chroma_acts
366,2,16.81066666666667,29.80266666666667,12.992,38,67,29,ki_chroma_acts
366,3,29.80266666666667,72.81066666666668,43.00800000000001,67,163,96,ki_chroma_acts
366,4,72.81066666666668,77.29066666666668,4.480000000000004,163,173,10,ki_chroma_acts
366,5,77.29066666666668,88.93866666666668,11.647999999999996,173,199,26,ki_chroma_acts
366,6,88.93866666666668,105.51466666666668,16.576000000000008,199,236,37,ki_chroma_acts
366,7,105.51466666666668,130.15466666666669,24.64,236,291,55,ki_chroma_acts
366,8,130.15466666666669,163.623,33.468333333333305,291,364,73,ki_chroma_acts
366,1,0.0,16.81066666666667,16.81066666666667,0,38,38,ki_chroma_acts_smoothed
366,2,16.81066666666667,29.80266666666667,12.992,38,67,29,ki_chroma_acts_smoothed
366,3,29.80266666666667,73.25866666666667,43.456,67,164,97,ki_chroma_acts_smoothed
366,4,73.25866666666667,77.29066666666668,4.032000000000011,164,173,9,ki_chroma_acts_smoothed
366,5,77.29066666666668,88.93866666666668,11.647999999999996,173,199,26,ki_chroma_acts_smoothed
366,6,88.93866666666668,105.96266666666668,17.024,199,237,38,ki_chroma_acts_smoothed
366,7,105.96266666666668,130.15466666666669,24.192000000000007,237,291,54,ki_chroma_acts_smoothed
366,8,130.15466666666669,163.623,33.468333333333305,291,364,73,ki_chroma_acts_smoothed
367,1,0.0,6.837333333333334,6.837333333333334,0,16,16,chromagram
367,2,6.837333333333334,21.62133333333334,14.784000000000006,16,49,33,chromagram
367,3,21.62133333333334,35.50933333333334,13.887999999999998,49,80,31,chromagram
367,4,35.50933333333334,63.73333333333334,28.224000000000004,80,143,63,chromagram
367,5,63.73333333333334,96.43733333333334,32.704,143,216,73,chromagram
367,6,96.43733333333334,100.91733333333335,4.480000000000004,216,226,10,chromagram
367,7,100.91733333333335,103.60533333333335,2.6880000000000024,226,232,6,chromagram
367,8,103.60533333333335,150.448,46.84266666666666,232,335,103,chromagram
367,1,0.0,6.837333333333334,6.837333333333334,0,16,16,chroma_acts
367,2,6.837333333333334,21.62133333333334,14.784000000000006,16,49,33,chroma_acts
367,3,21.62133333333334,35.50933333333334,13.887999999999998,49,80,31,chroma_acts
367,4,35.50933333333334,63.73333333333334,28.224000000000004,80,143,63,chroma_acts
367,5,63.73333333333334,100.46933333333335,36.73600000000001,143,225,82,chroma_acts
367,6,100.46933333333335,103.60533333333335,3.1359999999999957,225,232,7,chroma_acts
367,7,103.60533333333335,107.18933333333335,3.584000000000003,232,240,8,chroma_acts
367,8,107.18933333333335,150.448,43.258666666666656,240,335,95,chroma_acts
367,1,0.0,7.285333333333335,7.285333333333335,0,17,17,chroma_acts_smoothed
367,2,7.285333333333335,21.62133333333334,14.336000000000006,17,49,32,chroma_acts_smoothed
367,3,21.62133333333334,35.50933333333334,13.887999999999998,49,80,31,chroma_acts_smoothed
367,4,35.50933333333334,63.28533333333334,27.776000000000003,80,142,62,chroma_acts_smoothed
367,5,63.28533333333334,100.91733333333335,37.632000000000005,142,226,84,chroma_acts_smoothed
367,6,100.91733333333335,103.60533333333335,2.6880000000000024,226,232,6,chroma_acts_smoothed
367,7,103.60533333333335,107.63733333333334,4.0319999999999965,232,241,9,chroma_acts_smoothed
367,8,107.63733333333334,150.448,42.81066666666666,241,335,94,chroma_acts_smoothed
367,1,0.0,6.837333333333334,6.837333333333334,0,16,16,ki_chroma
367,2,6.837333333333334,21.62133333333334,14.784000000000006,16,49,33,ki_chroma
367,3,21.62133333333334,35.50933333333334,13.887999999999998,49,80,31,ki_chroma
367,4,35.50933333333334,63.73333333333334,28.224000000000004,80,143,63,ki_chroma
367,5,63.73333333333334,96.43733333333334,32.704,143,216,73,ki_chroma
367,6,96.43733333333334,100.91733333333335,4.480000000000004,216,226,10,ki_chroma
367,7,100.91733333333335,103.60533333333335,2.6880000000000024,226,232,6,ki_chroma
367,8,103.60533333333335,150.448,46.84266666666666,232,335,103,ki_chroma
367,1,0.0,6.837333333333334,6.837333333333334,0,16,16,ki_chroma_acts
367,2,6.837333333333334,21.62133333333334,14.784000000000006,16,49,33,ki_chroma_acts
367,3,21.62133333333334,35.50933333333334,13.887999999999998,49,80,31,ki_chroma_acts
367,4,35.50933333333334,63.73333333333334,28.224000000000004,80,143,63,ki_chroma_acts
367,5,63.73333333333334,100.46933333333335,36.73600000000001,143,225,82,ki_chroma_acts
367,6,100.46933333333335,103.60533333333335,3.1359999999999957,225,232,7,ki_chroma_acts
367,7,103.60533333333335,107.18933333333335,3.584000000000003,232,240,8,ki_chroma_acts
367,8,107.18933333333335,150.448,43.258666666666656,240,335,95,ki_chroma_acts
367,1,0.0,7.285333333333335,7.285333333333335,0,17,17,ki_chroma_acts_smoothed
367,2,7.285333333333335,21.62133333333334,14.336000000000006,17,49,32,ki_chroma_acts_smoothed
367,3,21.62133333333334,35.50933333333334,13.887999999999998,49,80,31,ki_chroma_acts_smoothed
367,4,35.50933333333334,63.28533333333334,27.776000000000003,80,142,62,ki_chroma_acts_smoothed
367,5,63.28533333333334,100.91733333333335,37.632000000000005,142,226,84,ki_chroma_acts_smoothed
367,6,100.91733333333335,103.60533333333335,2.6880000000000024,226,232,6,ki_chroma_acts_smoothed
367,7,103.60533333333335,107.63733333333334,4.0319999999999965,232,241,9,ki_chroma_acts_smoothed
367,8,107.63733333333334,150.448,42.81066666666666,241,335,94,ki_chroma_acts_smoothed
368,1,0.0,7.712,7.712,0,17,17,chromagram
368,2,7.712,21.152,13.440000000000001,17,45,28,chromagram
368,3,21.152,53.792,32.64,45,113,68,chromagram
368,4,53.792,113.312,59.519999999999996,113,237,124,chromagram
368,5,113.312,119.072,5.760000000000005,237,249,12,chromagram
368,6,119.072,122.91199999999999,3.839999999999989,249,257,8,chromagram
368,7,122.91199999999999,145.952,23.040000000000006,257,305,48,chromagram
368,8,145.952,210.733,64.781,305,438,133,chromagram
368,1,0.0,7.712,7.712,0,17,17,chroma_acts
368,2,7.712,21.152,13.440000000000001,17,45,28,chroma_acts
368,3,21.152,53.792,32.64,45,113,68,chroma_acts
368,4,53.792,57.152,3.3599999999999994,113,120,7,chroma_acts
368,5,57.152,113.312,56.16,120,237,117,chroma_acts
368,6,113.312,145.952,32.64,237,305,68,chroma_acts
368,7,145.952,172.352,26.400000000000006,305,360,55,chroma_acts
368,8,172.352,210.733,38.381,360,438,78,chroma_acts
368,1,0.0,7.231999999999999,7.231999999999999,0,16,16,chroma_acts_smoothed
368,2,7.231999999999999,21.152,13.920000000000002,16,45,29,chroma_acts_smoothed
368,3,21.152,53.792,32.64,45,113,68,chroma_acts_smoothed
368,4,53.792,113.312,59.519999999999996,113,237,124,chroma_acts_smoothed
368,5,113.312,122.91199999999999,9.599999999999994,237,257,20,chroma_acts_smoothed
368,6,122.91199999999999,145.952,23.040000000000006,257,305,48,chroma_acts_smoothed
368,7,145.952,172.352,26.400000000000006,305,360,55,chroma_acts_smoothed
368,8,172.352,210.733,38.381,360,438,78,chroma_acts_smoothed
368,1,0.0,7.712,7.712,0,17,17,ki_chroma
368,2,7.712,21.152,13.440000000000001,17,45,28,ki_chroma
368,3,21.152,53.792,32.64,45,113,68,ki_chroma
368,4,53.792,113.312,59.519999999999996,113,237,124,ki_chroma
368,5,113.312,119.072,5.760000000000005,237,249,12,ki_chroma
368,6,119.072,122.91199999999999,3.839999999999989,249,257,8,ki_chroma
368,7,122.91199999999999,145.952,23.040000000000006,257,305,48,ki_chroma
368,8,145.952,210.733,64.781,305,438,133,ki_chroma
368,1,0.0,7.712,7.712,0,17,17,ki_chroma_acts
368,2,7.712,21.152,13.440000000000001,17,45,28,ki_chroma_acts
368,3,21.152,53.792,32.64,45,113,68,ki_chroma_acts
368,4,53.792,57.152,3.3599999999999994,113,120,7,ki_chroma_acts
368,5,57.152,113.312,56.16,120,237,117,ki_chroma_acts
368,6,113.312,145.952,32.64,237,305,68,ki_chroma_acts
368,7,145.952,172.352,26.400000000000006,305,360,55,ki_chroma_acts
368,8,172.352,210.733,38.381,360,438,78,ki_chroma_acts
368,1,0.0,7.231999999999999,7.231999999999999,0,16,16,ki_chroma_acts_smoothed
368,2,7.231999999999999,21.152,13.920000000000002,16,45,29,ki_chroma_acts_smoothed
368,3,21.152,53.792,32.64,45,113,68,ki_chroma_acts_smoothed
368,4,53.792,113.312,59.519999999999996,113,237,124,ki_chroma_acts_smoothed
368,5,113.312,122.91199999999999,9.599999999999994,237,257,20,ki_chroma_acts_smoothed
368,6,122.91199999999999,145.952,23.040000000000006,257,305,48,ki_chroma_acts_smoothed
368,7,145.952,172.352,26.400000000000006,305,360,55,ki_chroma_acts_smoothed
368,8,172.352,210.733,38.381,360,438,78,ki_chroma_acts_smoothed
370,1,0.0,31.605333333333334,31.605333333333334,0,66,66,chromagram
370,2,31.605333333333334,58.96533333333333,27.359999999999992,66,123,57,chromagram
370,3,58.96533333333333,94.00533333333333,35.04,123,196,73,chromagram
370,4,94.00533333333333,132.88533333333334,38.88000000000001,196,277,81,chromagram
370,5,132.88533333333334,159.76533333333333,26.879999999999995,277,333,56,chromagram
370,6,159.76533333333333,170.80533333333335,11.04000000000002,333,356,23,chromagram
370,7,170.80533333333335,202.48533333333333,31.67999999999998,356,422,66,chromagram
370,8,202.48533333333333,217.84533333333334,15.360000000000014,422,454,32,chromagram
370,9,217.84533333333334,296.045,78.19966666666667,454,615,161,chromagram
370,1,0.0,31.605333333333334,31.605333333333334,0,66,66,chroma_acts
370,2,31.605333333333334,62.80533333333333,31.199999999999996,66,131,65,chroma_acts
370,3,62.80533333333333,94.00533333333333,31.199999999999996,131,196,65,chroma_acts
370,4,94.00533333333333,132.88533333333334,38.88000000000001,196,277,81,chroma_acts
370,5,132.88533333333334,159.76533333333333,26.879999999999995,277,333,56,chroma_acts
370,6,159.76533333333333,202.48533333333333,42.72,333,422,89,chroma_acts
370,7,202.48533333333333,217.84533333333334,15.360000000000014,422,454,32,chroma_acts
370,8,217.84533333333334,279.76533333333333,61.91999999999999,454,583,129,chroma_acts
370,9,279.76533333333333,296.045,16.279666666666685,583,615,32,chroma_acts
370,1,0.0,31.605333333333334,31.605333333333334,0,66,66,chroma_acts_smoothed
370,2,31.605333333333334,63.28533333333333,31.679999999999993,66,132,66,chroma_acts_smoothed
370,3,63.28533333333333,94.00533333333333,30.72,132,196,64,chroma_acts_smoothed
370,4,94.00533333333333,132.88533333333334,38.88000000000001,196,277,81,chroma_acts_smoothed
370,5,132.88533333333334,159.76533333333333,26.879999999999995,277,333,56,chroma_acts_smoothed
370,6,159.76533333333333,202.00533333333334,42.24000000000001,333,421,88,chroma_acts_smoothed
370,7,202.00533333333334,217.84533333333334,15.840000000000003,421,454,33,chroma_acts_smoothed
370,8,217.84533333333334,279.76533333333333,61.91999999999999,454,583,129,chroma_acts_smoothed
370,9,279.76533333333333,296.045,16.279666666666685,583,615,32,chroma_acts_smoothed
370,1,0.0,31.605333333333334,31.605333333333334,0,66,66,ki_chroma
370,2,31.605333333333334,58.96533333333333,27.359999999999992,66,123,57,ki_chroma
370,3,58.96533333333333,94.00533333333333,35.04,123,196,73,ki_chroma
370,4,94.00533333333333,132.88533333333334,38.88000000000001,196,277,81,ki_chroma
370,5,132.88533333333334,159.76533333333333,26.879999999999995,277,333,56,ki_chroma
370,6,159.76533333333333,170.80533333333335,11.04000000000002,333,356,23,ki_chroma
370,7,170.80533333333335,202.48533333333333,31.67999999999998,356,422,66,ki_chroma
370,8,202.48533333333333,217.84533333333334,15.360000000000014,422,454,32,ki_chroma
370,9,217.84533333333334,296.045,78.19966666666667,454,615,161,ki_chroma
370,1,0.0,31.605333333333334,31.605333333333334,0,66,66,ki_chroma_acts
370,2,31.605333333333334,62.80533333333333,31.199999999999996,66,131,65,ki_chroma_acts
370,3,62.80533333333333,94.00533333333333,31.199999999999996,131,196,65,ki_chroma_acts
370,4,94.00533333333333,132.88533333333334,38.88000000000001,196,277,81,ki_chroma_acts
370,5,132.88533333333334,159.76533333333333,26.879999999999995,277,333,56,ki_chroma_acts
370,6,159.76533333333333,202.48533333333333,42.72,333,422,89,ki_chroma_acts
370,7,202.48533333333333,217.84533333333334,15.360000000000014,422,454,32,ki_chroma_acts
370,8,217.84533333333334,279.76533333333333,61.91999999999999,454,583,129,ki_chroma_acts
370,9,279.76533333333333,296.045,16.279666666666685,583,615,32,ki_chroma_acts
370,1,0.0,31.605333333333334,31.605333333333334,0,66,66,ki_chroma_acts_smoothed
370,2,31.605333333333334,63.28533333333333,31.679999999999993,66,132,66,ki_chroma_acts_smoothed
370,3,63.28533333333333,94.00533333333333,30.72,132,196,64,ki_chroma_acts_smoothed
370,4,94.00533333333333,132.88533333333334,38.88000000000001,196,277,81,ki_chroma_acts_smoothed
370,5,132.88533333333334,159.76533333333333,26.879999999999995,277,333,56,ki_chroma_acts_smoothed
370,6,159.76533333333333,202.00533333333334,42.24000000000001,333,421,88,ki_chroma_acts_smoothed
370,7,202.00533333333334,217.84533333333334,15.840000000000003,421,454,33,ki_chroma_acts_smoothed
370,8,217.84533333333334,279.76533333333333,61.91999999999999,454,583,129,ki_chroma_acts_smoothed
370,9,279.76533333333333,296.045,16.279666666666685,583,615,32,ki_chroma_acts_smoothed
371,1,0.0,14.687999999999999,14.687999999999999,0,31,31,chromagram
371,2,14.687999999999999,46.848,32.16,31,98,67,chromagram
371,3,46.848,61.248,14.399999999999999,98,128,30,chromagram
371,4,61.248,93.888,32.64000000000001,128,196,68,chromagram
371,5,93.888,98.208,4.319999999999993,196,205,9,chromagram
371,6,98.208,135.648,37.44,205,283,78,chromagram
371,7,135.648,139.00799999999998,3.359999999999985,283,290,7,chromagram
371,8,139.00799999999998,186.018,47.01000000000002,290,386,96,chromagram
371,1,0.0,14.687999999999999,14.687999999999999,0,31,31,chroma_acts
371,2,14.687999999999999,46.848,32.16,31,98,67,chroma_acts
371,3,46.848,93.408,46.56,98,195,97,chroma_acts
371,4,93.408,98.208,4.799999999999997,195,205,10,chroma_acts
371,5,98.208,131.808,33.599999999999994,205,275,70,chroma_acts
371,6,131.808,135.648,3.8400000000000034,275,283,8,chroma_acts
371,7,135.648,139.00799999999998,3.359999999999985,283,290,7,chroma_acts
371,8,139.00799999999998,186.018,47.01000000000002,290,386,96,chroma_acts
371,1,0.0,14.207999999999998,14.207999999999998,0,30,30,chroma_acts_smoothed
371,2,14.207999999999998,46.848,32.64,30,98,68,chroma_acts_smoothed
371,3,46.848,93.888,47.040000000000006,98,196,98,chroma_acts_smoothed
371,4,93.888,98.208,4.319999999999993,196,205,9,chroma_acts_smoothed
371,5,98.208,130.84799999999998,32.639999999999986,205,273,68,chroma_acts_smoothed
371,6,130.84799999999998,136.128,5.280000000000001,273,284,11,chroma_acts_smoothed
371,7,136.128,139.00799999999998,2.8799999999999955,284,290,6,chroma_acts_smoothed
371,8,139.00799999999998,186.018,47.01000000000002,290,386,96,chroma_acts_smoothed
371,1,0.0,14.687999999999999,14.687999999999999,0,31,31,ki_chroma
371,2,14.687999999999999,46.848,32.16,31,98,67,ki_chroma
371,3,46.848,61.248,14.399999999999999,98,128,30,ki_chroma
371,4,61.248,93.888,32.64000000000001,128,196,68,ki_chroma
371,5,93.888,98.208,4.319999999999993,196,205,9,ki_chroma
371,6,98.208,135.648,37.44,205,283,78,ki_chroma
371,7,135.648,139.00799999999998,3.359999999999985,283,290,7,ki_chroma
371,8,139.00799999999998,186.018,47.01000000000002,290,386,96,ki_chroma
371,1,0.0,14.687999999999999,14.687999999999999,0,31,31,ki_chroma_acts
371,2,14.687999999999999,46.848,32.16,31,98,67,ki_chroma_acts
371,3,46.848,93.408,46.56,98,195,97,ki_chroma_acts
371,4,93.408,98.208,4.799999999999997,195,205,10,ki_chroma_acts
371,5,98.208,131.808,33.599999999999994,205,275,70,ki_chroma_acts
371,6,131.808,135.648,3.8400000000000034,275,283,8,ki_chroma_acts
371,7,135.648,139.00799999999998,3.359999999999985,283,290,7,ki_chroma_acts
371,8,139.00799999999998,186.018,47.01000000000002,290,386,96,ki_chroma_acts
371,1,0.0,14.207999999999998,14.207999999999998,0,30,30,ki_chroma_acts_smoothed
371,2,14.207999999999998,46.848,32.64,30,98,68,ki_chroma_acts_smoothed
371,3,46.848,93.888,47.040000000000006,98,196,98,ki_chroma_acts_smoothed
371,4,93.888,98.208,4.319999999999993,196,205,9,ki_chroma_acts_smoothed
371,5,98.208,130.84799999999998,32.639999999999986,205,273,68,ki_chroma_acts_smoothed
371,6,130.84799999999998,136.128,5.280000000000001,273,284,11,ki_chroma_acts_smoothed
371,7,136.128,139.00799999999998,2.8799999999999955,284,290,6,ki_chroma_acts_smoothed
371,8,139.00799999999998,186.018,47.01000000000002,290,386,96,ki_chroma_acts_smoothed
372,1,0.0,5.578666666666666,5.578666666666666,0,13,13,chromagram
372,2,5.578666666666666,14.751999999999999,9.173333333333332,13,33,20,chromagram
372,3,14.751999999999999,42.730666666666664,27.978666666666665,33,94,61,chromagram
372,4,42.730666666666664,72.08533333333332,29.35466666666666,94,158,64,chromagram
372,5,72.08533333333332,105.10933333333331,33.02399999999999,158,230,72,chromagram
372,6,105.10933333333331,120.24533333333332,15.13600000000001,230,263,33,chromagram
372,7,120.24533333333332,127.12533333333332,6.8799999999999955,263,278,15,chromagram
372,8,127.12533333333332,164.27733333333333,37.152000000000015,278,359,81,chromagram
372,9,164.27733333333333,193.913,29.63566666666668,359,422,63,chromagram
372,1,0.0,5.578666666666666,5.578666666666666,0,13,13,chroma_acts
372,2,5.578666666666666,14.751999999999999,9.173333333333332,13,33,20,chroma_acts
372,3,14.751999999999999,42.730666666666664,27.978666666666665,33,94,61,chroma_acts
372,4,42.730666666666664,72.08533333333332,29.35466666666666,94,158,64,chroma_acts
372,5,72.08533333333332,105.10933333333331,33.02399999999999,158,230,72,chroma_acts
372,6,105.10933333333331,120.24533333333332,15.13600000000001,230,263,33,chroma_acts
372,7,120.24533333333332,127.12533333333332,6.8799999999999955,263,278,15,chroma_acts
372,8,127.12533333333332,164.27733333333333,37.152000000000015,278,359,81,chroma_acts
372,9,164.27733333333333,193.913,29.63566666666668,359,422,63,chroma_acts
372,1,0.0,5.578666666666666,5.578666666666666,0,13,13,chroma_acts_smoothed
372,2,5.578666666666666,15.210666666666665,9.631999999999998,13,34,21,chroma_acts_smoothed
372,3,15.210666666666665,42.730666666666664,27.52,34,94,60,chroma_acts_smoothed
372,4,42.730666666666664,72.08533333333332,29.35466666666666,94,158,64,chroma_acts_smoothed
372,5,72.08533333333332,104.65066666666665,32.56533333333333,158,229,71,chroma_acts_smoothed
372,6,104.65066666666665,120.70399999999998,16.053333333333327,229,264,35,chroma_acts_smoothed
372,7,120.70399999999998,127.12533333333332,6.421333333333337,264,278,14,chroma_acts_smoothed
372,8,127.12533333333332,164.27733333333333,37.152000000000015,278,359,81,chroma_acts_smoothed
372,9,164.27733333333333,193.913,29.63566666666668,359,422,63,chroma_acts_smoothed
372,1,0.0,5.578666666666666,5.578666666666666,0,13,13,ki_chroma
372,2,5.578666666666666,14.751999999999999,9.173333333333332,13,33,20,ki_chroma
372,3,14.751999999999999,42.730666666666664,27.978666666666665,33,94,61,ki_chroma
372,4,42.730666666666664,72.08533333333332,29.35466666666666,94,158,64,ki_chroma
372,5,72.08533333333332,105.10933333333331,33.02399999999999,158,230,72,ki_chroma
372,6,105.10933333333331,120.24533333333332,15.13600000000001,230,263,33,ki_chroma
372,7,120.24533333333332,127.12533333333332,6.8799999999999955,263,278,15,ki_chroma
372,8,127.12533333333332,164.27733333333333,37.152000000000015,278,359,81,ki_chroma
372,9,164.27733333333333,193.913,29.63566666666668,359,422,63,ki_chroma
372,1,0.0,5.578666666666666,5.578666666666666,0,13,13,ki_chroma_acts
372,2,5.578666666666666,14.751999999999999,9.173333333333332,13,33,20,ki_chroma_acts
372,3,14.751999999999999,42.730666666666664,27.978666666666665,33,94,61,ki_chroma_acts
372,4,42.730666666666664,72.08533333333332,29.35466666666666,94,158,64,ki_chroma_acts
372,5,72.08533333333332,105.10933333333331,33.02399999999999,158,230,72,ki_chroma_acts
372,6,105.10933333333331,120.24533333333332,15.13600000000001,230,263,33,ki_chroma_acts
372,7,120.24533333333332,127.12533333333332,6.8799999999999955,263,278,15,ki_chroma_acts
372,8,127.12533333333332,164.27733333333333,37.152000000000015,278,359,81,ki_chroma_acts
372,9,164.27733333333333,193.913,29.63566666666668,359,422,63,ki_chroma_acts
372,1,0.0,5.578666666666666,5.578666666666666,0,13,13,ki_chroma_acts_smoothed
372,2,5.578666666666666,15.210666666666665,9.631999999999998,13,34,21,ki_chroma_acts_smoothed
372,3,15.210666666666665,42.730666666666664,27.52,34,94,60,ki_chroma_acts_smoothed
372,4,42.730666666666664,72.08533333333332,29.35466666666666,94,158,64,ki_chroma_acts_smoothed
372,5,72.08533333333332,104.65066666666665,32.56533333333333,158,229,71,ki_chroma_acts_smoothed
372,6,104.65066666666665,120.70399999999998,16.053333333333327,229,264,35,ki_chroma_acts_smoothed
372,7,120.70399999999998,127.12533333333332,6.421333333333337,264,278,14,ki_chroma_acts_smoothed
372,8,127.12533333333332,164.27733333333333,37.152000000000015,278,359,81,ki_chroma_acts_smoothed
372,9,164.27733333333333,193.913,29.63566666666668,359,422,63,ki_chroma_acts_smoothed
374,1,0.0,7.445333333333333,7.445333333333333,0,16,16,chromagram
374,2,7.445333333333333,30.485333333333333,23.04,16,64,48,chromagram
374,3,30.485333333333333,59.76533333333333,29.279999999999998,64,125,61,chromagram
374,4,59.76533333333333,62.64533333333333,2.8800000000000026,125,131,6,chromagram
374,5,62.64533333333333,66.48533333333333,3.8399999999999963,131,139,8,chromagram
374,6,66.48533333333333,70.32533333333333,3.8400000000000034,139,147,8,chromagram
374,7,70.32533333333333,74.16533333333334,3.8400000000000034,147,155,8,chromagram
374,8,74.16533333333334,91.44533333333334,17.28,155,191,36,chromagram
374,9,91.44533333333334,121.887,30.441666666666663,191,253,62,chromagram
374,1,0.0,30.005333333333333,30.005333333333333,0,63,63,chroma_acts
374,2,30.005333333333333,59.76533333333333,29.759999999999998,63,125,62,chroma_acts
374,3,59.76533333333333,62.64533333333333,2.8800000000000026,125,131,6,chroma_acts
374,4,62.64533333333333,66.96533333333333,4.32,131,140,9,chroma_acts
374,5,66.96533333333333,70.32533333333333,3.3599999999999994,140,147,7,chroma_acts
374,6,70.32533333333333,74.16533333333334,3.8400000000000034,147,155,8,chroma_acts
374,7,74.16533333333334,93.36533333333334,19.200000000000003,155,195,40,chroma_acts
374,8,93.36533333333334,121.887,28.52166666666666,195,253,58,chroma_acts
374,1,0.0,13.205333333333332,13.205333333333332,0,28,28,chroma_acts_smoothed
374,2,13.205333333333332,30.005333333333333,16.8,28,63,35,chroma_acts_smoothed
374,3,30.005333333333333,59.76533333333333,29.759999999999998,63,125,62,chroma_acts_smoothed
374,4,59.76533333333333,62.64533333333333,2.8800000000000026,125,131,6,chroma_acts_smoothed
374,5,62.64533333333333,66.48533333333333,3.8399999999999963,131,139,8,chroma_acts_smoothed
374,6,66.48533333333333,70.32533333333333,3.8400000000000034,139,147,8,chroma_acts_smoothed
374,7,70.32533333333333,74.16533333333334,3.8400000000000034,147,155,8,chroma_acts_smoothed
374,8,74.16533333333334,92.88533333333334,18.72,155,194,39,chroma_acts_smoothed
374,9,92.88533333333334,121.887,29.001666666666665,194,253,59,chroma_acts_smoothed
374,1,0.0,7.445333333333333,7.445333333333333,0,16,16,ki_chroma
374,2,7.445333333333333,30.485333333333333,23.04,16,64,48,ki_chroma
374,3,30.485333333333333,59.76533333333333,29.279999999999998,64,125,61,ki_chroma
374,4,59.76533333333333,62.64533333333333,2.8800000000000026,125,131,6,ki_chroma
374,5,62.64533333333333,66.48533333333333,3.8399999999999963,131,139,8,ki_chroma
374,6,66.48533333333333,70.32533333333333,3.8400000000000034,139,147,8,ki_chroma
374,7,70.32533333333333,74.16533333333334,3.8400000000000034,147,155,8,ki_chroma
374,8,74.16533333333334,91.44533333333334,17.28,155,191,36,ki_chroma
374,9,91.44533333333334,121.887,30.441666666666663,191,253,62,ki_chroma
374,1,0.0,30.005333333333333,30.005333333333333,0,63,63,ki_chroma_acts
374,2,30.005333333333333,59.76533333333333,29.759999999999998,63,125,62,ki_chroma_acts
374,3,59.76533333333333,62.64533333333333,2.8800000000000026,125,131,6,ki_chroma_acts
374,4,62.64533333333333,66.96533333333333,4.32,131,140,9,ki_chroma_acts
374,5,66.96533333333333,70.32533333333333,3.3599999999999994,140,147,7,ki_chroma_acts
374,6,70.32533333333333,74.16533333333334,3.8400000000000034,147,155,8,ki_chroma_acts
374,7,74.16533333333334,93.36533333333334,19.200000000000003,155,195,40,ki_chroma_acts
374,8,93.36533333333334,121.887,28.52166666666666,195,253,58,ki_chroma_acts
374,1,0.0,13.205333333333332,13.205333333333332,0,28,28,ki_chroma_acts_smoothed
374,2,13.205333333333332,30.005333333333333,16.8,28,63,35,ki_chroma_acts_smoothed
374,3,30.005333333333333,59.76533333333333,29.759999999999998,63,125,62,ki_chroma_acts_smoothed
374,4,59.76533333333333,62.64533333333333,2.8800000000000026,125,131,6,ki_chroma_acts_smoothed
374,5,62.64533333333333,66.48533333333333,3.8399999999999963,131,139,8,ki_chroma_acts_smoothed
374,6,66.48533333333333,70.32533333333333,3.8400000000000034,139,147,8,ki_chroma_acts_smoothed
374,7,70.32533333333333,74.16533333333334,3.8400000000000034,147,155,8,ki_chroma_acts_smoothed
374,8,74.16533333333334,92.88533333333334,18.72,155,194,39,ki_chroma_acts_smoothed
374,9,92.88533333333334,121.887,29.001666666666665,194,253,59,ki_chroma_acts_smoothed
375,1,0.0,17.376,17.376,0,38,38,chromagram
375,2,17.376,34.80533333333333,17.42933333333333,38,76,38,chromagram
375,3,34.80533333333333,79.29599999999999,44.49066666666666,76,173,97,chromagram
375,4,79.29599999999999,93.97333333333331,14.677333333333323,173,205,32,chromagram
375,5,93.97333333333331,105.43999999999998,11.466666666666669,205,230,25,chromagram
375,6,105.43999999999998,109.10933333333332,3.6693333333333413,230,238,8,chromagram
375,7,109.10933333333332,121.49333333333331,12.383999999999986,238,265,27,chromagram
375,8,121.49333333333331,154.177,32.68366666666668,265,335,70,chromagram
375,1,0.0,17.376,17.376,0,38,38,chroma_acts
375,2,17.376,35.72266666666666,18.34666666666666,38,78,40,chroma_acts
375,3,35.72266666666666,75.16799999999999,39.44533333333333,78,164,86,chroma_acts
375,4,75.16799999999999,93.97333333333331,18.805333333333323,164,205,41,chroma_acts
375,5,93.97333333333331,105.43999999999998,11.466666666666669,205,230,25,chroma_acts
375,6,105.43999999999998,109.10933333333332,3.6693333333333413,230,238,8,chroma_acts
375,7,109.10933333333332,121.49333333333331,12.383999999999986,238,265,27,chroma_acts
375,8,121.49333333333331,123.32799999999999,1.8346666666666778,265,269,4,chroma_acts
375,9,123.32799999999999,154.177,30.849000000000004,269,335,66,chroma_acts
375,1,0.0,17.376,17.376,0,38,38,chroma_acts_smoothed
375,2,17.376,35.72266666666666,18.34666666666666,38,78,40,chroma_acts_smoothed
375,3,35.72266666666666,74.70933333333332,38.98666666666666,78,163,85,chroma_acts_smoothed
375,4,74.70933333333332,94.43199999999999,19.72266666666667,163,206,43,chroma_acts_smoothed
375,5,94.43199999999999,104.98133333333332,10.549333333333337,206,229,23,chroma_acts_smoothed
375,6,104.98133333333332,109.56799999999998,4.586666666666659,229,239,10,chroma_acts_smoothed
375,7,109.56799999999998,121.49333333333331,11.925333333333327,239,265,26,chroma_acts_smoothed
375,8,121.49333333333331,124.24533333333332,2.7520000000000095,265,271,6,chroma_acts_smoothed
375,9,124.24533333333332,154.177,29.931666666666672,271,335,64,chroma_acts_smoothed
375,1,0.0,17.376,17.376,0,38,38,ki_chroma
375,2,17.376,34.80533333333333,17.42933333333333,38,76,38,ki_chroma
375,3,34.80533333333333,79.29599999999999,44.49066666666666,76,173,97,ki_chroma
375,4,79.29599999999999,93.97333333333331,14.677333333333323,173,205,32,ki_chroma
375,5,93.97333333333331,105.43999999999998,11.466666666666669,205,230,25,ki_chroma
375,6,105.43999999999998,109.10933333333332,3.6693333333333413,230,238,8,ki_chroma
375,7,109.10933333333332,121.49333333333331,12.383999999999986,238,265,27,ki_chroma
375,8,121.49333333333331,154.177,32.68366666666668,265,335,70,ki_chroma
375,1,0.0,17.376,17.376,0,38,38,ki_chroma_acts
375,2,17.376,35.72266666666666,18.34666666666666,38,78,40,ki_chroma_acts
375,3,35.72266666666666,75.16799999999999,39.44533333333333,78,164,86,ki_chroma_acts
375,4,75.16799999999999,93.97333333333331,18.805333333333323,164,205,41,ki_chroma_acts
375,5,93.97333333333331,105.43999999999998,11.466666666666669,205,230,25,ki_chroma_acts
375,6,105.43999999999998,109.10933333333332,3.6693333333333413,230,238,8,ki_chroma_acts
375,7,109.10933333333332,121.49333333333331,12.383999999999986,238,265,27,ki_chroma_acts
375,8,121.49333333333331,123.32799999999999,1.8346666666666778,265,269,4,ki_chroma_acts
375,9,123.32799999999999,154.177,30.849000000000004,269,335,66,ki_chroma_acts
375,1,0.0,17.376,17.376,0,38,38,ki_chroma_acts_smoothed
375,2,17.376,35.72266666666666,18.34666666666666,38,78,40,ki_chroma_acts_smoothed
375,3,35.72266666666666,74.70933333333332,38.98666666666666,78,163,85,ki_chroma_acts_smoothed
375,4,74.70933333333332,94.43199999999999,19.72266666666667,163,206,43,ki_chroma_acts_smoothed
375,5,94.43199999999999,104.98133333333332,10.549333333333337,206,229,23,ki_chroma_acts_smoothed
375,6,104.98133333333332,109.56799999999998,4.586666666666659,229,239,10,ki_chroma_acts_smoothed
375,7,109.56799999999998,121.49333333333331,11.925333333333327,239,265,26,ki_chroma_acts_smoothed
375,8,121.49333333333331,124.24533333333332,2.7520000000000095,265,271,6,ki_chroma_acts_smoothed
375,9,124.24533333333332,154.177,29.931666666666672,271,335,64,ki_chroma_acts_smoothed
388,1,0.0,16.362666666666666,16.362666666666666,0,35,35,chromagram
388,2,16.362666666666666,31.242666666666665,14.879999999999999,35,66,31,chromagram
388,3,31.242666666666665,35.08266666666667,3.8400000000000034,66,74,8,chromagram
388,4,35.08266666666667,66.28266666666667,31.200000000000003,74,139,65,chromagram
388,5,66.28266666666667,69.64266666666667,3.3599999999999994,139,146,7,chromagram
388,6,69.64266666666667,73.48266666666667,3.8400000000000034,146,154,8,chromagram
388,7,73.48266666666667,96.52266666666667,23.039999999999992,154,202,48,chromagram
388,8,96.52266666666667,115.24266666666666,18.72,202,241,39,chromagram
388,9,115.24266666666666,146.795,31.552333333333323,241,305,64,chromagram
388,1,0.0,16.362666666666666,16.362666666666666,0,35,35,chroma_acts
388,2,16.362666666666666,66.28266666666667,49.92,35,139,104,chroma_acts
388,3,66.28266666666667,69.64266666666667,3.3599999999999994,139,146,7,chroma_acts
388,4,69.64266666666667,73.48266666666667,3.8400000000000034,146,154,8,chroma_acts
388,5,73.48266666666667,77.32266666666666,3.839999999999989,154,162,8,chroma_acts
388,6,77.32266666666666,80.68266666666666,3.3599999999999994,162,169,7,chroma_acts
388,7,80.68266666666666,92.68266666666666,12.0,169,194,25,chroma_acts
388,8,92.68266666666666,115.24266666666666,22.560000000000002,194,241,47,chroma_acts
388,9,115.24266666666666,146.795,31.552333333333323,241,305,64,chroma_acts
388,1,0.0,16.362666666666666,16.362666666666666,0,35,35,chroma_acts_smoothed
388,2,16.362666666666666,65.80266666666667,49.44,35,138,103,chroma_acts_smoothed
388,3,65.80266666666667,69.64266666666667,3.8400000000000034,138,146,8,chroma_acts_smoothed
388,4,69.64266666666667,73.48266666666667,3.8400000000000034,146,154,8,chroma_acts_smoothed
388,5,73.48266666666667,77.32266666666666,3.839999999999989,154,162,8,chroma_acts_smoothed
388,6,77.32266666666666,80.68266666666666,3.3599999999999994,162,169,7,chroma_acts_smoothed
388,7,80.68266666666666,92.68266666666666,12.0,169,194,25,chroma_acts_smoothed
388,8,92.68266666666666,115.24266666666666,22.560000000000002,194,241,47,chroma_acts_smoothed
388,9,115.24266666666666,146.795,31.552333333333323,241,305,64,chroma_acts_smoothed
388,1,0.0,16.362666666666666,16.362666666666666,0,35,35,ki_chroma
388,2,16.362666666666666,31.242666666666665,14.879999999999999,35,66,31,ki_chroma
388,3,31.242666666666665,35.08266666666667,3.8400000000000034,66,74,8,ki_chroma
388,4,35.08266666666667,66.28266666666667,31.200000000000003,74,139,65,ki_chroma
388,5,66.28266666666667,69.64266666666667,3.3599999999999994,139,146,7,ki_chroma
388,6,69.64266666666667,73.48266666666667,3.8400000000000034,146,154,8,ki_chroma
388,7,73.48266666666667,96.52266666666667,23.039999999999992,154,202,48,ki_chroma
388,8,96.52266666666667,115.24266666666666,18.72,202,241,39,ki_chroma
388,9,115.24266666666666,146.795,31.552333333333323,241,305,64,ki_chroma
388,1,0.0,16.362666666666666,16.362666666666666,0,35,35,ki_chroma_acts
388,2,16.362666666666666,66.28266666666667,49.92,35,139,104,ki_chroma_acts
388,3,66.28266666666667,69.64266666666667,3.3599999999999994,139,146,7,ki_chroma_acts
388,4,69.64266666666667,73.48266666666667,3.8400000000000034,146,154,8,ki_chroma_acts
388,5,73.48266666666667,77.32266666666666,3.839999999999989,154,162,8,ki_chroma_acts
388,6,77.32266666666666,80.68266666666666,3.3599999999999994,162,169,7,ki_chroma_acts
388,7,80.68266666666666,92.68266666666666,12.0,169,194,25,ki_chroma_acts
388,8,92.68266666666666,115.24266666666666,22.560000000000002,194,241,47,ki_chroma_acts
388,9,115.24266666666666,146.795,31.552333333333323,241,305,64,ki_chroma_acts
388,1,0.0,16.362666666666666,16.362666666666666,0,35,35,ki_chroma_acts_smoothed
388,2,16.362666666666666,65.80266666666667,49.44,35,138,103,ki_chroma_acts_smoothed
388,3,65.80266666666667,69.64266666666667,3.8400000000000034,138,146,8,ki_chroma_acts_smoothed
388,4,69.64266666666667,73.48266666666667,3.8400000000000034,146,154,8,ki_chroma_acts_smoothed
388,5,73.48266666666667,77.32266666666666,3.839999999999989,154,162,8,ki_chroma_acts_smoothed
388,6,77.32266666666666,80.68266666666666,3.3599999999999994,162,169,7,ki_chroma_acts_smoothed
388,7,80.68266666666666,92.68266666666666,12.0,169,194,25,ki_chroma_acts_smoothed
388,8,92.68266666666666,115.24266666666666,22.560000000000002,194,241,47,ki_chroma_acts_smoothed
388,9,115.24266666666666,146.795,31.552333333333323,241,305,64,ki_chroma_acts_smoothed
389,1,0.0,11.306666666666667,11.306666666666667,0,24,24,chromagram
389,2,11.306666666666667,15.146666666666667,3.84,24,32,8,chromagram
389,3,15.146666666666667,63.626666666666665,48.48,32,133,101,chromagram
389,4,63.626666666666665,98.18666666666667,34.56,133,205,72,chromagram
389,5,98.18666666666667,102.98666666666665,4.799999999999983,205,215,10,chromagram
389,6,102.98666666666665,105.86666666666667,2.880000000000024,215,221,6,chromagram
389,7,105.86666666666667,111.62666666666667,5.759999999999991,221,233,12,chromagram
389,8,111.62666666666667,114.50666666666666,2.8799999999999955,233,239,6,chromagram
389,9,114.50666666666666,191.429,76.92233333333334,239,398,159,chromagram
389,1,0.0,11.306666666666667,11.306666666666667,0,24,24,chroma_acts
389,2,11.306666666666667,15.146666666666667,3.84,24,32,8,chroma_acts
389,3,15.146666666666667,63.626666666666665,48.48,32,133,101,chroma_acts
389,4,63.626666666666665,98.18666666666667,34.56,133,205,72,chroma_acts
389,5,98.18666666666667,102.98666666666665,4.799999999999983,205,215,10,chroma_acts
389,6,102.98666666666665,103.94666666666666,0.960000000000008,215,217,2,chroma_acts
389,7,103.94666666666666,111.62666666666667,7.680000000000007,217,233,16,chroma_acts
389,8,111.62666666666667,114.50666666666666,2.8799999999999955,233,239,6,chroma_acts
389,9,114.50666666666666,191.429,76.92233333333334,239,398,159,chroma_acts
389,1,0.0,11.306666666666667,11.306666666666667,0,24,24,chroma_acts_smoothed
389,2,11.306666666666667,15.146666666666667,3.84,24,32,8,chroma_acts_smoothed
389,3,15.146666666666667,63.626666666666665,48.48,32,133,101,chroma_acts_smoothed
389,4,63.626666666666665,96.26666666666665,32.639999999999986,133,201,68,chroma_acts_smoothed
389,5,96.26666666666665,102.98666666666665,6.719999999999999,201,215,14,chroma_acts_smoothed
389,6,102.98666666666665,105.86666666666667,2.880000000000024,215,221,6,chroma_acts_smoothed
389,7,105.86666666666667,111.62666666666667,5.759999999999991,221,233,12,chroma_acts_smoothed
389,8,111.62666666666667,114.02666666666667,2.4000000000000057,233,238,5,chroma_acts_smoothed
389,9,114.02666666666667,191.429,77.40233333333333,238,398,160,chroma_acts_smoothed
389,1,0.0,11.306666666666667,11.306666666666667,0,24,24,ki_chroma
389,2,11.306666666666667,15.146666666666667,3.84,24,32,8,ki_chroma
389,3,15.146666666666667,63.626666666666665,48.48,32,133,101,ki_chroma
389,4,63.626666666666665,98.18666666666667,34.56,133,205,72,ki_chroma
389,5,98.18666666666667,102.98666666666665,4.799999999999983,205,215,10,ki_chroma
389,6,102.98666666666665,105.86666666666667,2.880000000000024,215,221,6,ki_chroma
389,7,105.86666666666667,111.62666666666667,5.759999999999991,221,233,12,ki_chroma
389,8,111.62666666666667,114.50666666666666,2.8799999999999955,233,239,6,ki_chroma
389,9,114.50666666666666,191.429,76.92233333333334,239,398,159,ki_chroma
389,1,0.0,11.306666666666667,11.306666666666667,0,24,24,ki_chroma_acts
389,2,11.306666666666667,15.146666666666667,3.84,24,32,8,ki_chroma_acts
389,3,15.146666666666667,63.626666666666665,48.48,32,133,101,ki_chroma_acts
389,4,63.626666666666665,98.18666666666667,34.56,133,205,72,ki_chroma_acts
389,5,98.18666666666667,102.98666666666665,4.799999999999983,205,215,10,ki_chroma_acts
389,6,102.98666666666665,103.94666666666666,0.960000000000008,215,217,2,ki_chroma_acts
389,7,103.94666666666666,111.62666666666667,7.680000000000007,217,233,16,ki_chroma_acts
389,8,111.62666666666667,114.50666666666666,2.8799999999999955,233,239,6,ki_chroma_acts
389,9,114.50666666666666,191.429,76.92233333333334,239,398,159,ki_chroma_acts
389,1,0.0,11.306666666666667,11.306666666666667,0,24,24,ki_chroma_acts_smoothed
389,2,11.306666666666667,15.146666666666667,3.84,24,32,8,ki_chroma_acts_smoothed
389,3,15.146666666666667,63.626666666666665,48.48,32,133,101,ki_chroma_acts_smoothed
389,4,63.626666666666665,96.26666666666665,32.639999999999986,133,201,68,ki_chroma_acts_smoothed
389,5,96.26666666666665,102.98666666666665,6.719999999999999,201,215,14,ki_chroma_acts_smoothed
389,6,102.98666666666665,105.86666666666667,2.880000000000024,215,221,6,ki_chroma_acts_smoothed
389,7,105.86666666666667,111.62666666666667,5.759999999999991,221,233,12,ki_chroma_acts_smoothed
389,8,111.62666666666667,114.02666666666667,2.4000000000000057,233,238,5,ki_chroma_acts_smoothed
389,9,114.02666666666667,191.429,77.40233333333333,238,398,160,ki_chroma_acts_smoothed
393,1,0.0,50.25066666666666,50.25066666666666,0,110,110,chromagram
393,2,50.25066666666666,64.928,14.677333333333337,110,142,32,chromagram
393,3,64.928,72.26666666666665,7.338666666666654,142,158,16,chromagram
393,4,72.26666666666665,75.93599999999999,3.6693333333333413,158,166,8,chromagram
393,5,75.93599999999999,104.37333333333332,28.437333333333328,166,228,62,chromagram
393,6,104.37333333333332,132.81066666666666,28.437333333333342,228,290,62,chromagram
393,7,132.81066666666666,147.48799999999997,14.677333333333308,290,322,32,chromagram
393,8,147.48799999999997,176.384,28.896000000000015,322,385,63,chromagram
393,9,176.384,212.499,36.11500000000001,385,462,77,chromagram
393,1,0.0,48.416,48.416,0,106,106,chroma_acts
393,2,48.416,64.928,16.512,106,142,36,chroma_acts
393,3,64.928,72.26666666666665,7.338666666666654,142,158,16,chroma_acts
393,4,72.26666666666665,75.93599999999999,3.6693333333333413,158,166,8,chroma_acts
393,5,75.93599999999999,104.37333333333332,28.437333333333328,166,228,62,chroma_acts
393,6,104.37333333333332,132.81066666666666,28.437333333333342,228,290,62,chroma_acts
393,7,132.81066666666666,147.48799999999997,14.677333333333308,290,322,32,chroma_acts
393,8,147.48799999999997,176.384,28.896000000000015,322,385,63,chroma_acts
393,9,176.384,212.499,36.11500000000001,385,462,77,chroma_acts
393,1,0.0,50.25066666666666,50.25066666666666,0,110,110,chroma_acts_smoothed
393,2,50.25066666666666,64.46933333333332,14.218666666666664,110,141,31,chroma_acts_smoothed
393,3,64.46933333333332,72.26666666666665,7.797333333333327,141,158,17,chroma_acts_smoothed
393,4,72.26666666666665,75.93599999999999,3.6693333333333413,158,166,8,chroma_acts_smoothed
393,5,75.93599999999999,104.37333333333332,28.437333333333328,166,228,62,chroma_acts_smoothed
393,6,104.37333333333332,132.81066666666666,28.437333333333342,228,290,62,chroma_acts_smoothed
393,7,132.81066666666666,147.48799999999997,14.677333333333308,290,322,32,chroma_acts_smoothed
393,8,147.48799999999997,176.384,28.896000000000015,322,385,63,chroma_acts_smoothed
393,9,176.384,212.499,36.11500000000001,385,462,77,chroma_acts_smoothed
393,1,0.0,50.25066666666666,50.25066666666666,0,110,110,ki_chroma
393,2,50.25066666666666,64.928,14.677333333333337,110,142,32,ki_chroma
393,3,64.928,72.26666666666665,7.338666666666654,142,158,16,ki_chroma
393,4,72.26666666666665,75.93599999999999,3.6693333333333413,158,166,8,ki_chroma
393,5,75.93599999999999,104.37333333333332,28.437333333333328,166,228,62,ki_chroma
393,6,104.37333333333332,132.81066666666666,28.437333333333342,228,290,62,ki_chroma
393,7,132.81066666666666,147.48799999999997,14.677333333333308,290,322,32,ki_chroma
393,8,147.48799999999997,176.384,28.896000000000015,322,385,63,ki_chroma
393,9,176.384,212.499,36.11500000000001,385,462,77,ki_chroma
393,1,0.0,48.416,48.416,0,106,106,ki_chroma_acts
393,2,48.416,64.928,16.512,106,142,36,ki_chroma_acts
393,3,64.928,72.26666666666665,7.338666666666654,142,158,16,ki_chroma_acts
393,4,72.26666666666665,75.93599999999999,3.6693333333333413,158,166,8,ki_chroma_acts
393,5,75.93599999999999,104.37333333333332,28.437333333333328,166,228,62,ki_chroma_acts
393,6,104.37333333333332,132.81066666666666,28.437333333333342,228,290,62,ki_chroma_acts
393,7,132.81066666666666,147.48799999999997,14.677333333333308,290,322,32,ki_chroma_acts
393,8,147.48799999999997,176.384,28.896000000000015,322,385,63,ki_chroma_acts
393,9,176.384,212.499,36.11500000000001,385,462,77,ki_chroma_acts
393,1,0.0,50.25066666666666,50.25066666666666,0,110,110,ki_chroma_acts_smoothed
393,2,50.25066666666666,64.46933333333332,14.218666666666664,110,141,31,ki_chroma_acts_smoothed
393,3,64.46933333333332,72.26666666666665,7.797333333333327,141,158,17,ki_chroma_acts_smoothed
393,4,72.26666666666665,75.93599999999999,3.6693333333333413,158,166,8,ki_chroma_acts_smoothed
393,5,75.93599999999999,104.37333333333332,28.437333333333328,166,228,62,ki_chroma_acts_smoothed
393,6,104.37333333333332,132.81066666666666,28.437333333333342,228,290,62,ki_chroma_acts_smoothed
393,7,132.81066666666666,147.48799999999997,14.677333333333308,290,322,32,ki_chroma_acts_smoothed
393,8,147.48799999999997,176.384,28.896000000000015,322,385,63,ki_chroma_acts_smoothed
393,9,176.384,212.499,36.11500000000001,385,462,77,ki_chroma_acts_smoothed
397,1,0.0,15.093333333333334,15.093333333333334,0,32,32,chromagram
397,2,15.093333333333334,40.053333333333335,24.96,32,84,52,chromagram
397,3,40.053333333333335,93.81333333333333,53.76,84,196,112,chromagram
397,4,93.81333333333333,108.69333333333333,14.879999999999995,196,227,31,chromagram
397,5,108.69333333333333,112.53333333333333,3.8400000000000034,227,235,8,chromagram
397,6,112.53333333333333,116.37333333333333,3.8400000000000034,235,243,8,chromagram
397,7,116.37333333333333,169.65333333333334,53.28,243,354,111,chromagram
397,8,169.65333333333334,201.472,31.818666666666672,354,419,65,chromagram
397,1,0.0,15.093333333333334,15.093333333333334,0,32,32,chroma_acts
397,2,15.093333333333334,45.81333333333333,30.72,32,96,64,chroma_acts
397,3,45.81333333333333,93.81333333333333,48.0,96,196,100,chroma_acts
397,4,93.81333333333333,108.69333333333333,14.879999999999995,196,227,31,chroma_acts
397,5,108.69333333333333,112.53333333333333,3.8400000000000034,227,235,8,chroma_acts
397,6,112.53333333333333,116.37333333333333,3.8400000000000034,235,243,8,chroma_acts
397,7,116.37333333333333,122.13333333333333,5.759999999999991,243,255,12,chroma_acts
397,8,122.13333333333333,201.472,79.33866666666668,255,419,164,chroma_acts
397,1,0.0,15.093333333333334,15.093333333333334,0,32,32,chroma_acts_smoothed
397,2,15.093333333333334,45.81333333333333,30.72,32,96,64,chroma_acts_smoothed
397,3,45.81333333333333,93.81333333333333,48.0,96,196,100,chroma_acts_smoothed
397,4,93.81333333333333,108.69333333333333,14.879999999999995,196,227,31,chroma_acts_smoothed
397,5,108.69333333333333,112.53333333333333,3.8400000000000034,227,235,8,chroma_acts_smoothed
397,6,112.53333333333333,116.37333333333333,3.8400000000000034,235,243,8,chroma_acts_smoothed
397,7,116.37333333333333,122.13333333333333,5.759999999999991,243,255,12,chroma_acts_smoothed
397,8,122.13333333333333,201.472,79.33866666666668,255,419,164,chroma_acts_smoothed
397,1,0.0,15.093333333333334,15.093333333333334,0,32,32,ki_chroma
397,2,15.093333333333334,40.053333333333335,24.96,32,84,52,ki_chroma
397,3,40.053333333333335,93.81333333333333,53.76,84,196,112,ki_chroma
397,4,93.81333333333333,108.69333333333333,14.879999999999995,196,227,31,ki_chroma
397,5,108.69333333333333,112.53333333333333,3.8400000000000034,227,235,8,ki_chroma
397,6,112.53333333333333,116.37333333333333,3.8400000000000034,235,243,8,ki_chroma
397,7,116.37333333333333,169.65333333333334,53.28,243,354,111,ki_chroma
397,8,169.65333333333334,201.472,31.818666666666672,354,419,65,ki_chroma
397,1,0.0,15.093333333333334,15.093333333333334,0,32,32,ki_chroma_acts
397,2,15.093333333333334,45.81333333333333,30.72,32,96,64,ki_chroma_acts
397,3,45.81333333333333,93.81333333333333,48.0,96,196,100,ki_chroma_acts
397,4,93.81333333333333,108.69333333333333,14.879999999999995,196,227,31,ki_chroma_acts
397,5,108.69333333333333,112.53333333333333,3.8400000000000034,227,235,8,ki_chroma_acts
397,6,112.53333333333333,116.37333333333333,3.8400000000000034,235,243,8,ki_chroma_acts
397,7,116.37333333333333,122.13333333333333,5.759999999999991,243,255,12,ki_chroma_acts
397,8,122.13333333333333,201.472,79.33866666666668,255,419,164,ki_chroma_acts
397,1,0.0,15.093333333333334,15.093333333333334,0,32,32,ki_chroma_acts_smoothed
397,2,15.093333333333334,45.81333333333333,30.72,32,96,64,ki_chroma_acts_smoothed
397,3,45.81333333333333,93.81333333333333,48.0,96,196,100,ki_chroma_acts_smoothed
397,4,93.81333333333333,108.69333333333333,14.879999999999995,196,227,31,ki_chroma_acts_smoothed
397,5,108.69333333333333,112.53333333333333,3.8400000000000034,227,235,8,ki_chroma_acts_smoothed
397,6,112.53333333333333,116.37333333333333,3.8400000000000034,235,243,8,ki_chroma_acts_smoothed
397,7,116.37333333333333,122.13333333333333,5.759999999999991,243,255,12,ki_chroma_acts_smoothed
397,8,122.13333333333333,201.472,79.33866666666668,255,419,164,ki_chroma_acts_smoothed
399,1,0.0,48.330666666666666,48.330666666666666,0,97,97,chromagram
399,2,48.330666666666666,63.87199999999999,15.541333333333327,97,128,31,chromagram
399,3,63.87199999999999,91.94666666666667,28.07466666666668,128,184,56,chromagram
399,4,91.94666666666667,95.95733333333334,4.0106666666666655,184,192,8,chromagram
399,5,95.95733333333334,124.032,28.07466666666666,192,248,56,chromagram
399,6,124.032,156.1173333333333,32.08533333333331,248,312,64,chromagram
399,7,156.1173333333333,168.14933333333332,12.03200000000001,312,336,24,chromagram
399,8,168.14933333333332,266.815,98.66566666666668,336,531,195,chromagram
399,1,0.0,48.330666666666666,48.330666666666666,0,97,97,chroma_acts
399,2,48.330666666666666,63.87199999999999,15.541333333333327,97,128,31,chroma_acts
399,3,63.87199999999999,91.94666666666667,28.07466666666668,128,184,56,chroma_acts
399,4,91.94666666666667,95.95733333333334,4.0106666666666655,184,192,8,chroma_acts
399,5,95.95733333333334,124.032,28.07466666666666,192,248,56,chroma_acts
399,6,124.032,142.07999999999998,18.047999999999988,248,284,36,chroma_acts
399,7,142.07999999999998,168.14933333333332,26.069333333333333,284,336,52,chroma_acts
399,8,168.14933333333332,266.815,98.66566666666668,336,531,195,chroma_acts
399,1,0.0,47.82933333333333,47.82933333333333,0,96,96,chroma_acts_smoothed
399,2,47.82933333333333,63.87199999999999,16.042666666666662,96,128,32,chroma_acts_smoothed
399,3,63.87199999999999,126.53866666666666,62.666666666666664,128,253,125,chroma_acts_smoothed
399,4,126.53866666666666,142.07999999999998,15.541333333333327,253,284,31,chroma_acts_smoothed
399,5,142.07999999999998,146.09066666666664,4.010666666666651,284,292,8,chroma_acts_smoothed
399,6,146.09066666666664,158.62399999999997,12.533333333333331,292,317,25,chroma_acts_smoothed
399,7,158.62399999999997,168.14933333333332,9.52533333333335,317,336,19,chroma_acts_smoothed
399,8,168.14933333333332,266.815,98.66566666666668,336,531,195,chroma_acts_smoothed
399,1,0.0,48.330666666666666,48.330666666666666,0,97,97,ki_chroma
399,2,48.330666666666666,63.87199999999999,15.541333333333327,97,128,31,ki_chroma
399,3,63.87199999999999,91.94666666666667,28.07466666666668,128,184,56,ki_chroma
399,4,91.94666666666667,95.95733333333334,4.0106666666666655,184,192,8,ki_chroma
399,5,95.95733333333334,124.032,28.07466666666666,192,248,56,ki_chroma
399,6,124.032,156.1173333333333,32.08533333333331,248,312,64,ki_chroma
399,7,156.1173333333333,168.14933333333332,12.03200000000001,312,336,24,ki_chroma
399,8,168.14933333333332,266.815,98.66566666666668,336,531,195,ki_chroma
399,1,0.0,48.330666666666666,48.330666666666666,0,97,97,ki_chroma_acts
399,2,48.330666666666666,63.87199999999999,15.541333333333327,97,128,31,ki_chroma_acts
399,3,63.87199999999999,91.94666666666667,28.07466666666668,128,184,56,ki_chroma_acts
399,4,91.94666666666667,95.95733333333334,4.0106666666666655,184,192,8,ki_chroma_acts
399,5,95.95733333333334,124.032,28.07466666666666,192,248,56,ki_chroma_acts
399,6,124.032,142.07999999999998,18.047999999999988,248,284,36,ki_chroma_acts
399,7,142.07999999999998,168.14933333333332,26.069333333333333,284,336,52,ki_chroma_acts
399,8,168.14933333333332,266.815,98.66566666666668,336,531,195,ki_chroma_acts
399,1,0.0,47.82933333333333,47.82933333333333,0,96,96,ki_chroma_acts_smoothed
399,2,47.82933333333333,63.87199999999999,16.042666666666662,96,128,32,ki_chroma_acts_smoothed
399,3,63.87199999999999,126.53866666666666,62.666666666666664,128,253,125,ki_chroma_acts_smoothed
399,4,126.53866666666666,142.07999999999998,15.541333333333327,253,284,31,ki_chroma_acts_smoothed
399,5,142.07999999999998,146.09066666666664,4.010666666666651,284,292,8,ki_chroma_acts_smoothed
399,6,146.09066666666664,158.62399999999997,12.533333333333331,292,317,25,ki_chroma_acts_smoothed
399,7,158.62399999999997,168.14933333333332,9.52533333333335,317,336,19,ki_chroma_acts_smoothed
399,8,168.14933333333332,266.815,98.66566666666668,336,531,195,ki_chroma_acts_smoothed
400,1,0.0,9.408,9.408,0,20,20,chromagram
400,2,9.408,53.568,44.16,20,112,92,chromagram
400,3,53.568,99.648,46.08,112,208,96,chromagram
400,4,99.648,128.928,29.28,208,269,61,chromagram
400,5,128.928,161.088,32.16,269,336,67,chromagram
400,6,161.088,175.008,13.920000000000016,336,365,29,chromagram
400,7,175.008,176.448,1.4399999999999977,365,368,3,chromagram
400,8,176.448,190.368,13.919999999999987,368,397,29,chromagram
400,9,190.368,209.068,18.700000000000017,397,434,37,chromagram
400,1,0.0,9.408,9.408,0,20,20,chroma_acts
400,2,9.408,53.568,44.16,20,112,92,chroma_acts
400,3,53.568,99.648,46.08,112,208,96,chroma_acts
400,4,99.648,130.368,30.72,208,272,64,chroma_acts
400,5,130.368,161.088,30.72,272,336,64,chroma_acts
400,6,161.088,175.008,13.920000000000016,336,365,29,chroma_acts
400,7,175.008,176.448,1.4399999999999977,365,368,3,chroma_acts
400,8,176.448,190.368,13.919999999999987,368,397,29,chroma_acts
400,9,190.368,209.068,18.700000000000017,397,434,37,chroma_acts
400,1,0.0,7.4879999999999995,7.4879999999999995,0,16,16,chroma_acts_smoothed
400,2,7.4879999999999995,53.568,46.08,16,112,96,chroma_acts_smoothed
400,3,53.568,71.32799999999999,17.75999999999999,112,149,37,chroma_acts_smoothed
400,4,71.32799999999999,130.848,59.520000000000024,149,273,124,chroma_acts_smoothed
400,5,130.848,161.088,30.23999999999998,273,336,63,chroma_acts_smoothed
400,6,161.088,190.368,29.28,336,397,61,chroma_acts_smoothed
400,7,190.368,193.728,3.3600000000000136,397,404,7,chroma_acts_smoothed
400,8,193.728,209.068,15.340000000000003,404,434,30,chroma_acts_smoothed
400,1,0.0,9.408,9.408,0,20,20,ki_chroma
400,2,9.408,53.568,44.16,20,112,92,ki_chroma
400,3,53.568,99.648,46.08,112,208,96,ki_chroma
400,4,99.648,128.928,29.28,208,269,61,ki_chroma
400,5,128.928,161.088,32.16,269,336,67,ki_chroma
400,6,161.088,175.008,13.920000000000016,336,365,29,ki_chroma
400,7,175.008,176.448,1.4399999999999977,365,368,3,ki_chroma
400,8,176.448,190.368,13.919999999999987,368,397,29,ki_chroma
400,9,190.368,209.068,18.700000000000017,397,434,37,ki_chroma
400,1,0.0,9.408,9.408,0,20,20,ki_chroma_acts
400,2,9.408,53.568,44.16,20,112,92,ki_chroma_acts
400,3,53.568,99.648,46.08,112,208,96,ki_chroma_acts
400,4,99.648,130.368,30.72,208,272,64,ki_chroma_acts
400,5,130.368,161.088,30.72,272,336,64,ki_chroma_acts
400,6,161.088,175.008,13.920000000000016,336,365,29,ki_chroma_acts
400,7,175.008,176.448,1.4399999999999977,365,368,3,ki_chroma_acts
400,8,176.448,190.368,13.919999999999987,368,397,29,ki_chroma_acts
400,9,190.368,209.068,18.700000000000017,397,434,37,ki_chroma_acts
400,1,0.0,7.4879999999999995,7.4879999999999995,0,16,16,ki_chroma_acts_smoothed
400,2,7.4879999999999995,53.568,46.08,16,112,96,ki_chroma_acts_smoothed
400,3,53.568,71.32799999999999,17.75999999999999,112,149,37,ki_chroma_acts_smoothed
400,4,71.32799999999999,130.848,59.520000000000024,149,273,124,ki_chroma_acts_smoothed
400,5,130.848,161.088,30.23999999999998,273,336,63,ki_chroma_acts_smoothed
400,6,161.088,190.368,29.28,336,397,61,ki_chroma_acts_smoothed
400,7,190.368,193.728,3.3600000000000136,397,404,7,ki_chroma_acts_smoothed
400,8,193.728,209.068,15.340000000000003,404,434,30,ki_chroma_acts_smoothed
401,1,0.0,3.904,3.904,0,9,9,chromagram
401,2,3.904,7.744,3.84,9,17,8,chromagram
401,3,7.744,30.304,22.56,17,64,47,chromagram
401,4,30.304,61.504,31.2,64,129,65,chromagram
401,5,61.504,65.344,3.8399999999999963,129,137,8,chromagram
401,6,65.344,69.184,3.8400000000000034,137,145,8,chromagram
401,7,69.184,96.064,26.879999999999995,145,201,56,chromagram
401,8,96.064,103.744,7.680000000000007,201,217,16,chromagram
401,9,103.744,141.239,37.495000000000005,217,294,77,chromagram
401,1,0.0,19.264,19.264,0,41,41,chroma_acts
401,2,19.264,23.104,3.84,41,49,8,chroma_acts
401,3,23.104,26.944,3.84,49,57,8,chroma_acts
401,4,26.944,61.504,34.56,57,129,72,chroma_acts
401,5,61.504,65.344,3.8399999999999963,129,137,8,chroma_acts
401,6,65.344,69.184,3.8400000000000034,137,145,8,chroma_acts
401,7,69.184,96.064,26.879999999999995,145,201,56,chroma_acts
401,8,96.064,103.744,7.680000000000007,201,217,16,chroma_acts
401,9,103.744,141.239,37.495000000000005,217,294,77,chroma_acts
401,1,0.0,3.904,3.904,0,9,9,chroma_acts_smoothed
401,2,3.904,26.944,23.04,9,57,48,chroma_acts_smoothed
401,3,26.944,30.304,3.3599999999999994,57,64,7,chroma_acts_smoothed
401,4,30.304,61.504,31.2,64,129,65,chroma_acts_smoothed
401,5,61.504,65.344,3.8399999999999963,129,137,8,chroma_acts_smoothed
401,6,65.344,69.184,3.8400000000000034,137,145,8,chroma_acts_smoothed
401,7,69.184,96.544,27.36,145,202,57,chroma_acts_smoothed
401,8,96.544,103.744,7.200000000000003,202,217,15,chroma_acts_smoothed
401,9,103.744,141.239,37.495000000000005,217,294,77,chroma_acts_smoothed
401,1,0.0,3.904,3.904,0,9,9,ki_chroma
401,2,3.904,7.744,3.84,9,17,8,ki_chroma
401,3,7.744,30.304,22.56,17,64,47,ki_chroma
401,4,30.304,61.504,31.2,64,129,65,ki_chroma
401,5,61.504,65.344,3.8399999999999963,129,137,8,ki_chroma
401,6,65.344,69.184,3.8400000000000034,137,145,8,ki_chroma
401,7,69.184,96.064,26.879999999999995,145,201,56,ki_chroma
401,8,96.064,103.744,7.680000000000007,201,217,16,ki_chroma
401,9,103.744,141.239,37.495000000000005,217,294,77,ki_chroma
401,1,0.0,19.264,19.264,0,41,41,ki_chroma_acts
401,2,19.264,23.104,3.84,41,49,8,ki_chroma_acts
401,3,23.104,26.944,3.84,49,57,8,ki_chroma_acts
401,4,26.944,61.504,34.56,57,129,72,ki_chroma_acts
401,5,61.504,65.344,3.8399999999999963,129,137,8,ki_chroma_acts
401,6,65.344,69.184,3.8400000000000034,137,145,8,ki_chroma_acts
401,7,69.184,96.064,26.879999999999995,145,201,56,ki_chroma_acts
401,8,96.064,103.744,7.680000000000007,201,217,16,ki_chroma_acts
401,9,103.744,141.239,37.495000000000005,217,294,77,ki_chroma_acts
401,1,0.0,3.904,3.904,0,9,9,ki_chroma_acts_smoothed
401,2,3.904,26.944,23.04,9,57,48,ki_chroma_acts_smoothed
401,3,26.944,30.304,3.3599999999999994,57,64,7,ki_chroma_acts_smoothed
401,4,30.304,61.504,31.2,64,129,65,ki_chroma_acts_smoothed
401,5,61.504,65.344,3.8399999999999963,129,137,8,ki_chroma_acts_smoothed
401,6,65.344,69.184,3.8400000000000034,137,145,8,ki_chroma_acts_smoothed
401,7,69.184,96.544,27.36,145,202,57,ki_chroma_acts_smoothed
401,8,96.544,103.744,7.200000000000003,202,217,15,ki_chroma_acts_smoothed
401,9,103.744,141.239,37.495000000000005,217,294,77,ki_chroma_acts_smoothed
403,1,0.0,4.4479999999999995,4.4479999999999995,0,10,10,chromagram
403,2,4.4479999999999995,8.288,3.8400000000000007,10,18,8,chromagram
403,3,8.288,23.648,15.36,18,50,32,chromagram
403,4,23.648,38.528,14.879999999999999,50,81,31,chromagram
403,5,38.528,100.928,62.4,81,211,130,chromagram
403,6,100.928,148.928,48.0,211,311,100,chromagram
403,7,148.928,163.328,14.400000000000006,311,341,30,chromagram
403,8,163.328,178.84,15.512,341,372,31,chromagram
403,1,0.0,5.4079999999999995,5.4079999999999995,0,12,12,chroma_acts
403,2,5.4079999999999995,8.288,2.880000000000001,12,18,6,chroma_acts
403,3,8.288,38.528,30.24,18,81,63,chroma_acts
403,4,38.528,100.928,62.4,81,211,130,chroma_acts
403,5,100.928,133.088,32.16,211,278,67,chroma_acts
403,6,133.088,136.448,3.3600000000000136,278,285,7,chroma_acts
403,7,136.448,141.248,4.799999999999983,285,295,10,chroma_acts
403,8,141.248,162.84799999999998,21.599999999999994,295,340,45,chroma_acts
403,9,162.84799999999998,178.84,15.992000000000019,340,372,32,chroma_acts
403,1,0.0,5.4079999999999995,5.4079999999999995,0,12,12,chroma_acts_smoothed
403,2,5.4079999999999995,8.288,2.880000000000001,12,18,6,chroma_acts_smoothed
403,3,8.288,23.648,15.36,18,50,32,chroma_acts_smoothed
403,4,23.648,38.528,14.879999999999999,50,81,31,chroma_acts_smoothed
403,5,38.528,100.928,62.4,81,211,130,chroma_acts_smoothed
403,6,100.928,133.568,32.640000000000015,211,279,68,chroma_acts_smoothed
403,7,133.568,159.488,25.919999999999987,279,333,54,chroma_acts_smoothed
403,8,159.488,162.84799999999998,3.359999999999985,333,340,7,chroma_acts_smoothed
403,9,162.84799999999998,178.84,15.992000000000019,340,372,32,chroma_acts_smoothed
403,1,0.0,4.4479999999999995,4.4479999999999995,0,10,10,ki_chroma
403,2,4.4479999999999995,8.288,3.8400000000000007,10,18,8,ki_chroma
403,3,8.288,23.648,15.36,18,50,32,ki_chroma
403,4,23.648,38.528,14.879999999999999,50,81,31,ki_chroma
403,5,38.528,100.928,62.4,81,211,130,ki_chroma
403,6,100.928,148.928,48.0,211,311,100,ki_chroma
403,7,148.928,163.328,14.400000000000006,311,341,30,ki_chroma
403,8,163.328,178.84,15.512,341,372,31,ki_chroma
403,1,0.0,5.4079999999999995,5.4079999999999995,0,12,12,ki_chroma_acts
403,2,5.4079999999999995,8.288,2.880000000000001,12,18,6,ki_chroma_acts
403,3,8.288,38.528,30.24,18,81,63,ki_chroma_acts
403,4,38.528,100.928,62.4,81,211,130,ki_chroma_acts
403,5,100.928,133.088,32.16,211,278,67,ki_chroma_acts
403,6,133.088,136.448,3.3600000000000136,278,285,7,ki_chroma_acts
403,7,136.448,141.248,4.799999999999983,285,295,10,ki_chroma_acts
403,8,141.248,162.84799999999998,21.599999999999994,295,340,45,ki_chroma_acts
403,9,162.84799999999998,178.84,15.992000000000019,340,372,32,ki_chroma_acts
403,1,0.0,5.4079999999999995,5.4079999999999995,0,12,12,ki_chroma_acts_smoothed
403,2,5.4079999999999995,8.288,2.880000000000001,12,18,6,ki_chroma_acts_smoothed
403,3,8.288,23.648,15.36,18,50,32,ki_chroma_acts_smoothed
403,4,23.648,38.528,14.879999999999999,50,81,31,ki_chroma_acts_smoothed
403,5,38.528,100.928,62.4,81,211,130,ki_chroma_acts_smoothed
403,6,100.928,133.568,32.640000000000015,211,279,68,ki_chroma_acts_smoothed
403,7,133.568,159.488,25.919999999999987,279,333,54,ki_chroma_acts_smoothed
403,8,159.488,162.84799999999998,3.359999999999985,333,340,7,ki_chroma_acts_smoothed
403,9,162.84799999999998,178.84,15.992000000000019,340,372,32,ki_chroma_acts_smoothed
405,1,0.0,43.541333333333334,43.541333333333334,0,81,81,chromagram
405,2,43.541333333333334,63.669333333333334,20.128,81,118,37,chromagram
405,3,63.669333333333334,97.94133333333333,34.272,118,181,63,chromagram
405,4,97.94133333333333,103.38133333333334,5.440000000000012,181,191,10,chromagram
405,5,103.38133333333334,124.59733333333334,21.215999999999994,191,230,39,chromagram
405,6,124.59733333333334,163.76533333333336,39.16800000000002,230,302,72,chromagram
405,7,163.76533333333336,182.80533333333335,19.039999999999992,302,337,35,chromagram
405,8,182.80533333333335,219.25333333333336,36.44800000000001,337,404,67,chromagram
405,9,219.25333333333336,227.393,8.139666666666642,404,417,13,chromagram
405,1,0.0,43.541333333333334,43.541333333333334,0,81,81,chroma_acts
405,2,43.541333333333334,62.58133333333333,19.04,81,116,35,chroma_acts
405,3,62.58133333333333,97.94133333333333,35.36,116,181,65,chroma_acts
405,4,97.94133333333333,103.38133333333334,5.440000000000012,181,191,10,chroma_acts
405,5,103.38133333333334,113.17333333333335,9.792000000000002,191,209,18,chroma_acts
405,6,113.17333333333335,163.76533333333336,50.59200000000001,209,302,93,chroma_acts
405,7,163.76533333333336,182.26133333333337,18.49600000000001,302,336,34,chroma_acts
405,8,182.26133333333337,227.393,45.13166666666663,336,417,81,chroma_acts
405,1,0.0,44.08533333333334,44.08533333333334,0,82,82,chroma_acts_smoothed
405,2,44.08533333333334,62.037333333333336,17.951999999999998,82,115,33,chroma_acts_smoothed
405,3,62.037333333333336,98.48533333333334,36.44800000000001,115,182,67,chroma_acts_smoothed
405,4,98.48533333333334,103.38133333333334,4.896000000000001,182,191,9,chroma_acts_smoothed
405,5,103.38133333333334,113.17333333333335,9.792000000000002,191,209,18,chroma_acts_smoothed
405,6,113.17333333333335,163.76533333333336,50.59200000000001,209,302,93,chroma_acts_smoothed
405,7,163.76533333333336,182.26133333333337,18.49600000000001,302,336,34,chroma_acts_smoothed
405,8,182.26133333333337,219.25333333333336,36.99199999999999,336,404,68,chroma_acts_smoothed
405,9,219.25333333333336,227.393,8.139666666666642,404,417,13,chroma_acts_smoothed
405,1,0.0,43.541333333333334,43.541333333333334,0,81,81,ki_chroma
405,2,43.541333333333334,63.669333333333334,20.128,81,118,37,ki_chroma
405,3,63.669333333333334,97.94133333333333,34.272,118,181,63,ki_chroma
405,4,97.94133333333333,103.38133333333334,5.440000000000012,181,191,10,ki_chroma
405,5,103.38133333333334,124.59733333333334,21.215999999999994,191,230,39,ki_chroma
405,6,124.59733333333334,163.76533333333336,39.16800000000002,230,302,72,ki_chroma
405,7,163.76533333333336,182.80533333333335,19.039999999999992,302,337,35,ki_chroma
405,8,182.80533333333335,219.25333333333336,36.44800000000001,337,404,67,ki_chroma
405,9,219.25333333333336,227.393,8.139666666666642,404,417,13,ki_chroma
405,1,0.0,43.541333333333334,43.541333333333334,0,81,81,ki_chroma_acts
405,2,43.541333333333334,62.58133333333333,19.04,81,116,35,ki_chroma_acts
405,3,62.58133333333333,97.94133333333333,35.36,116,181,65,ki_chroma_acts
405,4,97.94133333333333,103.38133333333334,5.440000000000012,181,191,10,ki_chroma_acts
405,5,103.38133333333334,113.17333333333335,9.792000000000002,191,209,18,ki_chroma_acts
405,6,113.17333333333335,163.76533333333336,50.59200000000001,209,302,93,ki_chroma_acts
405,7,163.76533333333336,182.26133333333337,18.49600000000001,302,336,34,ki_chroma_acts
405,8,182.26133333333337,227.393,45.13166666666663,336,417,81,ki_chroma_acts
405,1,0.0,44.08533333333334,44.08533333333334,0,82,82,ki_chroma_acts_smoothed
405,2,44.08533333333334,62.037333333333336,17.951999999999998,82,115,33,ki_chroma_acts_smoothed
405,3,62.037333333333336,98.48533333333334,36.44800000000001,115,182,67,ki_chroma_acts_smoothed
405,4,98.48533333333334,103.38133333333334,4.896000000000001,182,191,9,ki_chroma_acts_smoothed
405,5,103.38133333333334,113.17333333333335,9.792000000000002,191,209,18,ki_chroma_acts_smoothed
405,6,113.17333333333335,163.76533333333336,50.59200000000001,209,302,93,ki_chroma_acts_smoothed
405,7,163.76533333333336,182.26133333333337,18.49600000000001,302,336,34,ki_chroma_acts_smoothed
405,8,182.26133333333337,219.25333333333336,36.99199999999999,336,404,68,ki_chroma_acts_smoothed
405,9,219.25333333333336,227.393,8.139666666666642,404,417,13,ki_chroma_acts_smoothed
407,1,0.0,17.962666666666664,17.962666666666664,0,32,32,chromagram
407,2,17.962666666666664,36.394666666666666,18.432000000000002,32,64,32,chromagram
407,3,36.394666666666666,54.82666666666667,18.432000000000002,64,96,32,chromagram
407,4,54.82666666666667,111.27466666666666,56.44799999999999,96,194,98,chromagram
407,5,111.27466666666666,127.97866666666665,16.703999999999994,194,223,29,chromagram
407,6,127.97866666666665,146.41066666666666,18.432000000000002,223,255,32,chromagram
407,7,146.41066666666666,163.69066666666663,17.279999999999973,255,285,30,chromagram
407,8,163.69066666666663,219.56266666666664,55.872000000000014,285,382,97,chromagram
407,9,219.56266666666664,237.714,18.151333333333355,382,412,30,chromagram
407,1,0.0,17.962666666666664,17.962666666666664,0,32,32,chroma_acts
407,2,17.962666666666664,41.00266666666666,23.04,32,72,40,chroma_acts
407,3,41.00266666666666,55.97866666666666,14.975999999999999,72,98,26,chroma_acts
407,4,55.97866666666666,73.25866666666667,17.28000000000001,98,128,30,chroma_acts
407,5,73.25866666666667,111.27466666666666,38.01599999999999,128,194,66,chroma_acts
407,6,111.27466666666666,132.58666666666664,21.311999999999983,194,231,37,chroma_acts
407,7,132.58666666666664,146.41066666666666,13.824000000000012,231,255,24,chroma_acts
407,8,146.41066666666666,219.56266666666664,73.15199999999999,255,382,127,chroma_acts
407,9,219.56266666666664,237.714,18.151333333333355,382,412,30,chroma_acts
407,1,0.0,17.386666666666663,17.386666666666663,0,31,31,chroma_acts_smoothed
407,2,17.386666666666663,39.85066666666667,22.464000000000006,31,70,39,chroma_acts_smoothed
407,3,39.85066666666667,55.97866666666666,16.127999999999993,70,98,28,chroma_acts_smoothed
407,4,55.97866666666666,70.95466666666667,14.976000000000006,98,124,26,chroma_acts_smoothed
407,5,70.95466666666667,112.42666666666666,41.471999999999994,124,196,72,chroma_acts_smoothed
407,6,112.42666666666666,132.58666666666664,20.159999999999982,196,231,35,chroma_acts_smoothed
407,7,132.58666666666664,146.41066666666666,13.824000000000012,231,255,24,chroma_acts_smoothed
407,8,146.41066666666666,218.98666666666665,72.576,255,381,126,chroma_acts_smoothed
407,9,218.98666666666665,237.714,18.72733333333335,381,412,31,chroma_acts_smoothed
407,1,0.0,17.962666666666664,17.962666666666664,0,32,32,ki_chroma
407,2,17.962666666666664,36.394666666666666,18.432000000000002,32,64,32,ki_chroma
407,3,36.394666666666666,54.82666666666667,18.432000000000002,64,96,32,ki_chroma
407,4,54.82666666666667,111.27466666666666,56.44799999999999,96,194,98,ki_chroma
407,5,111.27466666666666,127.97866666666665,16.703999999999994,194,223,29,ki_chroma
407,6,127.97866666666665,146.41066666666666,18.432000000000002,223,255,32,ki_chroma
407,7,146.41066666666666,163.69066666666663,17.279999999999973,255,285,30,ki_chroma
407,8,163.69066666666663,219.56266666666664,55.872000000000014,285,382,97,ki_chroma
407,9,219.56266666666664,237.714,18.151333333333355,382,412,30,ki_chroma
407,1,0.0,17.962666666666664,17.962666666666664,0,32,32,ki_chroma_acts
407,2,17.962666666666664,41.00266666666666,23.04,32,72,40,ki_chroma_acts
407,3,41.00266666666666,55.97866666666666,14.975999999999999,72,98,26,ki_chroma_acts
407,4,55.97866666666666,73.25866666666667,17.28000000000001,98,128,30,ki_chroma_acts
407,5,73.25866666666667,111.27466666666666,38.01599999999999,128,194,66,ki_chroma_acts
407,6,111.27466666666666,132.58666666666664,21.311999999999983,194,231,37,ki_chroma_acts
407,7,132.58666666666664,146.41066666666666,13.824000000000012,231,255,24,ki_chroma_acts
407,8,146.41066666666666,219.56266666666664,73.15199999999999,255,382,127,ki_chroma_acts
407,9,219.56266666666664,237.714,18.151333333333355,382,412,30,ki_chroma_acts
407,1,0.0,17.386666666666663,17.386666666666663,0,31,31,ki_chroma_acts_smoothed
407,2,17.386666666666663,39.85066666666667,22.464000000000006,31,70,39,ki_chroma_acts_smoothed
407,3,39.85066666666667,55.97866666666666,16.127999999999993,70,98,28,ki_chroma_acts_smoothed
407,4,55.97866666666666,70.95466666666667,14.976000000000006,98,124,26,ki_chroma_acts_smoothed
407,5,70.95466666666667,112.42666666666666,41.471999999999994,124,196,72,ki_chroma_acts_smoothed
407,6,112.42666666666666,132.58666666666664,20.159999999999982,196,231,35,ki_chroma_acts_smoothed
407,7,132.58666666666664,146.41066666666666,13.824000000000012,231,255,24,ki_chroma_acts_smoothed
407,8,146.41066666666666,218.98666666666665,72.576,255,381,126,ki_chroma_acts_smoothed
407,9,218.98666666666665,237.714,18.72733333333335,381,412,31,ki_chroma_acts_smoothed
410,1,0.0,13.482666666666667,13.482666666666667,0,29,29,chromagram
410,2,13.482666666666667,16.362666666666666,2.879999999999999,29,35,6,chromagram
410,3,16.362666666666666,42.76266666666667,26.400000000000002,35,90,55,chromagram
410,4,42.76266666666667,46.12266666666667,3.3599999999999994,90,97,7,chromagram
410,5,46.12266666666667,77.32266666666666,31.199999999999996,97,162,65,chromagram
410,6,77.32266666666666,103.24266666666666,25.92,162,216,54,chromagram
410,7,103.24266666666666,116.20266666666666,12.959999999999994,216,243,27,chromagram
410,8,116.20266666666666,149.582,33.379333333333335,243,311,68,chromagram
410,1,0.0,13.482666666666667,13.482666666666667,0,29,29,chroma_acts
410,2,13.482666666666667,16.362666666666666,2.879999999999999,29,35,6,chroma_acts
410,3,16.362666666666666,42.76266666666667,26.400000000000002,35,90,55,chroma_acts
410,4,42.76266666666667,46.12266666666667,3.3599999999999994,90,97,7,chroma_acts
410,5,46.12266666666667,77.32266666666666,31.199999999999996,97,162,65,chroma_acts
410,6,77.32266666666666,112.36266666666666,35.03999999999999,162,235,73,chroma_acts
410,7,112.36266666666666,116.20266666666666,3.8400000000000034,235,243,8,chroma_acts
410,8,116.20266666666666,149.582,33.379333333333335,243,311,68,chroma_acts
410,1,0.0,13.962666666666667,13.962666666666667,0,30,30,chroma_acts_smoothed
410,2,13.962666666666667,16.362666666666666,2.3999999999999986,30,35,5,chroma_acts_smoothed
410,3,16.362666666666666,43.242666666666665,26.88,35,91,56,chroma_acts_smoothed
410,4,43.242666666666665,77.32266666666666,34.08,91,162,71,chroma_acts_smoothed
410,5,77.32266666666666,103.72266666666665,26.39999999999999,162,217,55,chroma_acts_smoothed
410,6,103.72266666666665,112.84266666666666,9.120000000000005,217,236,19,chroma_acts_smoothed
410,7,112.84266666666666,115.72266666666665,2.8799999999999955,236,242,6,chroma_acts_smoothed
410,8,115.72266666666665,149.582,33.85933333333334,242,311,69,chroma_acts_smoothed
410,1,0.0,13.482666666666667,13.482666666666667,0,29,29,ki_chroma
410,2,13.482666666666667,16.362666666666666,2.879999999999999,29,35,6,ki_chroma
410,3,16.362666666666666,42.76266666666667,26.400000000000002,35,90,55,ki_chroma
410,4,42.76266666666667,46.12266666666667,3.3599999999999994,90,97,7,ki_chroma
410,5,46.12266666666667,77.32266666666666,31.199999999999996,97,162,65,ki_chroma
410,6,77.32266666666666,103.24266666666666,25.92,162,216,54,ki_chroma
410,7,103.24266666666666,116.20266666666666,12.959999999999994,216,243,27,ki_chroma
410,8,116.20266666666666,149.582,33.379333333333335,243,311,68,ki_chroma
410,1,0.0,13.482666666666667,13.482666666666667,0,29,29,ki_chroma_acts
410,2,13.482666666666667,16.362666666666666,2.879999999999999,29,35,6,ki_chroma_acts
410,3,16.362666666666666,42.76266666666667,26.400000000000002,35,90,55,ki_chroma_acts
410,4,42.76266666666667,46.12266666666667,3.3599999999999994,90,97,7,ki_chroma_acts
410,5,46.12266666666667,77.32266666666666,31.199999999999996,97,162,65,ki_chroma_acts
410,6,77.32266666666666,112.36266666666666,35.03999999999999,162,235,73,ki_chroma_acts
410,7,112.36266666666666,116.20266666666666,3.8400000000000034,235,243,8,ki_chroma_acts
410,8,116.20266666666666,149.582,33.379333333333335,243,311,68,ki_chroma_acts
410,1,0.0,13.962666666666667,13.962666666666667,0,30,30,ki_chroma_acts_smoothed
410,2,13.962666666666667,16.362666666666666,2.3999999999999986,30,35,5,ki_chroma_acts_smoothed
410,3,16.362666666666666,43.242666666666665,26.88,35,91,56,ki_chroma_acts_smoothed
410,4,43.242666666666665,77.32266666666666,34.08,91,162,71,ki_chroma_acts_smoothed
410,5,77.32266666666666,103.72266666666665,26.39999999999999,162,217,55,ki_chroma_acts_smoothed
410,6,103.72266666666665,112.84266666666666,9.120000000000005,217,236,19,ki_chroma_acts_smoothed
410,7,112.84266666666666,115.72266666666665,2.8799999999999955,236,242,6,ki_chroma_acts_smoothed
410,8,115.72266666666665,149.582,33.85933333333334,242,311,69,ki_chroma_acts_smoothed
412,1,0.0,18.741333333333333,18.741333333333333,0,40,40,chromagram
412,2,18.741333333333333,56.66133333333333,37.92,40,119,79,chromagram
412,3,56.66133333333333,76.34133333333334,19.680000000000007,119,160,41,chromagram
412,4,76.34133333333334,125.78133333333334,49.44,160,263,103,chromagram
412,5,125.78133333333334,137.3013333333333,11.519999999999968,263,287,24,chromagram
412,6,137.3013333333333,163.7013333333333,26.400000000000006,287,342,55,chromagram
412,7,163.7013333333333,182.90133333333333,19.200000000000017,342,382,40,chromagram
412,8,182.90133333333333,240.0213333333333,57.119999999999976,382,501,119,chromagram
412,9,240.0213333333333,252.826,12.80466666666669,501,526,25,chromagram
412,1,0.0,18.741333333333333,18.741333333333333,0,40,40,chroma_acts
412,2,18.741333333333333,125.78133333333334,107.04,40,263,223,chroma_acts
412,3,125.78133333333334,137.3013333333333,11.519999999999968,263,287,24,chroma_acts
412,4,137.3013333333333,140.66133333333332,3.3600000000000136,287,294,7,chroma_acts
412,5,140.66133333333332,144.50133333333332,3.8400000000000034,294,302,8,chroma_acts
412,6,144.50133333333332,148.34133333333332,3.8400000000000034,302,310,8,chroma_acts
412,7,148.34133333333332,152.18133333333333,3.8400000000000034,310,318,8,chroma_acts
412,8,152.18133333333333,156.0213333333333,3.839999999999975,318,326,8,chroma_acts
412,9,156.0213333333333,252.826,96.80466666666669,326,526,200,chroma_acts
412,1,0.0,18.741333333333333,18.741333333333333,0,40,40,chroma_acts_smoothed
412,2,18.741333333333333,125.78133333333334,107.04,40,263,223,chroma_acts_smoothed
412,3,125.78133333333334,136.8213333333333,11.039999999999978,263,286,23,chroma_acts_smoothed
412,4,136.8213333333333,141.1413333333333,4.319999999999993,286,295,9,chroma_acts_smoothed
412,5,141.1413333333333,144.50133333333332,3.3600000000000136,295,302,7,chroma_acts_smoothed
412,6,144.50133333333332,159.8613333333333,15.359999999999985,302,334,32,chroma_acts_smoothed
412,7,159.8613333333333,163.7013333333333,3.8400000000000034,334,342,8,chroma_acts_smoothed
412,8,163.7013333333333,167.5413333333333,3.8400000000000034,342,350,8,chroma_acts_smoothed
412,9,167.5413333333333,252.826,85.28466666666668,350,526,176,chroma_acts_smoothed
412,1,0.0,18.741333333333333,18.741333333333333,0,40,40,ki_chroma
412,2,18.741333333333333,56.66133333333333,37.92,40,119,79,ki_chroma
412,3,56.66133333333333,76.34133333333334,19.680000000000007,119,160,41,ki_chroma
412,4,76.34133333333334,125.78133333333334,49.44,160,263,103,ki_chroma
412,5,125.78133333333334,137.3013333333333,11.519999999999968,263,287,24,ki_chroma
412,6,137.3013333333333,163.7013333333333,26.400000000000006,287,342,55,ki_chroma
412,7,163.7013333333333,182.90133333333333,19.200000000000017,342,382,40,ki_chroma
412,8,182.90133333333333,240.0213333333333,57.119999999999976,382,501,119,ki_chroma
412,9,240.0213333333333,252.826,12.80466666666669,501,526,25,ki_chroma
412,1,0.0,18.741333333333333,18.741333333333333,0,40,40,ki_chroma_acts
412,2,18.741333333333333,125.78133333333334,107.04,40,263,223,ki_chroma_acts
412,3,125.78133333333334,137.3013333333333,11.519999999999968,263,287,24,ki_chroma_acts
412,4,137.3013333333333,140.66133333333332,3.3600000000000136,287,294,7,ki_chroma_acts
412,5,140.66133333333332,144.50133333333332,3.8400000000000034,294,302,8,ki_chroma_acts
412,6,144.50133333333332,148.34133333333332,3.8400000000000034,302,310,8,ki_chroma_acts
412,7,148.34133333333332,152.18133333333333,3.8400000000000034,310,318,8,ki_chroma_acts
412,8,152.18133333333333,156.0213333333333,3.839999999999975,318,326,8,ki_chroma_acts
412,9,156.0213333333333,252.826,96.80466666666669,326,526,200,ki_chroma_acts
412,1,0.0,18.741333333333333,18.741333333333333,0,40,40,ki_chroma_acts_smoothed
412,2,18.741333333333333,125.78133333333334,107.04,40,263,223,ki_chroma_acts_smoothed
412,3,125.78133333333334,136.8213333333333,11.039999999999978,263,286,23,ki_chroma_acts_smoothed
412,4,136.8213333333333,141.1413333333333,4.319999999999993,286,295,9,ki_chroma_acts_smoothed
412,5,141.1413333333333,144.50133333333332,3.3600000000000136,295,302,7,ki_chroma_acts_smoothed
412,6,144.50133333333332,159.8613333333333,15.359999999999985,302,334,32,ki_chroma_acts_smoothed
412,7,159.8613333333333,163.7013333333333,3.8400000000000034,334,342,8,ki_chroma_acts_smoothed
412,8,163.7013333333333,167.5413333333333,3.8400000000000034,342,350,8,ki_chroma_acts_smoothed
412,9,167.5413333333333,252.826,85.28466666666668,350,526,176,ki_chroma_acts_smoothed
413,1,0.0,5.834666666666667,5.834666666666667,0,10,10,chromagram
413,2,5.834666666666667,41.077333333333335,35.242666666666665,10,69,59,chromagram
413,3,41.077333333333335,53.024,11.946666666666665,69,89,20,chromagram
413,4,53.024,95.43466666666669,42.410666666666685,89,160,71,chromagram
413,5,95.43466666666669,131.872,36.43733333333333,160,221,61,chromagram
413,6,131.872,134.85866666666666,2.9866666666666504,221,226,5,chromagram
413,7,134.85866666666666,164.12800000000001,29.26933333333335,226,275,49,chromagram
413,8,164.12800000000001,208.92800000000003,44.80000000000001,275,350,75,chromagram
413,9,208.92800000000003,224.074,15.145999999999987,350,374,24,chromagram
413,1,0.0,5.834666666666667,5.834666666666667,0,10,10,chroma_acts
413,2,5.834666666666667,42.272000000000006,36.43733333333334,10,71,61,chroma_acts
413,3,42.272000000000006,53.024,10.751999999999995,71,89,18,chroma_acts
413,4,53.024,95.43466666666669,42.410666666666685,89,160,71,chroma_acts
413,5,95.43466666666669,131.872,36.43733333333333,160,221,61,chroma_acts
413,6,131.872,135.45600000000002,3.584000000000003,221,227,6,chroma_acts
413,7,135.45600000000002,164.12800000000001,28.671999999999997,227,275,48,chroma_acts
413,8,164.12800000000001,208.92800000000003,44.80000000000001,275,350,75,chroma_acts
413,9,208.92800000000003,224.074,15.145999999999987,350,374,24,chroma_acts
413,1,0.0,5.834666666666667,5.834666666666667,0,10,10,chroma_acts_smoothed
413,2,5.834666666666667,41.077333333333335,35.242666666666665,10,69,59,chroma_acts_smoothed
413,3,41.077333333333335,53.024,11.946666666666665,69,89,20,chroma_acts_smoothed
413,4,53.024,94.24000000000001,41.21600000000001,89,158,69,chroma_acts_smoothed
413,5,94.24000000000001,130.67733333333334,36.43733333333333,158,219,61,chroma_acts_smoothed
413,6,130.67733333333334,136.05333333333334,5.376000000000005,219,228,9,chroma_acts_smoothed
413,7,136.05333333333334,164.12800000000001,28.074666666666673,228,275,47,chroma_acts_smoothed
413,8,164.12800000000001,209.52533333333335,45.397333333333336,275,351,76,chroma_acts_smoothed
413,9,209.52533333333335,224.074,14.548666666666662,351,374,23,chroma_acts_smoothed
413,1,0.0,5.834666666666667,5.834666666666667,0,10,10,ki_chroma
413,2,5.834666666666667,41.077333333333335,35.242666666666665,10,69,59,ki_chroma
413,3,41.077333333333335,53.024,11.946666666666665,69,89,20,ki_chroma
413,4,53.024,95.43466666666669,42.410666666666685,89,160,71,ki_chroma
413,5,95.43466666666669,131.872,36.43733333333333,160,221,61,ki_chroma
413,6,131.872,134.85866666666666,2.9866666666666504,221,226,5,ki_chroma
413,7,134.85866666666666,164.12800000000001,29.26933333333335,226,275,49,ki_chroma
413,8,164.12800000000001,208.92800000000003,44.80000000000001,275,350,75,ki_chroma
413,9,208.92800000000003,224.074,15.145999999999987,350,374,24,ki_chroma
413,1,0.0,5.834666666666667,5.834666666666667,0,10,10,ki_chroma_acts
413,2,5.834666666666667,42.272000000000006,36.43733333333334,10,71,61,ki_chroma_acts
413,3,42.272000000000006,53.024,10.751999999999995,71,89,18,ki_chroma_acts
413,4,53.024,95.43466666666669,42.410666666666685,89,160,71,ki_chroma_acts
413,5,95.43466666666669,131.872,36.43733333333333,160,221,61,ki_chroma_acts
413,6,131.872,135.45600000000002,3.584000000000003,221,227,6,ki_chroma_acts
413,7,135.45600000000002,164.12800000000001,28.671999999999997,227,275,48,ki_chroma_acts
413,8,164.12800000000001,208.92800000000003,44.80000000000001,275,350,75,ki_chroma_acts
413,9,208.92800000000003,224.074,15.145999999999987,350,374,24,ki_chroma_acts
413,1,0.0,5.834666666666667,5.834666666666667,0,10,10,ki_chroma_acts_smoothed
413,2,5.834666666666667,41.077333333333335,35.242666666666665,10,69,59,ki_chroma_acts_smoothed
413,3,41.077333333333335,53.024,11.946666666666665,69,89,20,ki_chroma_acts_smoothed
413,4,53.024,94.24000000000001,41.21600000000001,89,158,69,ki_chroma_acts_smoothed
413,5,94.24000000000001,130.67733333333334,36.43733333333333,158,219,61,ki_chroma_acts_smoothed
413,6,130.67733333333334,136.05333333333334,5.376000000000005,219,228,9,ki_chroma_acts_smoothed
413,7,136.05333333333334,164.12800000000001,28.074666666666673,228,275,47,ki_chroma_acts_smoothed
413,8,164.12800000000001,209.52533333333335,45.397333333333336,275,351,76,ki_chroma_acts_smoothed
413,9,209.52533333333335,224.074,14.548666666666662,351,374,23,ki_chroma_acts_smoothed
415,1,0.0,46.218666666666664,46.218666666666664,0,82,82,chromagram
415,2,46.218666666666664,62.048,15.829333333333338,82,110,28,chromagram
415,3,62.048,100.49066666666667,38.44266666666667,110,178,68,chromagram
415,4,100.49066666666667,137.23733333333334,36.74666666666667,178,243,65,chromagram
415,5,137.23733333333334,150.80533333333335,13.568000000000012,243,267,24,chromagram
415,6,150.80533333333335,164.37333333333336,13.568000000000012,267,291,24,chromagram
415,7,164.37333333333336,210.16533333333336,45.792,291,372,81,chromagram
415,8,210.16533333333336,228.82133333333334,18.655999999999977,372,405,33,chromagram
415,9,228.82133333333334,238.761,9.939666666666653,405,421,16,chromagram
415,1,0.0,46.218666666666664,46.218666666666664,0,82,82,chroma_acts
415,2,46.218666666666664,59.78666666666667,13.568000000000005,82,106,24,chroma_acts
415,3,59.78666666666667,100.49066666666667,40.704,106,178,72,chroma_acts
415,4,100.49066666666667,133.28,32.78933333333333,178,236,58,chroma_acts
415,5,133.28,137.23733333333334,3.957333333333338,236,243,7,chroma_acts
415,6,137.23733333333334,150.80533333333335,13.568000000000012,243,267,24,chroma_acts
415,7,150.80533333333335,210.16533333333336,59.360000000000014,267,372,105,chroma_acts
415,8,210.16533333333336,228.82133333333334,18.655999999999977,372,405,33,chroma_acts
415,9,228.82133333333334,238.761,9.939666666666653,405,421,16,chroma_acts
415,1,0.0,43.392,43.392,0,77,77,chroma_acts_smoothed
415,2,43.392,63.178666666666665,19.78666666666666,77,112,35,chroma_acts_smoothed
415,3,63.178666666666665,100.49066666666667,37.312000000000005,112,178,66,chroma_acts_smoothed
415,4,100.49066666666667,133.84533333333334,33.354666666666674,178,237,59,chroma_acts_smoothed
415,5,133.84533333333334,136.67200000000003,2.826666666666682,237,242,5,chroma_acts_smoothed
415,6,136.67200000000003,150.80533333333335,14.133333333333326,242,267,25,chroma_acts_smoothed
415,7,150.80533333333335,210.16533333333336,59.360000000000014,267,372,105,chroma_acts_smoothed
415,8,210.16533333333336,228.82133333333334,18.655999999999977,372,405,33,chroma_acts_smoothed
415,9,228.82133333333334,238.761,9.939666666666653,405,421,16,chroma_acts_smoothed
415,1,0.0,46.218666666666664,46.218666666666664,0,82,82,ki_chroma
415,2,46.218666666666664,62.048,15.829333333333338,82,110,28,ki_chroma
415,3,62.048,100.49066666666667,38.44266666666667,110,178,68,ki_chroma
415,4,100.49066666666667,137.23733333333334,36.74666666666667,178,243,65,ki_chroma
415,5,137.23733333333334,150.80533333333335,13.568000000000012,243,267,24,ki_chroma
415,6,150.80533333333335,164.37333333333336,13.568000000000012,267,291,24,ki_chroma
415,7,164.37333333333336,210.16533333333336,45.792,291,372,81,ki_chroma
415,8,210.16533333333336,228.82133333333334,18.655999999999977,372,405,33,ki_chroma
415,9,228.82133333333334,238.761,9.939666666666653,405,421,16,ki_chroma
415,1,0.0,46.218666666666664,46.218666666666664,0,82,82,ki_chroma_acts
415,2,46.218666666666664,59.78666666666667,13.568000000000005,82,106,24,ki_chroma_acts
415,3,59.78666666666667,100.49066666666667,40.704,106,178,72,ki_chroma_acts
415,4,100.49066666666667,133.28,32.78933333333333,178,236,58,ki_chroma_acts
415,5,133.28,137.23733333333334,3.957333333333338,236,243,7,ki_chroma_acts
415,6,137.23733333333334,150.80533333333335,13.568000000000012,243,267,24,ki_chroma_acts
415,7,150.80533333333335,210.16533333333336,59.360000000000014,267,372,105,ki_chroma_acts
415,8,210.16533333333336,228.82133333333334,18.655999999999977,372,405,33,ki_chroma_acts
415,9,228.82133333333334,238.761,9.939666666666653,405,421,16,ki_chroma_acts
415,1,0.0,43.392,43.392,0,77,77,ki_chroma_acts_smoothed
415,2,43.392,63.178666666666665,19.78666666666666,77,112,35,ki_chroma_acts_smoothed
415,3,63.178666666666665,100.49066666666667,37.312000000000005,112,178,66,ki_chroma_acts_smoothed
415,4,100.49066666666667,133.84533333333334,33.354666666666674,178,237,59,ki_chroma_acts_smoothed
415,5,133.84533333333334,136.67200000000003,2.826666666666682,237,242,5,ki_chroma_acts_smoothed
415,6,136.67200000000003,150.80533333333335,14.133333333333326,242,267,25,ki_chroma_acts_smoothed
415,7,150.80533333333335,210.16533333333336,59.360000000000014,267,372,105,ki_chroma_acts_smoothed
415,8,210.16533333333336,228.82133333333334,18.655999999999977,372,405,33,ki_chroma_acts_smoothed
415,9,228.82133333333334,238.761,9.939666666666653,405,421,16,ki_chroma_acts_smoothed
416,1,0.0,14.656,14.656,0,32,32,chromagram
416,2,14.656,26.389333333333333,11.733333333333333,32,57,25,chromagram
416,3,26.389333333333333,60.181333333333335,33.792,57,129,72,chromagram
416,4,60.181333333333335,64.40533333333333,4.223999999999997,129,138,9,chromagram
416,5,64.40533333333333,68.16,3.7546666666666653,138,146,8,chromagram
416,6,68.16,74.73066666666666,6.570666666666668,146,160,14,chromagram
416,7,74.73066666666666,78.95466666666667,4.224000000000004,160,169,9,chromagram
416,8,78.95466666666667,117.44,38.48533333333333,169,251,82,chromagram
416,9,117.44,136.063,18.62299999999999,251,289,38,chromagram
416,1,0.0,14.656,14.656,0,32,32,chroma_acts
416,2,14.656,60.181333333333335,45.525333333333336,32,129,97,chroma_acts
416,3,60.181333333333335,64.40533333333333,4.223999999999997,129,138,9,chroma_acts
416,4,64.40533333333333,68.16,3.7546666666666653,138,146,8,chroma_acts
416,5,68.16,74.73066666666666,6.570666666666668,146,160,14,chroma_acts
416,6,74.73066666666666,78.95466666666667,4.224000000000004,160,169,9,chroma_acts
416,7,78.95466666666667,105.70666666666666,26.751999999999995,169,226,57,chroma_acts
416,8,105.70666666666666,117.44,11.733333333333334,226,251,25,chroma_acts
416,9,117.44,136.063,18.62299999999999,251,289,38,chroma_acts
416,1,0.0,15.125333333333334,15.125333333333334,0,33,33,chroma_acts_smoothed
416,2,15.125333333333334,60.181333333333335,45.056,33,129,96,chroma_acts_smoothed
416,3,60.181333333333335,64.40533333333333,4.223999999999997,129,138,9,chroma_acts_smoothed
416,4,64.40533333333333,68.16,3.7546666666666653,138,146,8,chroma_acts_smoothed
416,5,68.16,74.73066666666666,6.570666666666668,146,160,14,chroma_acts_smoothed
416,6,74.73066666666666,78.95466666666667,4.224000000000004,160,169,9,chroma_acts_smoothed
416,7,78.95466666666667,105.23733333333334,26.28266666666667,169,225,56,chroma_acts_smoothed
416,8,105.23733333333334,117.44,12.202666666666659,225,251,26,chroma_acts_smoothed
416,9,117.44,136.063,18.62299999999999,251,289,38,chroma_acts_smoothed
416,1,0.0,14.656,14.656,0,32,32,ki_chroma
416,2,14.656,26.389333333333333,11.733333333333333,32,57,25,ki_chroma
416,3,26.389333333333333,60.181333333333335,33.792,57,129,72,ki_chroma
416,4,60.181333333333335,64.40533333333333,4.223999999999997,129,138,9,ki_chroma
416,5,64.40533333333333,68.16,3.7546666666666653,138,146,8,ki_chroma
416,6,68.16,74.73066666666666,6.570666666666668,146,160,14,ki_chroma
416,7,74.73066666666666,78.95466666666667,4.224000000000004,160,169,9,ki_chroma
416,8,78.95466666666667,117.44,38.48533333333333,169,251,82,ki_chroma
416,9,117.44,136.063,18.62299999999999,251,289,38,ki_chroma
416,1,0.0,14.656,14.656,0,32,32,ki_chroma_acts
416,2,14.656,60.181333333333335,45.525333333333336,32,129,97,ki_chroma_acts
416,3,60.181333333333335,64.40533333333333,4.223999999999997,129,138,9,ki_chroma_acts
416,4,64.40533333333333,68.16,3.7546666666666653,138,146,8,ki_chroma_acts
416,5,68.16,74.73066666666666,6.570666666666668,146,160,14,ki_chroma_acts
416,6,74.73066666666666,78.95466666666667,4.224000000000004,160,169,9,ki_chroma_acts
416,7,78.95466666666667,105.70666666666666,26.751999999999995,169,226,57,ki_chroma_acts
416,8,105.70666666666666,117.44,11.733333333333334,226,251,25,ki_chroma_acts
416,9,117.44,136.063,18.62299999999999,251,289,38,ki_chroma_acts
416,1,0.0,15.125333333333334,15.125333333333334,0,33,33,ki_chroma_acts_smoothed
416,2,15.125333333333334,60.181333333333335,45.056,33,129,96,ki_chroma_acts_smoothed
416,3,60.181333333333335,64.40533333333333,4.223999999999997,129,138,9,ki_chroma_acts_smoothed
416,4,64.40533333333333,68.16,3.7546666666666653,138,146,8,ki_chroma_acts_smoothed
416,5,68.16,74.73066666666666,6.570666666666668,146,160,14,ki_chroma_acts_smoothed
416,6,74.73066666666666,78.95466666666667,4.224000000000004,160,169,9,ki_chroma_acts_smoothed
416,7,78.95466666666667,105.23733333333334,26.28266666666667,169,225,56,ki_chroma_acts_smoothed
416,8,105.23733333333334,117.44,12.202666666666659,225,251,26,ki_chroma_acts_smoothed
416,9,117.44,136.063,18.62299999999999,251,289,38,ki_chroma_acts_smoothed
418,1,0.0,3.8506666666666667,3.8506666666666667,0,9,9,chromagram
418,2,3.8506666666666667,29.290666666666667,25.44,9,62,53,chromagram
418,3,29.290666666666667,61.45066666666666,32.16,62,129,67,chromagram
418,4,61.45066666666666,91.21066666666665,29.75999999999999,129,191,62,chromagram
418,5,91.21066666666665,98.41066666666666,7.200000000000003,191,206,15,chromagram
418,6,98.41066666666666,99.85066666666665,1.4399999999999977,206,209,3,chromagram
418,7,99.85066666666665,132.757,32.90633333333335,209,276,67,chromagram
418,1,0.0,3.8506666666666667,3.8506666666666667,0,9,9,chroma_acts
418,2,3.8506666666666667,6.730666666666666,2.8799999999999994,9,15,6,chroma_acts
418,3,6.730666666666666,11.530666666666667,4.800000000000001,15,25,10,chroma_acts
418,4,11.530666666666667,30.730666666666664,19.199999999999996,25,65,40,chroma_acts
418,5,30.730666666666664,91.21066666666665,60.47999999999999,65,191,126,chroma_acts
418,6,91.21066666666665,99.85066666666665,8.64,191,209,18,chroma_acts
418,7,99.85066666666665,132.757,32.90633333333335,209,276,67,chroma_acts
418,1,0.0,3.8506666666666667,3.8506666666666667,0,9,9,chroma_acts_smoothed
418,2,3.8506666666666667,6.730666666666666,2.8799999999999994,9,15,6,chroma_acts_smoothed
418,3,6.730666666666666,11.530666666666667,4.800000000000001,15,25,10,chroma_acts_smoothed
418,4,11.530666666666667,14.410666666666666,2.879999999999999,25,31,6,chroma_acts_smoothed
418,5,14.410666666666666,32.650666666666666,18.240000000000002,31,69,38,chroma_acts_smoothed
418,6,32.650666666666666,91.69066666666666,59.03999999999999,69,192,123,chroma_acts_smoothed
418,7,91.69066666666666,99.85066666666665,8.159999999999997,192,209,17,chroma_acts_smoothed
418,8,99.85066666666665,132.757,32.90633333333335,209,276,67,chroma_acts_smoothed
418,1,0.0,3.8506666666666667,3.8506666666666667,0,9,9,ki_chroma
418,2,3.8506666666666667,29.290666666666667,25.44,9,62,53,ki_chroma
418,3,29.290666666666667,61.45066666666666,32.16,62,129,67,ki_chroma
418,4,61.45066666666666,91.21066666666665,29.75999999999999,129,191,62,ki_chroma
418,5,91.21066666666665,98.41066666666666,7.200000000000003,191,206,15,ki_chroma
418,6,98.41066666666666,99.85066666666665,1.4399999999999977,206,209,3,ki_chroma
418,7,99.85066666666665,132.757,32.90633333333335,209,276,67,ki_chroma
418,1,0.0,3.8506666666666667,3.8506666666666667,0,9,9,ki_chroma_acts
418,2,3.8506666666666667,6.730666666666666,2.8799999999999994,9,15,6,ki_chroma_acts
418,3,6.730666666666666,11.530666666666667,4.800000000000001,15,25,10,ki_chroma_acts
418,4,11.530666666666667,30.730666666666664,19.199999999999996,25,65,40,ki_chroma_acts
418,5,30.730666666666664,91.21066666666665,60.47999999999999,65,191,126,ki_chroma_acts
418,6,91.21066666666665,99.85066666666665,8.64,191,209,18,ki_chroma_acts
418,7,99.85066666666665,132.757,32.90633333333335,209,276,67,ki_chroma_acts
418,1,0.0,3.8506666666666667,3.8506666666666667,0,9,9,ki_chroma_acts_smoothed
418,2,3.8506666666666667,6.730666666666666,2.8799999999999994,9,15,6,ki_chroma_acts_smoothed
418,3,6.730666666666666,11.530666666666667,4.800000000000001,15,25,10,ki_chroma_acts_smoothed
418,4,11.530666666666667,14.410666666666666,2.879999999999999,25,31,6,ki_chroma_acts_smoothed
418,5,14.410666666666666,32.650666666666666,18.240000000000002,31,69,38,ki_chroma_acts_smoothed
418,6,32.650666666666666,91.69066666666666,59.03999999999999,69,192,123,ki_chroma_acts_smoothed
418,7,91.69066666666666,99.85066666666665,8.159999999999997,192,209,17,ki_chroma_acts_smoothed
418,8,99.85066666666665,132.757,32.90633333333335,209,276,67,ki_chroma_acts_smoothed
420,1,0.0,12.255999999999998,12.255999999999998,0,27,27,chromagram
420,2,12.255999999999998,18.357333333333333,6.101333333333335,27,40,13,chromagram
420,3,18.357333333333333,32.437333333333335,14.080000000000002,40,70,30,chromagram
420,4,32.437333333333335,77.96266666666666,45.52533333333333,70,167,97,chromagram
420,5,77.96266666666666,85.94133333333333,7.978666666666669,167,184,17,chromagram
420,6,85.94133333333333,101.42933333333333,15.488,184,217,33,chromagram
420,7,101.42933333333333,114.57066666666667,13.141333333333336,217,245,28,chromagram
420,8,114.57066666666667,133.34400000000002,18.773333333333355,245,285,40,chromagram
420,9,133.34400000000002,179.278,45.93399999999997,285,381,96,chromagram
420,1,0.0,12.255999999999998,12.255999999999998,0,27,27,chroma_acts
420,2,12.255999999999998,20.234666666666666,7.978666666666667,27,44,17,chroma_acts
420,3,20.234666666666666,32.437333333333335,12.20266666666667,44,70,26,chroma_acts
420,4,32.437333333333335,78.432,45.99466666666667,70,168,98,chroma_acts
420,5,78.432,85.94133333333333,7.5093333333333305,168,184,16,chroma_acts
420,6,85.94133333333333,101.42933333333333,15.488,184,217,33,chroma_acts
420,7,101.42933333333333,114.57066666666667,13.141333333333336,217,245,28,chroma_acts
420,8,114.57066666666667,133.34400000000002,18.773333333333355,245,285,40,chroma_acts
420,9,133.34400000000002,179.278,45.93399999999997,285,381,96,chroma_acts
420,1,0.0,12.255999999999998,12.255999999999998,0,27,27,chroma_acts_smoothed
420,2,12.255999999999998,26.805333333333333,14.549333333333335,27,58,31,chroma_acts_smoothed
420,3,26.805333333333333,32.437333333333335,5.6320000000000014,58,70,12,chroma_acts_smoothed
420,4,32.437333333333335,77.96266666666666,45.52533333333333,70,167,97,chroma_acts_smoothed
420,5,77.96266666666666,85.94133333333333,7.978666666666669,167,184,17,chroma_acts_smoothed
420,6,85.94133333333333,101.42933333333333,15.488,184,217,33,chroma_acts_smoothed
420,7,101.42933333333333,114.57066666666667,13.141333333333336,217,245,28,chroma_acts_smoothed
420,8,114.57066666666667,133.34400000000002,18.773333333333355,245,285,40,chroma_acts_smoothed
420,9,133.34400000000002,179.278,45.93399999999997,285,381,96,chroma_acts_smoothed
420,1,0.0,12.255999999999998,12.255999999999998,0,27,27,ki_chroma
420,2,12.255999999999998,18.357333333333333,6.101333333333335,27,40,13,ki_chroma
420,3,18.357333333333333,32.437333333333335,14.080000000000002,40,70,30,ki_chroma
420,4,32.437333333333335,77.96266666666666,45.52533333333333,70,167,97,ki_chroma
420,5,77.96266666666666,85.94133333333333,7.978666666666669,167,184,17,ki_chroma
420,6,85.94133333333333,101.42933333333333,15.488,184,217,33,ki_chroma
420,7,101.42933333333333,114.57066666666667,13.141333333333336,217,245,28,ki_chroma
420,8,114.57066666666667,133.34400000000002,18.773333333333355,245,285,40,ki_chroma
420,9,133.34400000000002,179.278,45.93399999999997,285,381,96,ki_chroma
420,1,0.0,12.255999999999998,12.255999999999998,0,27,27,ki_chroma_acts
420,2,12.255999999999998,20.234666666666666,7.978666666666667,27,44,17,ki_chroma_acts
420,3,20.234666666666666,32.437333333333335,12.20266666666667,44,70,26,ki_chroma_acts
420,4,32.437333333333335,78.432,45.99466666666667,70,168,98,ki_chroma_acts
420,5,78.432,85.94133333333333,7.5093333333333305,168,184,16,ki_chroma_acts
420,6,85.94133333333333,101.42933333333333,15.488,184,217,33,ki_chroma_acts
420,7,101.42933333333333,114.57066666666667,13.141333333333336,217,245,28,ki_chroma_acts
420,8,114.57066666666667,133.34400000000002,18.773333333333355,245,285,40,ki_chroma_acts
420,9,133.34400000000002,179.278,45.93399999999997,285,381,96,ki_chroma_acts
420,1,0.0,12.255999999999998,12.255999999999998,0,27,27,ki_chroma_acts_smoothed
420,2,12.255999999999998,26.805333333333333,14.549333333333335,27,58,31,ki_chroma_acts_smoothed
420,3,26.805333333333333,32.437333333333335,5.6320000000000014,58,70,12,ki_chroma_acts_smoothed
420,4,32.437333333333335,77.96266666666666,45.52533333333333,70,167,97,ki_chroma_acts_smoothed
420,5,77.96266666666666,85.94133333333333,7.978666666666669,167,184,17,ki_chroma_acts_smoothed
420,6,85.94133333333333,101.42933333333333,15.488,184,217,33,ki_chroma_acts_smoothed
420,7,101.42933333333333,114.57066666666667,13.141333333333336,217,245,28,ki_chroma_acts_smoothed
420,8,114.57066666666667,133.34400000000002,18.773333333333355,245,285,40,ki_chroma_acts_smoothed
420,9,133.34400000000002,179.278,45.93399999999997,285,381,96,ki_chroma_acts_smoothed
421,1,0.0,15.157333333333332,15.157333333333332,0,32,32,chromagram
421,2,15.157333333333332,30.517333333333333,15.360000000000001,32,64,32,chromagram
421,3,30.517333333333333,76.11733333333333,45.6,64,159,95,chromagram
421,4,76.11733333333333,91.47733333333333,15.36,159,191,32,chromagram
421,5,91.47733333333333,106.83733333333333,15.36,191,223,32,chromagram
421,6,106.83733333333333,123.63733333333333,16.799999999999997,223,258,35,chromagram
421,7,123.63733333333333,152.43733333333333,28.799999999999997,258,318,60,chromagram
421,8,152.43733333333333,166.83733333333333,14.400000000000006,318,348,30,chromagram
421,9,166.83733333333333,182.852,16.01466666666667,348,380,32,chromagram
421,1,0.0,15.157333333333332,15.157333333333332,0,32,32,chroma_acts
421,2,15.157333333333332,30.517333333333333,15.360000000000001,32,64,32,chroma_acts
421,3,30.517333333333333,76.11733333333333,45.6,64,159,95,chroma_acts
421,4,76.11733333333333,91.47733333333333,15.36,159,191,32,chroma_acts
421,5,91.47733333333333,106.83733333333333,15.36,191,223,32,chroma_acts
421,6,106.83733333333333,123.63733333333333,16.799999999999997,223,258,35,chroma_acts
421,7,123.63733333333333,150.99733333333333,27.36,258,315,57,chroma_acts
421,8,150.99733333333333,167.31733333333332,16.319999999999993,315,349,34,chroma_acts
421,9,167.31733333333332,182.852,15.53466666666668,349,380,31,chroma_acts
421,1,0.0,15.157333333333332,15.157333333333332,0,32,32,chroma_acts_smoothed
421,2,15.157333333333332,30.517333333333333,15.360000000000001,32,64,32,chroma_acts_smoothed
421,3,30.517333333333333,76.11733333333333,45.6,64,159,95,chroma_acts_smoothed
421,4,76.11733333333333,90.99733333333333,14.879999999999995,159,190,31,chroma_acts_smoothed
421,5,90.99733333333333,107.31733333333332,16.319999999999993,190,224,34,chroma_acts_smoothed
421,6,107.31733333333332,124.11733333333332,16.799999999999997,224,259,35,chroma_acts_smoothed
421,7,124.11733333333332,150.5173333333333,26.39999999999999,259,314,55,chroma_acts_smoothed
421,8,150.5173333333333,167.7973333333333,17.28,314,350,36,chroma_acts_smoothed
421,9,167.7973333333333,182.852,15.05466666666669,350,380,30,chroma_acts_smoothed
421,1,0.0,15.157333333333332,15.157333333333332,0,32,32,ki_chroma
421,2,15.157333333333332,30.517333333333333,15.360000000000001,32,64,32,ki_chroma
421,3,30.517333333333333,76.11733333333333,45.6,64,159,95,ki_chroma
421,4,76.11733333333333,91.47733333333333,15.36,159,191,32,ki_chroma
421,5,91.47733333333333,106.83733333333333,15.36,191,223,32,ki_chroma
421,6,106.83733333333333,123.63733333333333,16.799999999999997,223,258,35,ki_chroma
421,7,123.63733333333333,152.43733333333333,28.799999999999997,258,318,60,ki_chroma
421,8,152.43733333333333,166.83733333333333,14.400000000000006,318,348,30,ki_chroma
421,9,166.83733333333333,182.852,16.01466666666667,348,380,32,ki_chroma
421,1,0.0,15.157333333333332,15.157333333333332,0,32,32,ki_chroma_acts
421,2,15.157333333333332,30.517333333333333,15.360000000000001,32,64,32,ki_chroma_acts
421,3,30.517333333333333,76.11733333333333,45.6,64,159,95,ki_chroma_acts
421,4,76.11733333333333,91.47733333333333,15.36,159,191,32,ki_chroma_acts
421,5,91.47733333333333,106.83733333333333,15.36,191,223,32,ki_chroma_acts
421,6,106.83733333333333,123.63733333333333,16.799999999999997,223,258,35,ki_chroma_acts
421,7,123.63733333333333,150.99733333333333,27.36,258,315,57,ki_chroma_acts
421,8,150.99733333333333,167.31733333333332,16.319999999999993,315,349,34,ki_chroma_acts
421,9,167.31733333333332,182.852,15.53466666666668,349,380,31,ki_chroma_acts
421,1,0.0,15.157333333333332,15.157333333333332,0,32,32,ki_chroma_acts_smoothed
421,2,15.157333333333332,30.517333333333333,15.360000000000001,32,64,32,ki_chroma_acts_smoothed
421,3,30.517333333333333,76.11733333333333,45.6,64,159,95,ki_chroma_acts_smoothed
421,4,76.11733333333333,90.99733333333333,14.879999999999995,159,190,31,ki_chroma_acts_smoothed
421,5,90.99733333333333,107.31733333333332,16.319999999999993,190,224,34,ki_chroma_acts_smoothed
421,6,107.31733333333332,124.11733333333332,16.799999999999997,224,259,35,ki_chroma_acts_smoothed
421,7,124.11733333333332,150.5173333333333,26.39999999999999,259,314,55,ki_chroma_acts_smoothed
421,8,150.5173333333333,167.7973333333333,17.28,314,350,36,ki_chroma_acts_smoothed
421,9,167.7973333333333,182.852,15.05466666666669,350,380,30,ki_chroma_acts_smoothed
422,1,0.0,14.197333333333333,14.197333333333333,0,30,30,chromagram
422,2,14.197333333333333,29.557333333333332,15.36,30,62,32,chromagram
422,3,29.557333333333332,78.03733333333334,48.480000000000004,62,163,101,chromagram
422,4,78.03733333333334,84.75733333333334,6.719999999999999,163,177,14,chromagram
422,5,84.75733333333334,105.87733333333334,21.120000000000005,177,221,44,chromagram
422,6,105.87733333333334,121.23733333333334,15.36,221,253,32,chromagram
422,7,121.23733333333334,149.55733333333333,28.319999999999993,253,312,59,chromagram
422,8,149.55733333333333,152.91733333333335,3.3600000000000136,312,319,7,chromagram
422,9,152.91733333333335,170.766,17.848666666666645,319,355,36,chromagram
422,1,0.0,14.197333333333333,14.197333333333333,0,30,30,chroma_acts
422,2,14.197333333333333,30.51733333333333,16.319999999999997,30,64,34,chroma_acts
422,3,30.51733333333333,78.03733333333334,47.52000000000001,64,163,99,chroma_acts
422,4,78.03733333333334,84.75733333333334,6.719999999999999,163,177,14,chroma_acts
422,5,84.75733333333334,105.87733333333334,21.120000000000005,177,221,44,chroma_acts
422,6,105.87733333333334,126.03733333333334,20.159999999999997,221,263,42,chroma_acts
422,7,126.03733333333334,149.07733333333334,23.040000000000006,263,311,48,chroma_acts
422,8,149.07733333333334,153.87733333333333,4.799999999999983,311,321,10,chroma_acts
422,9,153.87733333333333,170.766,16.888666666666666,321,355,34,chroma_acts
422,1,0.0,14.197333333333333,14.197333333333333,0,30,30,chroma_acts_smoothed
422,2,14.197333333333333,30.51733333333333,16.319999999999997,30,64,34,chroma_acts_smoothed
422,3,30.51733333333333,78.03733333333334,47.52000000000001,64,163,99,chroma_acts_smoothed
422,4,78.03733333333334,84.27733333333333,6.239999999999995,163,176,13,chroma_acts_smoothed
422,5,84.27733333333333,105.87733333333334,21.60000000000001,176,221,45,chroma_acts_smoothed
422,6,105.87733333333334,115.47733333333333,9.599999999999994,221,241,20,chroma_acts_smoothed
422,7,115.47733333333333,121.23733333333334,5.760000000000005,241,253,12,chroma_acts_smoothed
422,8,121.23733333333334,149.07733333333334,27.840000000000003,253,311,58,chroma_acts_smoothed
422,9,149.07733333333334,170.766,21.68866666666665,311,355,44,chroma_acts_smoothed
422,1,0.0,14.197333333333333,14.197333333333333,0,30,30,ki_chroma
422,2,14.197333333333333,29.557333333333332,15.36,30,62,32,ki_chroma
422,3,29.557333333333332,78.03733333333334,48.480000000000004,62,163,101,ki_chroma
422,4,78.03733333333334,84.75733333333334,6.719999999999999,163,177,14,ki_chroma
422,5,84.75733333333334,105.87733333333334,21.120000000000005,177,221,44,ki_chroma
422,6,105.87733333333334,121.23733333333334,15.36,221,253,32,ki_chroma
422,7,121.23733333333334,149.55733333333333,28.319999999999993,253,312,59,ki_chroma
422,8,149.55733333333333,152.91733333333335,3.3600000000000136,312,319,7,ki_chroma
422,9,152.91733333333335,170.766,17.848666666666645,319,355,36,ki_chroma
422,1,0.0,14.197333333333333,14.197333333333333,0,30,30,ki_chroma_acts
422,2,14.197333333333333,30.51733333333333,16.319999999999997,30,64,34,ki_chroma_acts
422,3,30.51733333333333,78.03733333333334,47.52000000000001,64,163,99,ki_chroma_acts
422,4,78.03733333333334,84.75733333333334,6.719999999999999,163,177,14,ki_chroma_acts
422,5,84.75733333333334,105.87733333333334,21.120000000000005,177,221,44,ki_chroma_acts
422,6,105.87733333333334,126.03733333333334,20.159999999999997,221,263,42,ki_chroma_acts
422,7,126.03733333333334,149.07733333333334,23.040000000000006,263,311,48,ki_chroma_acts
422,8,149.07733333333334,153.87733333333333,4.799999999999983,311,321,10,ki_chroma_acts
422,9,153.87733333333333,170.766,16.888666666666666,321,355,34,ki_chroma_acts
422,1,0.0,14.197333333333333,14.197333333333333,0,30,30,ki_chroma_acts_smoothed
422,2,14.197333333333333,30.51733333333333,16.319999999999997,30,64,34,ki_chroma_acts_smoothed
422,3,30.51733333333333,78.03733333333334,47.52000000000001,64,163,99,ki_chroma_acts_smoothed
422,4,78.03733333333334,84.27733333333333,6.239999999999995,163,176,13,ki_chroma_acts_smoothed
422,5,84.27733333333333,105.87733333333334,21.60000000000001,176,221,45,ki_chroma_acts_smoothed
422,6,105.87733333333334,115.47733333333333,9.599999999999994,221,241,20,ki_chroma_acts_smoothed
422,7,115.47733333333333,121.23733333333334,5.760000000000005,241,253,12,ki_chroma_acts_smoothed
422,8,121.23733333333334,149.07733333333334,27.840000000000003,253,311,58,ki_chroma_acts_smoothed
422,9,149.07733333333334,170.766,21.68866666666665,311,355,44,ki_chroma_acts_smoothed
423,1,0.0,40.38399999999999,40.38399999999999,0,85,85,chromagram
423,2,40.38399999999999,44.224,3.8400000000000034,85,93,8,chromagram
423,3,44.224,92.22399999999999,47.99999999999999,93,193,100,chromagram
423,4,92.22399999999999,97.984,5.760000000000005,193,205,12,chromagram
423,5,97.984,99.904,1.9200000000000017,205,209,4,chromagram
423,6,99.904,132.544,32.640000000000015,209,277,68,chromagram
423,7,132.544,136.38400000000001,3.8400000000000034,277,285,8,chromagram
423,8,136.38400000000001,184.38400000000001,48.0,285,385,100,chromagram
423,9,184.38400000000001,199.691,15.306999999999988,385,415,30,chromagram
423,1,0.0,40.38399999999999,40.38399999999999,0,85,85,chroma_acts
423,2,40.38399999999999,44.224,3.8400000000000034,85,93,8,chroma_acts
423,3,44.224,92.22399999999999,47.99999999999999,93,193,100,chroma_acts
423,4,92.22399999999999,132.544,40.32000000000002,193,277,84,chroma_acts
423,5,132.544,184.38400000000001,51.84,277,385,108,chroma_acts
423,6,184.38400000000001,190.144,5.759999999999991,385,397,12,chroma_acts
423,7,190.144,192.064,1.9199999999999875,397,401,4,chroma_acts
423,8,192.064,199.691,7.6270000000000095,401,415,14,chroma_acts
423,1,0.0,40.864,40.864,0,86,86,chroma_acts_smoothed
423,2,40.864,44.224,3.3599999999999994,86,93,7,chroma_acts_smoothed
423,3,44.224,92.22399999999999,47.99999999999999,93,193,100,chroma_acts_smoothed
423,4,92.22399999999999,133.024,40.80000000000001,193,278,85,chroma_acts_smoothed
423,5,133.024,184.38400000000001,51.360000000000014,278,385,107,chroma_acts_smoothed
423,6,184.38400000000001,190.144,5.759999999999991,385,397,12,chroma_acts_smoothed
423,7,190.144,192.064,1.9199999999999875,397,401,4,chroma_acts_smoothed
423,8,192.064,199.691,7.6270000000000095,401,415,14,chroma_acts_smoothed
423,1,0.0,40.38399999999999,40.38399999999999,0,85,85,ki_chroma
423,2,40.38399999999999,44.224,3.8400000000000034,85,93,8,ki_chroma
423,3,44.224,92.22399999999999,47.99999999999999,93,193,100,ki_chroma
423,4,92.22399999999999,97.984,5.760000000000005,193,205,12,ki_chroma
423,5,97.984,99.904,1.9200000000000017,205,209,4,ki_chroma
423,6,99.904,132.544,32.640000000000015,209,277,68,ki_chroma
423,7,132.544,136.38400000000001,3.8400000000000034,277,285,8,ki_chroma
423,8,136.38400000000001,184.38400000000001,48.0,285,385,100,ki_chroma
423,9,184.38400000000001,199.691,15.306999999999988,385,415,30,ki_chroma
423,1,0.0,40.38399999999999,40.38399999999999,0,85,85,ki_chroma_acts
423,2,40.38399999999999,44.224,3.8400000000000034,85,93,8,ki_chroma_acts
423,3,44.224,92.22399999999999,47.99999999999999,93,193,100,ki_chroma_acts
423,4,92.22399999999999,132.544,40.32000000000002,193,277,84,ki_chroma_acts
423,5,132.544,184.38400000000001,51.84,277,385,108,ki_chroma_acts
423,6,184.38400000000001,190.144,5.759999999999991,385,397,12,ki_chroma_acts
423,7,190.144,192.064,1.9199999999999875,397,401,4,ki_chroma_acts
423,8,192.064,199.691,7.6270000000000095,401,415,14,ki_chroma_acts
423,1,0.0,40.864,40.864,0,86,86,ki_chroma_acts_smoothed
423,2,40.864,44.224,3.3599999999999994,86,93,7,ki_chroma_acts_smoothed
423,3,44.224,92.22399999999999,47.99999999999999,93,193,100,ki_chroma_acts_smoothed
423,4,92.22399999999999,133.024,40.80000000000001,193,278,85,ki_chroma_acts_smoothed
423,5,133.024,184.38400000000001,51.360000000000014,278,385,107,ki_chroma_acts_smoothed
423,6,184.38400000000001,190.144,5.759999999999991,385,397,12,ki_chroma_acts_smoothed
423,7,190.144,192.064,1.9199999999999875,397,401,4,ki_chroma_acts_smoothed
423,8,192.064,199.691,7.6270000000000095,401,415,14,ki_chroma_acts_smoothed
424,1,0.0,28.608,28.608,0,60,60,chromagram
424,2,28.608,45.407999999999994,16.799999999999994,60,95,35,chromagram
424,3,45.407999999999994,85.24799999999999,39.839999999999996,95,178,83,chromagram
424,4,85.24799999999999,92.448,7.200000000000003,178,193,15,chromagram
424,5,92.448,120.76799999999999,28.319999999999993,193,252,59,chromagram
424,6,120.76799999999999,137.568,16.800000000000026,252,287,35,chromagram
424,7,137.568,177.40800000000002,39.84,287,370,83,chromagram
424,8,177.40800000000002,184.12800000000001,6.719999999999999,370,384,14,chromagram
424,9,184.12800000000001,199.895,15.766999999999996,384,415,31,chromagram
424,1,0.0,28.608,28.608,0,60,60,chroma_acts
424,2,28.608,45.888,17.279999999999998,60,96,36,chroma_acts
424,3,45.888,85.24799999999999,39.35999999999999,96,178,82,chroma_acts
424,4,85.24799999999999,92.448,7.200000000000003,178,193,15,chroma_acts
424,5,92.448,120.76799999999999,28.319999999999993,193,252,59,chroma_acts
424,6,120.76799999999999,138.048,17.280000000000015,252,288,36,chroma_acts
424,7,138.048,177.40800000000002,39.360000000000014,288,370,82,chroma_acts
424,8,177.40800000000002,184.12800000000001,6.719999999999999,370,384,14,chroma_acts
424,9,184.12800000000001,199.895,15.766999999999996,384,415,31,chroma_acts
424,1,0.0,28.608,28.608,0,60,60,chroma_acts_smoothed
424,2,28.608,46.367999999999995,17.759999999999994,60,97,37,chroma_acts_smoothed
424,3,46.367999999999995,85.24799999999999,38.879999999999995,97,178,81,chroma_acts_smoothed
424,4,85.24799999999999,92.448,7.200000000000003,178,193,15,chroma_acts_smoothed
424,5,92.448,121.24799999999999,28.799999999999997,193,253,60,chroma_acts_smoothed
424,6,121.24799999999999,138.52800000000002,17.28000000000003,253,289,36,chroma_acts_smoothed
424,7,138.52800000000002,177.40800000000002,38.879999999999995,289,370,81,chroma_acts_smoothed
424,8,177.40800000000002,184.12800000000001,6.719999999999999,370,384,14,chroma_acts_smoothed
424,9,184.12800000000001,199.895,15.766999999999996,384,415,31,chroma_acts_smoothed
424,1,0.0,28.608,28.608,0,60,60,ki_chroma
424,2,28.608,45.407999999999994,16.799999999999994,60,95,35,ki_chroma
424,3,45.407999999999994,85.24799999999999,39.839999999999996,95,178,83,ki_chroma
424,4,85.24799999999999,92.448,7.200000000000003,178,193,15,ki_chroma
424,5,92.448,120.76799999999999,28.319999999999993,193,252,59,ki_chroma
424,6,120.76799999999999,137.568,16.800000000000026,252,287,35,ki_chroma
424,7,137.568,177.40800000000002,39.84,287,370,83,ki_chroma
424,8,177.40800000000002,184.12800000000001,6.719999999999999,370,384,14,ki_chroma
424,9,184.12800000000001,199.895,15.766999999999996,384,415,31,ki_chroma
424,1,0.0,28.608,28.608,0,60,60,ki_chroma_acts
424,2,28.608,45.888,17.279999999999998,60,96,36,ki_chroma_acts
424,3,45.888,85.24799999999999,39.35999999999999,96,178,82,ki_chroma_acts
424,4,85.24799999999999,92.448,7.200000000000003,178,193,15,ki_chroma_acts
424,5,92.448,120.76799999999999,28.319999999999993,193,252,59,ki_chroma_acts
424,6,120.76799999999999,138.048,17.280000000000015,252,288,36,ki_chroma_acts
424,7,138.048,177.40800000000002,39.360000000000014,288,370,82,ki_chroma_acts
424,8,177.40800000000002,184.12800000000001,6.719999999999999,370,384,14,ki_chroma_acts
424,9,184.12800000000001,199.895,15.766999999999996,384,415,31,ki_chroma_acts
424,1,0.0,28.608,28.608,0,60,60,ki_chroma_acts_smoothed
424,2,28.608,46.367999999999995,17.759999999999994,60,97,37,ki_chroma_acts_smoothed
424,3,46.367999999999995,85.24799999999999,38.879999999999995,97,178,81,ki_chroma_acts_smoothed
424,4,85.24799999999999,92.448,7.200000000000003,178,193,15,ki_chroma_acts_smoothed
424,5,92.448,121.24799999999999,28.799999999999997,193,253,60,ki_chroma_acts_smoothed
424,6,121.24799999999999,138.52800000000002,17.28000000000003,253,289,36,ki_chroma_acts_smoothed
424,7,138.52800000000002,177.40800000000002,38.879999999999995,289,370,81,ki_chroma_acts_smoothed
424,8,177.40800000000002,184.12800000000001,6.719999999999999,370,384,14,ki_chroma_acts_smoothed
424,9,184.12800000000001,199.895,15.766999999999996,384,415,31,ki_chroma_acts_smoothed
426,1,0.0,17.685333333333336,17.685333333333336,0,37,37,chromagram
426,2,17.685333333333336,28.245333333333335,10.559999999999999,37,59,22,chromagram
426,3,28.245333333333335,31.605333333333334,3.3599999999999994,59,66,7,chromagram
426,4,31.605333333333334,78.16533333333332,46.55999999999999,66,163,97,chromagram
426,5,78.16533333333332,94.96533333333333,16.80000000000001,163,198,35,chromagram
426,6,94.96533333333333,135.28533333333334,40.32000000000001,198,282,84,chromagram
426,7,135.28533333333334,139.12533333333334,3.8400000000000034,282,290,8,chromagram
426,8,139.12533333333334,185.405,46.27966666666666,290,385,95,chromagram
426,1,0.0,17.685333333333336,17.685333333333336,0,37,37,chroma_acts
426,2,17.685333333333336,28.245333333333335,10.559999999999999,37,59,22,chroma_acts
426,3,28.245333333333335,31.605333333333334,3.3599999999999994,59,66,7,chroma_acts
426,4,31.605333333333334,78.16533333333332,46.55999999999999,66,163,97,chroma_acts
426,5,78.16533333333332,93.04533333333333,14.88000000000001,163,194,31,chroma_acts
426,6,93.04533333333333,135.28533333333334,42.24000000000001,194,282,88,chroma_acts
426,7,135.28533333333334,138.16533333333334,2.8799999999999955,282,288,6,chroma_acts
426,8,138.16533333333334,185.405,47.239666666666665,288,385,97,chroma_acts
426,1,0.0,16.725333333333335,16.725333333333335,0,35,35,chroma_acts_smoothed
426,2,16.725333333333335,28.245333333333335,11.52,35,59,24,chroma_acts_smoothed
426,3,28.245333333333335,31.605333333333334,3.3599999999999994,59,66,7,chroma_acts_smoothed
426,4,31.605333333333334,78.16533333333332,46.55999999999999,66,163,97,chroma_acts_smoothed
426,5,78.16533333333332,93.52533333333332,15.36,163,195,32,chroma_acts_smoothed
426,6,93.52533333333332,133.36533333333335,39.84000000000003,195,278,83,chroma_acts_smoothed
426,7,133.36533333333335,139.12533333333334,5.759999999999991,278,290,12,chroma_acts_smoothed
426,8,139.12533333333334,185.405,46.27966666666666,290,385,95,chroma_acts_smoothed
426,1,0.0,17.685333333333336,17.685333333333336,0,37,37,ki_chroma
426,2,17.685333333333336,28.245333333333335,10.559999999999999,37,59,22,ki_chroma
426,3,28.245333333333335,31.605333333333334,3.3599999999999994,59,66,7,ki_chroma
426,4,31.605333333333334,78.16533333333332,46.55999999999999,66,163,97,ki_chroma
426,5,78.16533333333332,94.96533333333333,16.80000000000001,163,198,35,ki_chroma
426,6,94.96533333333333,135.28533333333334,40.32000000000001,198,282,84,ki_chroma
426,7,135.28533333333334,139.12533333333334,3.8400000000000034,282,290,8,ki_chroma
426,8,139.12533333333334,185.405,46.27966666666666,290,385,95,ki_chroma
426,1,0.0,17.685333333333336,17.685333333333336,0,37,37,ki_chroma_acts
426,2,17.685333333333336,28.245333333333335,10.559999999999999,37,59,22,ki_chroma_acts
426,3,28.245333333333335,31.605333333333334,3.3599999999999994,59,66,7,ki_chroma_acts
426,4,31.605333333333334,78.16533333333332,46.55999999999999,66,163,97,ki_chroma_acts
426,5,78.16533333333332,93.04533333333333,14.88000000000001,163,194,31,ki_chroma_acts
426,6,93.04533333333333,135.28533333333334,42.24000000000001,194,282,88,ki_chroma_acts
426,7,135.28533333333334,138.16533333333334,2.8799999999999955,282,288,6,ki_chroma_acts
426,8,138.16533333333334,185.405,47.239666666666665,288,385,97,ki_chroma_acts
426,1,0.0,16.725333333333335,16.725333333333335,0,35,35,ki_chroma_acts_smoothed
426,2,16.725333333333335,28.245333333333335,11.52,35,59,24,ki_chroma_acts_smoothed
426,3,28.245333333333335,31.605333333333334,3.3599999999999994,59,66,7,ki_chroma_acts_smoothed
426,4,31.605333333333334,78.16533333333332,46.55999999999999,66,163,97,ki_chroma_acts_smoothed
426,5,78.16533333333332,93.52533333333332,15.36,163,195,32,ki_chroma_acts_smoothed
426,6,93.52533333333332,133.36533333333335,39.84000000000003,195,278,83,ki_chroma_acts_smoothed
426,7,133.36533333333335,139.12533333333334,5.759999999999991,278,290,12,ki_chroma_acts_smoothed
426,8,139.12533333333334,185.405,46.27966666666666,290,385,95,ki_chroma_acts_smoothed
428,1,0.0,7.498666666666666,7.498666666666666,0,11,11,chromagram
428,2,7.498666666666666,24.671999999999997,17.173333333333332,11,34,23,chromagram
428,3,24.671999999999997,35.12533333333333,10.453333333333333,34,48,14,chromagram
428,4,35.12533333333333,53.791999999999994,18.666666666666664,48,73,25,chromagram
428,5,53.791999999999994,70.96533333333333,17.17333333333334,73,96,23,chromagram
428,6,70.96533333333333,104.56533333333333,33.599999999999994,96,141,45,chromagram
428,7,104.56533333333333,138.91199999999998,34.34666666666665,141,187,46,chromagram
428,8,138.91199999999998,175.739,36.82700000000003,187,235,48,chromagram
428,1,0.0,7.498666666666666,7.498666666666666,0,11,11,chroma_acts
428,2,7.498666666666666,24.671999999999997,17.173333333333332,11,34,23,chroma_acts
428,3,24.671999999999997,35.12533333333333,10.453333333333333,34,48,14,chroma_acts
428,4,35.12533333333333,53.04533333333333,17.92,48,72,24,chroma_acts
428,5,53.04533333333333,70.96533333333333,17.92,72,96,24,chroma_acts
428,6,70.96533333333333,104.56533333333333,33.599999999999994,96,141,45,chroma_acts
428,7,104.56533333333333,138.91199999999998,34.34666666666665,141,187,46,chroma_acts
428,8,138.91199999999998,175.739,36.82700000000003,187,235,48,chroma_acts
428,1,0.0,7.498666666666666,7.498666666666666,0,11,11,chroma_acts_smoothed
428,2,7.498666666666666,23.178666666666665,15.68,11,32,21,chroma_acts_smoothed
428,3,23.178666666666665,38.111999999999995,14.93333333333333,32,52,20,chroma_acts_smoothed
428,4,38.111999999999995,53.04533333333333,14.933333333333337,52,72,20,chroma_acts_smoothed
428,5,53.04533333333333,70.96533333333333,17.92,72,96,24,chroma_acts_smoothed
428,6,70.96533333333333,104.56533333333333,33.599999999999994,96,141,45,chroma_acts_smoothed
428,7,104.56533333333333,139.65866666666665,35.09333333333332,141,188,47,chroma_acts_smoothed
428,8,139.65866666666665,175.739,36.08033333333336,188,235,47,chroma_acts_smoothed
428,1,0.0,7.498666666666666,7.498666666666666,0,11,11,ki_chroma
428,2,7.498666666666666,24.671999999999997,17.173333333333332,11,34,23,ki_chroma
428,3,24.671999999999997,35.12533333333333,10.453333333333333,34,48,14,ki_chroma
428,4,35.12533333333333,53.791999999999994,18.666666666666664,48,73,25,ki_chroma
428,5,53.791999999999994,70.96533333333333,17.17333333333334,73,96,23,ki_chroma
428,6,70.96533333333333,104.56533333333333,33.599999999999994,96,141,45,ki_chroma
428,7,104.56533333333333,138.91199999999998,34.34666666666665,141,187,46,ki_chroma
428,8,138.91199999999998,175.739,36.82700000000003,187,235,48,ki_chroma
428,1,0.0,7.498666666666666,7.498666666666666,0,11,11,ki_chroma_acts
428,2,7.498666666666666,24.671999999999997,17.173333333333332,11,34,23,ki_chroma_acts
428,3,24.671999999999997,35.12533333333333,10.453333333333333,34,48,14,ki_chroma_acts
428,4,35.12533333333333,53.04533333333333,17.92,48,72,24,ki_chroma_acts
428,5,53.04533333333333,70.96533333333333,17.92,72,96,24,ki_chroma_acts
428,6,70.96533333333333,104.56533333333333,33.599999999999994,96,141,45,ki_chroma_acts
428,7,104.56533333333333,138.91199999999998,34.34666666666665,141,187,46,ki_chroma_acts
428,8,138.91199999999998,175.739,36.82700000000003,187,235,48,ki_chroma_acts
428,1,0.0,7.498666666666666,7.498666666666666,0,11,11,ki_chroma_acts_smoothed
428,2,7.498666666666666,23.178666666666665,15.68,11,32,21,ki_chroma_acts_smoothed
428,3,23.178666666666665,38.111999999999995,14.93333333333333,32,52,20,ki_chroma_acts_smoothed
428,4,38.111999999999995,53.04533333333333,14.933333333333337,52,72,20,ki_chroma_acts_smoothed
428,5,53.04533333333333,70.96533333333333,17.92,72,96,24,ki_chroma_acts_smoothed
428,6,70.96533333333333,104.56533333333333,33.599999999999994,96,141,45,ki_chroma_acts_smoothed
428,7,104.56533333333333,139.65866666666665,35.09333333333332,141,188,47,ki_chroma_acts_smoothed
428,8,139.65866666666665,175.739,36.08033333333336,188,235,47,ki_chroma_acts_smoothed
430,1,0.0,11.082666666666666,11.082666666666666,0,24,24,chromagram
430,2,11.082666666666666,25.162666666666667,14.08,24,54,30,chromagram
430,3,25.162666666666667,37.834666666666664,12.671999999999997,54,81,27,chromagram
430,4,37.834666666666664,55.199999999999996,17.365333333333332,81,118,37,chromagram
430,5,55.199999999999996,100.72533333333332,45.52533333333333,118,215,97,chromagram
430,6,100.72533333333332,114.80533333333332,14.079999999999998,215,245,30,chromagram
430,7,114.80533333333332,129.35466666666667,14.549333333333351,245,276,31,chromagram
430,8,129.35466666666667,139.68,10.325333333333333,276,298,22,chromagram
430,9,139.68,173.186,33.506,298,368,70,chromagram
430,1,0.0,11.082666666666666,11.082666666666666,0,24,24,chroma_acts
430,2,11.082666666666666,31.264,20.181333333333335,24,67,43,chroma_acts
430,3,31.264,37.834666666666664,6.570666666666664,67,81,14,chroma_acts
430,4,37.834666666666664,55.66933333333333,17.834666666666664,81,119,38,chroma_acts
430,5,55.66933333333333,100.72533333333332,45.056,119,215,96,chroma_acts
430,6,100.72533333333332,129.35466666666667,28.62933333333335,215,276,61,chroma_acts
430,7,129.35466666666667,140.14933333333335,10.794666666666672,276,299,23,chroma_acts
430,8,140.14933333333335,173.186,33.03666666666666,299,368,69,chroma_acts
430,1,0.0,11.082666666666666,11.082666666666666,0,24,24,chroma_acts_smoothed
430,2,11.082666666666666,25.162666666666667,14.08,24,54,30,chroma_acts_smoothed
430,3,25.162666666666667,37.834666666666664,12.671999999999997,54,81,27,chroma_acts_smoothed
430,4,37.834666666666664,55.66933333333333,17.834666666666664,81,119,38,chroma_acts_smoothed
430,5,55.66933333333333,100.72533333333332,45.056,119,215,96,chroma_acts_smoothed
430,6,100.72533333333332,129.35466666666667,28.62933333333335,215,276,61,chroma_acts_smoothed
430,7,129.35466666666667,141.08800000000002,11.733333333333348,276,301,25,chroma_acts_smoothed
430,8,141.08800000000002,173.186,32.097999999999985,301,368,67,chroma_acts_smoothed
430,1,0.0,11.082666666666666,11.082666666666666,0,24,24,ki_chroma
430,2,11.082666666666666,25.162666666666667,14.08,24,54,30,ki_chroma
430,3,25.162666666666667,37.834666666666664,12.671999999999997,54,81,27,ki_chroma
430,4,37.834666666666664,55.199999999999996,17.365333333333332,81,118,37,ki_chroma
430,5,55.199999999999996,100.72533333333332,45.52533333333333,118,215,97,ki_chroma
430,6,100.72533333333332,114.80533333333332,14.079999999999998,215,245,30,ki_chroma
430,7,114.80533333333332,129.35466666666667,14.549333333333351,245,276,31,ki_chroma
430,8,129.35466666666667,139.68,10.325333333333333,276,298,22,ki_chroma
430,9,139.68,173.186,33.506,298,368,70,ki_chroma
430,1,0.0,11.082666666666666,11.082666666666666,0,24,24,ki_chroma_acts
430,2,11.082666666666666,31.264,20.181333333333335,24,67,43,ki_chroma_acts
430,3,31.264,37.834666666666664,6.570666666666664,67,81,14,ki_chroma_acts
430,4,37.834666666666664,55.66933333333333,17.834666666666664,81,119,38,ki_chroma_acts
430,5,55.66933333333333,100.72533333333332,45.056,119,215,96,ki_chroma_acts
430,6,100.72533333333332,129.35466666666667,28.62933333333335,215,276,61,ki_chroma_acts
430,7,129.35466666666667,140.14933333333335,10.794666666666672,276,299,23,ki_chroma_acts
430,8,140.14933333333335,173.186,33.03666666666666,299,368,69,ki_chroma_acts
430,1,0.0,11.082666666666666,11.082666666666666,0,24,24,ki_chroma_acts_smoothed
430,2,11.082666666666666,25.162666666666667,14.08,24,54,30,ki_chroma_acts_smoothed
430,3,25.162666666666667,37.834666666666664,12.671999999999997,54,81,27,ki_chroma_acts_smoothed
430,4,37.834666666666664,55.66933333333333,17.834666666666664,81,119,38,ki_chroma_acts_smoothed
430,5,55.66933333333333,100.72533333333332,45.056,119,215,96,ki_chroma_acts_smoothed
430,6,100.72533333333332,129.35466666666667,28.62933333333335,215,276,61,ki_chroma_acts_smoothed
430,7,129.35466666666667,141.08800000000002,11.733333333333348,276,301,25,ki_chroma_acts_smoothed
430,8,141.08800000000002,173.186,32.097999999999985,301,368,67,ki_chroma_acts_smoothed
433,1,0.0,14.346666666666668,14.346666666666668,0,31,31,chromagram
433,2,14.346666666666668,48.608,34.261333333333326,31,104,73,chromagram
433,3,48.608,59.872,11.264000000000003,104,128,24,chromagram
433,4,59.872,89.90933333333334,30.037333333333336,128,192,64,chromagram
433,5,89.90933333333334,103.05066666666666,13.141333333333321,192,220,28,chromagram
433,6,103.05066666666666,110.56,7.509333333333345,220,236,16,chromagram
433,7,110.56,112.43733333333333,1.8773333333333255,236,240,4,chromagram
433,8,112.43733333333333,119.008,6.570666666666668,240,254,14,chromagram
433,9,119.008,180.144,61.13600000000001,254,383,129,chromagram
433,1,0.0,14.346666666666668,14.346666666666668,0,31,31,chroma_acts
433,2,14.346666666666668,48.608,34.261333333333326,31,104,73,chroma_acts
433,3,48.608,59.872,11.264000000000003,104,128,24,chroma_acts
433,4,59.872,89.90933333333334,30.037333333333336,128,192,64,chroma_acts
433,5,89.90933333333334,103.05066666666666,13.141333333333321,192,220,28,chroma_acts
433,6,103.05066666666666,109.62133333333333,6.570666666666668,220,234,14,chroma_acts
433,7,109.62133333333333,112.43733333333333,2.8160000000000025,234,240,6,chroma_acts
433,8,112.43733333333333,119.008,6.570666666666668,240,254,14,chroma_acts
433,9,119.008,180.144,61.13600000000001,254,383,129,chroma_acts
433,1,0.0,14.816,14.816,0,32,32,chroma_acts_smoothed
433,2,14.816,48.608,33.791999999999994,32,104,72,chroma_acts_smoothed
433,3,48.608,59.872,11.264000000000003,104,128,24,chroma_acts_smoothed
433,4,59.872,89.90933333333334,30.037333333333336,128,192,64,chroma_acts_smoothed
433,5,89.90933333333334,102.58133333333333,12.671999999999997,192,219,27,chroma_acts_smoothed
433,6,102.58133333333333,104.928,2.346666666666664,219,224,5,chroma_acts_smoothed
433,7,104.928,112.43733333333333,7.5093333333333305,224,240,16,chroma_acts_smoothed
433,8,112.43733333333333,119.008,6.570666666666668,240,254,14,chroma_acts_smoothed
433,9,119.008,180.144,61.13600000000001,254,383,129,chroma_acts_smoothed
433,1,0.0,14.346666666666668,14.346666666666668,0,31,31,ki_chroma
433,2,14.346666666666668,48.608,34.261333333333326,31,104,73,ki_chroma
433,3,48.608,59.872,11.264000000000003,104,128,24,ki_chroma
433,4,59.872,89.90933333333334,30.037333333333336,128,192,64,ki_chroma
433,5,89.90933333333334,103.05066666666666,13.141333333333321,192,220,28,ki_chroma
433,6,103.05066666666666,110.56,7.509333333333345,220,236,16,ki_chroma
433,7,110.56,112.43733333333333,1.8773333333333255,236,240,4,ki_chroma
433,8,112.43733333333333,119.008,6.570666666666668,240,254,14,ki_chroma
433,9,119.008,180.144,61.13600000000001,254,383,129,ki_chroma
433,1,0.0,14.346666666666668,14.346666666666668,0,31,31,ki_chroma_acts
433,2,14.346666666666668,48.608,34.261333333333326,31,104,73,ki_chroma_acts
433,3,48.608,59.872,11.264000000000003,104,128,24,ki_chroma_acts
433,4,59.872,89.90933333333334,30.037333333333336,128,192,64,ki_chroma_acts
433,5,89.90933333333334,103.05066666666666,13.141333333333321,192,220,28,ki_chroma_acts
433,6,103.05066666666666,109.62133333333333,6.570666666666668,220,234,14,ki_chroma_acts
433,7,109.62133333333333,112.43733333333333,2.8160000000000025,234,240,6,ki_chroma_acts
433,8,112.43733333333333,119.008,6.570666666666668,240,254,14,ki_chroma_acts
433,9,119.008,180.144,61.13600000000001,254,383,129,ki_chroma_acts
433,1,0.0,14.816,14.816,0,32,32,ki_chroma_acts_smoothed
433,2,14.816,48.608,33.791999999999994,32,104,72,ki_chroma_acts_smoothed
433,3,48.608,59.872,11.264000000000003,104,128,24,ki_chroma_acts_smoothed
433,4,59.872,89.90933333333334,30.037333333333336,128,192,64,ki_chroma_acts_smoothed
433,5,89.90933333333334,102.58133333333333,12.671999999999997,192,219,27,ki_chroma_acts_smoothed
433,6,102.58133333333333,104.928,2.346666666666664,219,224,5,ki_chroma_acts_smoothed
433,7,104.928,112.43733333333333,7.5093333333333305,224,240,16,ki_chroma_acts_smoothed
433,8,112.43733333333333,119.008,6.570666666666668,240,254,14,ki_chroma_acts_smoothed
433,9,119.008,180.144,61.13600000000001,254,383,129,ki_chroma_acts_smoothed
434,1,0.0,17.536,17.536,0,37,37,chromagram
434,2,17.536,30.976,13.439999999999998,37,65,28,chromagram
434,3,30.976,81.37599999999999,50.39999999999999,65,170,105,chromagram
434,4,81.37599999999999,93.37599999999999,12.0,170,195,25,chromagram
434,5,93.37599999999999,98.65599999999999,5.280000000000001,195,206,11,chromagram
434,6,98.65599999999999,113.056,14.400000000000006,206,236,30,chromagram
434,7,113.056,163.708,50.652,236,340,104,chromagram
434,1,0.0,16.096,16.096,0,34,34,chroma_acts
434,2,16.096,34.816,18.720000000000002,34,73,39,chroma_acts
434,3,34.816,79.456,44.64,73,166,93,chroma_acts
434,4,79.456,99.136,19.679999999999993,166,207,41,chroma_acts
434,5,99.136,113.056,13.920000000000002,207,236,29,chroma_acts
434,6,113.056,143.77599999999998,30.719999999999985,236,300,64,chroma_acts
434,7,143.77599999999998,163.708,19.932000000000016,300,340,40,chroma_acts
434,1,0.0,16.096,16.096,0,34,34,chroma_acts_smoothed
434,2,16.096,35.296,19.2,34,74,40,chroma_acts_smoothed
434,3,35.296,79.456,44.160000000000004,74,166,92,chroma_acts_smoothed
434,4,79.456,99.136,19.679999999999993,166,207,41,chroma_acts_smoothed
434,5,99.136,113.536,14.400000000000006,207,237,30,chroma_acts_smoothed
434,6,113.536,143.296,29.75999999999999,237,299,62,chroma_acts_smoothed
434,7,143.296,163.708,20.412000000000006,299,340,41,chroma_acts_smoothed
434,1,0.0,17.536,17.536,0,37,37,ki_chroma
434,2,17.536,30.976,13.439999999999998,37,65,28,ki_chroma
434,3,30.976,81.37599999999999,50.39999999999999,65,170,105,ki_chroma
434,4,81.37599999999999,93.37599999999999,12.0,170,195,25,ki_chroma
434,5,93.37599999999999,98.65599999999999,5.280000000000001,195,206,11,ki_chroma
434,6,98.65599999999999,113.056,14.400000000000006,206,236,30,ki_chroma
434,7,113.056,163.708,50.652,236,340,104,ki_chroma
434,1,0.0,16.096,16.096,0,34,34,ki_chroma_acts
434,2,16.096,34.816,18.720000000000002,34,73,39,ki_chroma_acts
434,3,34.816,79.456,44.64,73,166,93,ki_chroma_acts
434,4,79.456,99.136,19.679999999999993,166,207,41,ki_chroma_acts
434,5,99.136,113.056,13.920000000000002,207,236,29,ki_chroma_acts
434,6,113.056,143.77599999999998,30.719999999999985,236,300,64,ki_chroma_acts
434,7,143.77599999999998,163.708,19.932000000000016,300,340,40,ki_chroma_acts
434,1,0.0,16.096,16.096,0,34,34,ki_chroma_acts_smoothed
434,2,16.096,35.296,19.2,34,74,40,ki_chroma_acts_smoothed
434,3,35.296,79.456,44.160000000000004,74,166,92,ki_chroma_acts_smoothed
434,4,79.456,99.136,19.679999999999993,166,207,41,ki_chroma_acts_smoothed
434,5,99.136,113.536,14.400000000000006,207,237,30,ki_chroma_acts_smoothed
434,6,113.536,143.296,29.75999999999999,237,299,62,ki_chroma_acts_smoothed
434,7,143.296,163.708,20.412000000000006,299,340,41,ki_chroma_acts_smoothed
436,1,0.0,15.936,15.936,0,34,34,chromagram
436,2,15.936,30.336,14.399999999999999,34,64,30,chromagram
436,3,30.336,44.25599999999999,13.919999999999995,64,93,29,chromagram
436,4,44.25599999999999,61.056,16.800000000000004,93,128,35,chromagram
436,5,61.056,104.736,43.68000000000001,128,219,91,chromagram
436,6,104.736,134.976,30.239999999999995,219,282,63,chromagram
436,7,134.976,136.896,1.9199999999999875,282,286,4,chromagram
436,8,136.896,187.053,50.15700000000001,286,389,103,chromagram
436,1,0.0,14.495999999999999,14.495999999999999,0,31,31,chroma_acts
436,2,14.495999999999999,30.336,15.84,31,64,33,chroma_acts
436,3,30.336,44.25599999999999,13.919999999999995,64,93,29,chroma_acts
436,4,44.25599999999999,61.056,16.800000000000004,93,128,35,chroma_acts
436,5,61.056,104.736,43.68000000000001,128,219,91,chroma_acts
436,6,104.736,135.456,30.719999999999985,219,283,64,chroma_acts
436,7,135.456,136.896,1.4399999999999977,283,286,3,chroma_acts
436,8,136.896,187.053,50.15700000000001,286,389,103,chroma_acts
436,1,0.0,14.016,14.016,0,30,30,chroma_acts_smoothed
436,2,14.016,30.336,16.32,30,64,34,chroma_acts_smoothed
436,3,30.336,43.29599999999999,12.959999999999994,64,91,27,chroma_acts_smoothed
436,4,43.29599999999999,61.056,17.760000000000005,91,128,37,chroma_acts_smoothed
436,5,61.056,104.736,43.68000000000001,128,219,91,chroma_acts_smoothed
436,6,104.736,134.496,29.760000000000005,219,281,62,chroma_acts_smoothed
436,7,134.496,136.896,2.3999999999999773,281,286,5,chroma_acts_smoothed
436,8,136.896,187.053,50.15700000000001,286,389,103,chroma_acts_smoothed
436,1,0.0,15.936,15.936,0,34,34,ki_chroma
436,2,15.936,30.336,14.399999999999999,34,64,30,ki_chroma
436,3,30.336,44.25599999999999,13.919999999999995,64,93,29,ki_chroma
436,4,44.25599999999999,61.056,16.800000000000004,93,128,35,ki_chroma
436,5,61.056,104.736,43.68000000000001,128,219,91,ki_chroma
436,6,104.736,134.976,30.239999999999995,219,282,63,ki_chroma
436,7,134.976,136.896,1.9199999999999875,282,286,4,ki_chroma
436,8,136.896,187.053,50.15700000000001,286,389,103,ki_chroma
436,1,0.0,14.495999999999999,14.495999999999999,0,31,31,ki_chroma_acts
436,2,14.495999999999999,30.336,15.84,31,64,33,ki_chroma_acts
436,3,30.336,44.25599999999999,13.919999999999995,64,93,29,ki_chroma_acts
436,4,44.25599999999999,61.056,16.800000000000004,93,128,35,ki_chroma_acts
436,5,61.056,104.736,43.68000000000001,128,219,91,ki_chroma_acts
436,6,104.736,135.456,30.719999999999985,219,283,64,ki_chroma_acts
436,7,135.456,136.896,1.4399999999999977,283,286,3,ki_chroma_acts
436,8,136.896,187.053,50.15700000000001,286,389,103,ki_chroma_acts
436,1,0.0,14.016,14.016,0,30,30,ki_chroma_acts_smoothed
436,2,14.016,30.336,16.32,30,64,34,ki_chroma_acts_smoothed
436,3,30.336,43.29599999999999,12.959999999999994,64,91,27,ki_chroma_acts_smoothed
436,4,43.29599999999999,61.056,17.760000000000005,91,128,37,ki_chroma_acts_smoothed
436,5,61.056,104.736,43.68000000000001,128,219,91,ki_chroma_acts_smoothed
436,6,104.736,134.496,29.760000000000005,219,281,62,ki_chroma_acts_smoothed
436,7,134.496,136.896,2.3999999999999773,281,286,5,ki_chroma_acts_smoothed
436,8,136.896,187.053,50.15700000000001,286,389,103,ki_chroma_acts_smoothed
437,1,0.0,7.818666666666666,7.818666666666666,0,17,17,chromagram
437,2,7.818666666666666,38.32533333333333,30.506666666666668,17,82,65,chromagram
437,3,38.32533333333333,68.36266666666666,30.037333333333322,82,146,64,chromagram
437,4,68.36266666666666,83.38133333333333,15.018666666666675,146,178,32,chromagram
437,5,83.38133333333333,98.86933333333333,15.488,178,211,33,chromagram
437,6,98.86933333333333,136.88533333333334,38.016000000000005,211,292,81,chromagram
437,7,136.88533333333334,143.92533333333333,7.039999999999992,292,307,15,chromagram
437,8,143.92533333333333,191.411,47.485666666666674,307,407,100,chromagram
437,1,0.0,7.818666666666666,7.818666666666666,0,17,17,chroma_acts
437,2,7.818666666666666,38.32533333333333,30.506666666666668,17,82,65,chroma_acts
437,3,38.32533333333333,68.36266666666666,30.037333333333322,82,146,64,chroma_acts
437,4,68.36266666666666,83.38133333333333,15.018666666666675,146,178,32,chroma_acts
437,5,83.38133333333333,97.93066666666665,14.549333333333323,178,209,31,chroma_acts
437,6,97.93066666666665,134.06933333333333,36.13866666666668,209,286,77,chroma_acts
437,7,134.06933333333333,143.92533333333333,9.855999999999995,286,307,21,chroma_acts
437,8,143.92533333333333,191.411,47.485666666666674,307,407,100,chroma_acts
437,1,0.0,7.818666666666666,7.818666666666666,0,17,17,chroma_acts_smoothed
437,2,7.818666666666666,38.32533333333333,30.506666666666668,17,82,65,chroma_acts_smoothed
437,3,38.32533333333333,68.36266666666666,30.037333333333322,82,146,64,chroma_acts_smoothed
437,4,68.36266666666666,83.38133333333333,15.018666666666675,146,178,32,chroma_acts_smoothed
437,5,83.38133333333333,97.93066666666665,14.549333333333323,178,209,31,chroma_acts_smoothed
437,6,97.93066666666665,134.06933333333333,36.13866666666668,209,286,77,chroma_acts_smoothed
437,7,134.06933333333333,143.92533333333333,9.855999999999995,286,307,21,chroma_acts_smoothed
437,8,143.92533333333333,191.411,47.485666666666674,307,407,100,chroma_acts_smoothed
437,1,0.0,7.818666666666666,7.818666666666666,0,17,17,ki_chroma
437,2,7.818666666666666,38.32533333333333,30.506666666666668,17,82,65,ki_chroma
437,3,38.32533333333333,68.36266666666666,30.037333333333322,82,146,64,ki_chroma
437,4,68.36266666666666,83.38133333333333,15.018666666666675,146,178,32,ki_chroma
437,5,83.38133333333333,98.86933333333333,15.488,178,211,33,ki_chroma
437,6,98.86933333333333,136.88533333333334,38.016000000000005,211,292,81,ki_chroma
437,7,136.88533333333334,143.92533333333333,7.039999999999992,292,307,15,ki_chroma
437,8,143.92533333333333,191.411,47.485666666666674,307,407,100,ki_chroma
437,1,0.0,7.818666666666666,7.818666666666666,0,17,17,ki_chroma_acts
437,2,7.818666666666666,38.32533333333333,30.506666666666668,17,82,65,ki_chroma_acts
437,3,38.32533333333333,68.36266666666666,30.037333333333322,82,146,64,ki_chroma_acts
437,4,68.36266666666666,83.38133333333333,15.018666666666675,146,178,32,ki_chroma_acts
437,5,83.38133333333333,97.93066666666665,14.549333333333323,178,209,31,ki_chroma_acts
437,6,97.93066666666665,134.06933333333333,36.13866666666668,209,286,77,ki_chroma_acts
437,7,134.06933333333333,143.92533333333333,9.855999999999995,286,307,21,ki_chroma_acts
437,8,143.92533333333333,191.411,47.485666666666674,307,407,100,ki_chroma_acts
437,1,0.0,7.818666666666666,7.818666666666666,0,17,17,ki_chroma_acts_smoothed
437,2,7.818666666666666,38.32533333333333,30.506666666666668,17,82,65,ki_chroma_acts_smoothed
437,3,38.32533333333333,68.36266666666666,30.037333333333322,82,146,64,ki_chroma_acts_smoothed
437,4,68.36266666666666,83.38133333333333,15.018666666666675,146,178,32,ki_chroma_acts_smoothed
437,5,83.38133333333333,97.93066666666665,14.549333333333323,178,209,31,ki_chroma_acts_smoothed
437,6,97.93066666666665,134.06933333333333,36.13866666666668,209,286,77,ki_chroma_acts_smoothed
437,7,134.06933333333333,143.92533333333333,9.855999999999995,286,307,21,ki_chroma_acts_smoothed
437,8,143.92533333333333,191.411,47.485666666666674,307,407,100,ki_chroma_acts_smoothed
438,1,0.0,30.816,30.816,0,65,65,chromagram
438,2,30.816,60.096,29.279999999999998,65,126,61,chromagram
438,3,60.096,92.736,32.64000000000001,126,194,68,chromagram
438,4,92.736,116.256,23.519999999999996,194,243,49,chromagram
438,5,116.256,124.416,8.159999999999997,243,260,17,chromagram
438,6,124.416,139.776,15.360000000000014,260,292,32,chromagram
438,7,139.776,143.136,3.359999999999985,292,299,7,chromagram
438,8,143.136,170.894,27.75800000000001,299,355,56,chromagram
438,1,0.0,30.816,30.816,0,65,65,chroma_acts
438,2,30.816,60.096,29.279999999999998,65,126,61,chroma_acts
438,3,60.096,108.576,48.48,126,227,101,chroma_acts
438,4,108.576,116.736,8.16000000000001,227,244,17,chroma_acts
438,5,116.736,124.416,7.679999999999993,244,260,16,chroma_acts
438,6,124.416,137.376,12.960000000000008,260,287,27,chroma_acts
438,7,137.376,143.136,5.759999999999991,287,299,12,chroma_acts
438,8,143.136,170.894,27.75800000000001,299,355,56,chroma_acts
438,1,0.0,30.816,30.816,0,65,65,chroma_acts_smoothed
438,2,30.816,59.61599999999999,28.799999999999994,65,125,60,chroma_acts_smoothed
438,3,59.61599999999999,92.736,33.12000000000001,125,194,69,chroma_acts_smoothed
438,4,92.736,116.736,24.0,194,244,50,chroma_acts_smoothed
438,5,116.736,124.416,7.679999999999993,244,260,16,chroma_acts_smoothed
438,6,124.416,136.896,12.47999999999999,260,286,26,chroma_acts_smoothed
438,7,136.896,143.136,6.240000000000009,286,299,13,chroma_acts_smoothed
438,8,143.136,170.894,27.75800000000001,299,355,56,chroma_acts_smoothed
438,1,0.0,30.816,30.816,0,65,65,ki_chroma
438,2,30.816,60.096,29.279999999999998,65,126,61,ki_chroma
438,3,60.096,92.736,32.64000000000001,126,194,68,ki_chroma
438,4,92.736,116.256,23.519999999999996,194,243,49,ki_chroma
438,5,116.256,124.416,8.159999999999997,243,260,17,ki_chroma
438,6,124.416,139.776,15.360000000000014,260,292,32,ki_chroma
438,7,139.776,143.136,3.359999999999985,292,299,7,ki_chroma
438,8,143.136,170.894,27.75800000000001,299,355,56,ki_chroma
438,1,0.0,30.816,30.816,0,65,65,ki_chroma_acts
438,2,30.816,60.096,29.279999999999998,65,126,61,ki_chroma_acts
438,3,60.096,108.576,48.48,126,227,101,ki_chroma_acts
438,4,108.576,116.736,8.16000000000001,227,244,17,ki_chroma_acts
438,5,116.736,124.416,7.679999999999993,244,260,16,ki_chroma_acts
438,6,124.416,137.376,12.960000000000008,260,287,27,ki_chroma_acts
438,7,137.376,143.136,5.759999999999991,287,299,12,ki_chroma_acts
438,8,143.136,170.894,27.75800000000001,299,355,56,ki_chroma_acts
438,1,0.0,30.816,30.816,0,65,65,ki_chroma_acts_smoothed
438,2,30.816,59.61599999999999,28.799999999999994,65,125,60,ki_chroma_acts_smoothed
438,3,59.61599999999999,92.736,33.12000000000001,125,194,69,ki_chroma_acts_smoothed
438,4,92.736,116.736,24.0,194,244,50,ki_chroma_acts_smoothed
438,5,116.736,124.416,7.679999999999993,244,260,16,ki_chroma_acts_smoothed
438,6,124.416,136.896,12.47999999999999,260,286,26,ki_chroma_acts_smoothed
438,7,136.896,143.136,6.240000000000009,286,299,13,ki_chroma_acts_smoothed
438,8,143.136,170.894,27.75800000000001,299,355,56,ki_chroma_acts_smoothed
439,1,0.0,29.866666666666664,29.866666666666664,0,64,64,chromagram
439,2,29.866666666666664,60.373333333333335,30.50666666666667,64,129,65,chromagram
439,3,60.373333333333335,74.92266666666666,14.549333333333323,129,160,31,chromagram
439,4,74.92266666666666,138.75199999999998,63.829333333333324,160,296,136,chromagram
439,5,138.75199999999998,146.26133333333334,7.509333333333359,296,312,16,chromagram
439,6,146.26133333333334,161.28,15.018666666666661,312,344,32,chromagram
439,7,161.28,173.952,12.671999999999997,344,371,27,chromagram
439,8,173.952,180.0533333333333,6.101333333333315,371,384,13,chromagram
439,9,180.0533333333333,212.961,32.9076666666667,384,453,69,chromagram
439,1,0.0,29.866666666666664,29.866666666666664,0,64,64,chroma_acts
439,2,29.866666666666664,60.373333333333335,30.50666666666667,64,129,65,chroma_acts
439,3,60.373333333333335,74.92266666666666,14.549333333333323,129,160,31,chroma_acts
439,4,74.92266666666666,138.75199999999998,63.829333333333324,160,296,136,chroma_acts
439,5,138.75199999999998,142.50666666666666,3.7546666666666795,296,304,8,chroma_acts
439,6,142.50666666666666,146.26133333333334,3.7546666666666795,304,312,8,chroma_acts
439,7,146.26133333333334,153.77066666666667,7.5093333333333305,312,328,16,chroma_acts
439,8,153.77066666666667,180.0533333333333,26.282666666666643,328,384,56,chroma_acts
439,9,180.0533333333333,212.961,32.9076666666667,384,453,69,chroma_acts
439,1,0.0,30.336,30.336,0,65,65,chroma_acts_smoothed
439,2,30.336,60.373333333333335,30.037333333333336,65,129,64,chroma_acts_smoothed
439,3,60.373333333333335,74.45333333333333,14.079999999999998,129,159,30,chroma_acts_smoothed
439,4,74.45333333333333,118.10133333333333,43.647999999999996,159,252,93,chroma_acts_smoothed
439,5,118.10133333333333,138.75199999999998,20.650666666666652,252,296,44,chroma_acts_smoothed
439,6,138.75199999999998,146.26133333333334,7.509333333333359,296,312,16,chroma_acts_smoothed
439,7,146.26133333333334,154.23999999999998,7.978666666666641,312,329,17,chroma_acts_smoothed
439,8,154.23999999999998,180.0533333333333,25.813333333333333,329,384,55,chroma_acts_smoothed
439,9,180.0533333333333,212.961,32.9076666666667,384,453,69,chroma_acts_smoothed
439,1,0.0,29.866666666666664,29.866666666666664,0,64,64,ki_chroma
439,2,29.866666666666664,60.373333333333335,30.50666666666667,64,129,65,ki_chroma
439,3,60.373333333333335,74.92266666666666,14.549333333333323,129,160,31,ki_chroma
439,4,74.92266666666666,138.75199999999998,63.829333333333324,160,296,136,ki_chroma
439,5,138.75199999999998,146.26133333333334,7.509333333333359,296,312,16,ki_chroma
439,6,146.26133333333334,161.28,15.018666666666661,312,344,32,ki_chroma
439,7,161.28,173.952,12.671999999999997,344,371,27,ki_chroma
439,8,173.952,180.0533333333333,6.101333333333315,371,384,13,ki_chroma
439,9,180.0533333333333,212.961,32.9076666666667,384,453,69,ki_chroma
439,1,0.0,29.866666666666664,29.866666666666664,0,64,64,ki_chroma_acts
439,2,29.866666666666664,60.373333333333335,30.50666666666667,64,129,65,ki_chroma_acts
439,3,60.373333333333335,74.92266666666666,14.549333333333323,129,160,31,ki_chroma_acts
439,4,74.92266666666666,138.75199999999998,63.829333333333324,160,296,136,ki_chroma_acts
439,5,138.75199999999998,142.50666666666666,3.7546666666666795,296,304,8,ki_chroma_acts
439,6,142.50666666666666,146.26133333333334,3.7546666666666795,304,312,8,ki_chroma_acts
439,7,146.26133333333334,153.77066666666667,7.5093333333333305,312,328,16,ki_chroma_acts
439,8,153.77066666666667,180.0533333333333,26.282666666666643,328,384,56,ki_chroma_acts
439,9,180.0533333333333,212.961,32.9076666666667,384,453,69,ki_chroma_acts
439,1,0.0,30.336,30.336,0,65,65,ki_chroma_acts_smoothed
439,2,30.336,60.373333333333335,30.037333333333336,65,129,64,ki_chroma_acts_smoothed
439,3,60.373333333333335,74.45333333333333,14.079999999999998,129,159,30,ki_chroma_acts_smoothed
439,4,74.45333333333333,118.10133333333333,43.647999999999996,159,252,93,ki_chroma_acts_smoothed
439,5,118.10133333333333,138.75199999999998,20.650666666666652,252,296,44,ki_chroma_acts_smoothed
439,6,138.75199999999998,146.26133333333334,7.509333333333359,296,312,16,ki_chroma_acts_smoothed
439,7,146.26133333333334,154.23999999999998,7.978666666666641,312,329,17,ki_chroma_acts_smoothed
439,8,154.23999999999998,180.0533333333333,25.813333333333333,329,384,55,ki_chroma_acts_smoothed
439,9,180.0533333333333,212.961,32.9076666666667,384,453,69,ki_chroma_acts_smoothed
440,1,0.0,6.677333333333333,6.677333333333333,0,15,15,chromagram
440,2,6.677333333333333,38.12266666666667,31.445333333333334,15,82,67,chromagram
440,3,38.12266666666667,52.672000000000004,14.549333333333337,82,113,31,chromagram
440,4,52.672000000000004,84.58666666666667,31.91466666666667,113,181,68,chromagram
440,5,84.58666666666667,124.01066666666667,39.42399999999999,181,265,84,chromagram
440,6,124.01066666666667,138.09066666666666,14.079999999999998,265,295,30,chromagram
440,7,138.09066666666666,141.37599999999998,3.2853333333333126,295,302,7,chromagram
440,8,141.37599999999998,171.957,30.581000000000017,302,366,64,chromagram
440,1,0.0,6.677333333333333,6.677333333333333,0,15,15,chroma_acts
440,2,6.677333333333333,38.12266666666667,31.445333333333334,15,82,67,chroma_acts
440,3,38.12266666666667,52.202666666666666,14.079999999999998,82,112,30,chroma_acts
440,4,52.202666666666666,83.17866666666667,30.976000000000006,112,178,66,chroma_acts
440,5,83.17866666666667,113.216,30.037333333333322,178,242,64,chroma_acts
440,6,113.216,124.48,11.26400000000001,242,266,24,chroma_acts
440,7,124.48,141.37599999999998,16.895999999999972,266,302,36,chroma_acts
440,8,141.37599999999998,171.957,30.581000000000017,302,366,64,chroma_acts
440,1,0.0,6.677333333333333,6.677333333333333,0,15,15,chroma_acts_smoothed
440,2,6.677333333333333,38.12266666666667,31.445333333333334,15,82,67,chroma_acts_smoothed
440,3,38.12266666666667,52.672000000000004,14.549333333333337,82,113,31,chroma_acts_smoothed
440,4,52.672000000000004,83.17866666666667,30.506666666666668,113,178,65,chroma_acts_smoothed
440,5,83.17866666666667,113.216,30.037333333333322,178,242,64,chroma_acts_smoothed
440,6,113.216,124.48,11.26400000000001,242,266,24,chroma_acts_smoothed
440,7,124.48,140.90666666666667,16.426666666666662,266,301,35,chroma_acts_smoothed
440,8,140.90666666666667,171.957,31.050333333333327,301,366,65,chroma_acts_smoothed
440,1,0.0,6.677333333333333,6.677333333333333,0,15,15,ki_chroma
440,2,6.677333333333333,38.12266666666667,31.445333333333334,15,82,67,ki_chroma
440,3,38.12266666666667,52.672000000000004,14.549333333333337,82,113,31,ki_chroma
440,4,52.672000000000004,84.58666666666667,31.91466666666667,113,181,68,ki_chroma
440,5,84.58666666666667,124.01066666666667,39.42399999999999,181,265,84,ki_chroma
440,6,124.01066666666667,138.09066666666666,14.079999999999998,265,295,30,ki_chroma
440,7,138.09066666666666,141.37599999999998,3.2853333333333126,295,302,7,ki_chroma
440,8,141.37599999999998,171.957,30.581000000000017,302,366,64,ki_chroma
440,1,0.0,6.677333333333333,6.677333333333333,0,15,15,ki_chroma_acts
440,2,6.677333333333333,38.12266666666667,31.445333333333334,15,82,67,ki_chroma_acts
440,3,38.12266666666667,52.202666666666666,14.079999999999998,82,112,30,ki_chroma_acts
440,4,52.202666666666666,83.17866666666667,30.976000000000006,112,178,66,ki_chroma_acts
440,5,83.17866666666667,113.216,30.037333333333322,178,242,64,ki_chroma_acts
440,6,113.216,124.48,11.26400000000001,242,266,24,ki_chroma_acts
440,7,124.48,141.37599999999998,16.895999999999972,266,302,36,ki_chroma_acts
440,8,141.37599999999998,171.957,30.581000000000017,302,366,64,ki_chroma_acts
440,1,0.0,6.677333333333333,6.677333333333333,0,15,15,ki_chroma_acts_smoothed
440,2,6.677333333333333,38.12266666666667,31.445333333333334,15,82,67,ki_chroma_acts_smoothed
440,3,38.12266666666667,52.672000000000004,14.549333333333337,82,113,31,ki_chroma_acts_smoothed
440,4,52.672000000000004,83.17866666666667,30.506666666666668,113,178,65,ki_chroma_acts_smoothed
440,5,83.17866666666667,113.216,30.037333333333322,178,242,64,ki_chroma_acts_smoothed
440,6,113.216,124.48,11.26400000000001,242,266,24,ki_chroma_acts_smoothed
440,7,124.48,140.90666666666667,16.426666666666662,266,301,35,ki_chroma_acts_smoothed
440,8,140.90666666666667,171.957,31.050333333333327,301,366,65,ki_chroma_acts_smoothed
441,1,0.0,86.38933333333333,86.38933333333333,0,127,127,chromagram
441,2,86.38933333333333,93.216,6.826666666666668,127,137,10,chromagram
441,3,93.216,153.97333333333333,60.757333333333335,137,226,89,chromagram
441,4,153.97333333333333,161.48266666666666,7.5093333333333305,226,237,11,chromagram
441,5,161.48266666666666,164.896,3.413333333333327,237,242,5,chromagram
441,6,164.896,172.40533333333332,7.5093333333333305,242,253,11,chromagram
441,7,172.40533333333332,175.81866666666667,3.4133333333333553,253,258,5,chromagram
441,8,175.81866666666667,187.689,11.87033333333332,258,274,16,chromagram
441,1,0.0,86.38933333333333,86.38933333333333,0,127,127,chroma_acts
441,2,86.38933333333333,93.216,6.826666666666668,127,137,10,chroma_acts
441,3,93.216,153.97333333333333,60.757333333333335,137,226,89,chroma_acts
441,4,153.97333333333333,162.16533333333334,8.192000000000007,226,238,12,chroma_acts
441,5,162.16533333333334,164.896,2.73066666666665,238,242,4,chroma_acts
441,6,164.896,173.088,8.192000000000007,242,254,12,chroma_acts
441,7,173.088,175.81866666666667,2.7306666666666786,254,258,4,chroma_acts
441,8,175.81866666666667,187.689,11.87033333333332,258,274,16,chroma_acts
441,1,0.0,35.872,35.872,0,53,53,chroma_acts_smoothed
441,2,35.872,38.602666666666664,2.7306666666666644,53,57,4,chroma_acts_smoothed
441,3,38.602666666666664,79.56266666666667,40.96000000000001,57,117,60,chroma_acts_smoothed
441,4,79.56266666666667,82.29333333333334,2.7306666666666644,117,121,4,chroma_acts_smoothed
441,5,82.29333333333334,87.072,4.778666666666666,121,128,7,chroma_acts_smoothed
441,6,87.072,93.216,6.143999999999991,128,137,9,chroma_acts_smoothed
441,7,93.216,175.81866666666667,82.60266666666668,137,258,121,chroma_acts_smoothed
441,8,175.81866666666667,187.689,11.87033333333332,258,274,16,chroma_acts_smoothed
441,1,0.0,86.38933333333333,86.38933333333333,0,127,127,ki_chroma
441,2,86.38933333333333,93.216,6.826666666666668,127,137,10,ki_chroma
441,3,93.216,153.97333333333333,60.757333333333335,137,226,89,ki_chroma
441,4,153.97333333333333,161.48266666666666,7.5093333333333305,226,237,11,ki_chroma
441,5,161.48266666666666,164.896,3.413333333333327,237,242,5,ki_chroma
441,6,164.896,172.40533333333332,7.5093333333333305,242,253,11,ki_chroma
441,7,172.40533333333332,175.81866666666667,3.4133333333333553,253,258,5,ki_chroma
441,8,175.81866666666667,187.689,11.87033333333332,258,274,16,ki_chroma
441,1,0.0,86.38933333333333,86.38933333333333,0,127,127,ki_chroma_acts
441,2,86.38933333333333,93.216,6.826666666666668,127,137,10,ki_chroma_acts
441,3,93.216,153.97333333333333,60.757333333333335,137,226,89,ki_chroma_acts
441,4,153.97333333333333,162.16533333333334,8.192000000000007,226,238,12,ki_chroma_acts
441,5,162.16533333333334,164.896,2.73066666666665,238,242,4,ki_chroma_acts
441,6,164.896,173.088,8.192000000000007,242,254,12,ki_chroma_acts
441,7,173.088,175.81866666666667,2.7306666666666786,254,258,4,ki_chroma_acts
441,8,175.81866666666667,187.689,11.87033333333332,258,274,16,ki_chroma_acts
441,1,0.0,35.872,35.872,0,53,53,ki_chroma_acts_smoothed
441,2,35.872,38.602666666666664,2.7306666666666644,53,57,4,ki_chroma_acts_smoothed
441,3,38.602666666666664,79.56266666666667,40.96000000000001,57,117,60,ki_chroma_acts_smoothed
441,4,79.56266666666667,82.29333333333334,2.7306666666666644,117,121,4,ki_chroma_acts_smoothed
441,5,82.29333333333334,87.072,4.778666666666666,121,128,7,ki_chroma_acts_smoothed
441,6,87.072,93.216,6.143999999999991,128,137,9,ki_chroma_acts_smoothed
441,7,93.216,175.81866666666667,82.60266666666668,137,258,121,ki_chroma_acts_smoothed
441,8,175.81866666666667,187.689,11.87033333333332,258,274,16,ki_chroma_acts_smoothed
445,1,0.0,16.458666666666666,16.458666666666666,0,38,38,chromagram
445,2,16.458666666666666,31.328,14.869333333333334,38,72,34,chromagram
445,3,31.328,59.31733333333334,27.989333333333338,72,136,64,chromagram
445,4,59.31733333333334,72.87466666666667,13.557333333333332,136,167,31,chromagram
445,5,72.87466666666667,109.17333333333333,36.29866666666666,167,250,83,chromagram
445,6,109.17333333333333,142.41066666666666,33.237333333333325,250,326,76,chromagram
445,7,142.41066666666666,170.4,27.98933333333335,326,390,64,chromagram
445,8,170.4,173.89866666666668,3.4986666666666792,390,398,8,chromagram
445,9,173.89866666666668,191.722,17.823333333333323,398,437,39,chromagram
445,1,0.0,16.458666666666666,16.458666666666666,0,38,38,chroma_acts
445,2,16.458666666666666,31.328,14.869333333333334,38,72,34,chroma_acts
445,3,31.328,59.31733333333334,27.989333333333338,72,136,64,chroma_acts
445,4,59.31733333333334,72.87466666666667,13.557333333333332,136,167,31,chroma_acts
445,5,72.87466666666667,112.672,39.79733333333333,167,258,91,chroma_acts
445,6,112.672,139.34933333333333,26.677333333333337,258,319,61,chroma_acts
445,7,139.34933333333333,170.4,31.05066666666667,319,390,71,chroma_acts
445,8,170.4,173.89866666666668,3.4986666666666792,390,398,8,chroma_acts
445,9,173.89866666666668,191.722,17.823333333333323,398,437,39,chroma_acts
445,1,0.0,17.770666666666667,17.770666666666667,0,41,41,chroma_acts_smoothed
445,2,17.770666666666667,31.328,13.557333333333332,41,72,31,chroma_acts_smoothed
445,3,31.328,58.00533333333333,26.677333333333333,72,133,61,chroma_acts_smoothed
445,4,58.00533333333333,72.87466666666667,14.869333333333337,133,167,34,chroma_acts_smoothed
445,5,72.87466666666667,113.10933333333334,40.23466666666667,167,259,92,chroma_acts_smoothed
445,6,113.10933333333334,142.41066666666666,29.301333333333318,259,326,67,chroma_acts_smoothed
445,7,142.41066666666666,170.4,27.98933333333335,326,390,64,chroma_acts_smoothed
445,8,170.4,173.89866666666668,3.4986666666666792,390,398,8,chroma_acts_smoothed
445,9,173.89866666666668,191.722,17.823333333333323,398,437,39,chroma_acts_smoothed
445,1,0.0,16.458666666666666,16.458666666666666,0,38,38,ki_chroma
445,2,16.458666666666666,31.328,14.869333333333334,38,72,34,ki_chroma
445,3,31.328,59.31733333333334,27.989333333333338,72,136,64,ki_chroma
445,4,59.31733333333334,72.87466666666667,13.557333333333332,136,167,31,ki_chroma
445,5,72.87466666666667,109.17333333333333,36.29866666666666,167,250,83,ki_chroma
445,6,109.17333333333333,142.41066666666666,33.237333333333325,250,326,76,ki_chroma
445,7,142.41066666666666,170.4,27.98933333333335,326,390,64,ki_chroma
445,8,170.4,173.89866666666668,3.4986666666666792,390,398,8,ki_chroma
445,9,173.89866666666668,191.722,17.823333333333323,398,437,39,ki_chroma
445,1,0.0,16.458666666666666,16.458666666666666,0,38,38,ki_chroma_acts
445,2,16.458666666666666,31.328,14.869333333333334,38,72,34,ki_chroma_acts
445,3,31.328,59.31733333333334,27.989333333333338,72,136,64,ki_chroma_acts
445,4,59.31733333333334,72.87466666666667,13.557333333333332,136,167,31,ki_chroma_acts
445,5,72.87466666666667,112.672,39.79733333333333,167,258,91,ki_chroma_acts
445,6,112.672,139.34933333333333,26.677333333333337,258,319,61,ki_chroma_acts
445,7,139.34933333333333,170.4,31.05066666666667,319,390,71,ki_chroma_acts
445,8,170.4,173.89866666666668,3.4986666666666792,390,398,8,ki_chroma_acts
445,9,173.89866666666668,191.722,17.823333333333323,398,437,39,ki_chroma_acts
445,1,0.0,17.770666666666667,17.770666666666667,0,41,41,ki_chroma_acts_smoothed
445,2,17.770666666666667,31.328,13.557333333333332,41,72,31,ki_chroma_acts_smoothed
445,3,31.328,58.00533333333333,26.677333333333333,72,133,61,ki_chroma_acts_smoothed
445,4,58.00533333333333,72.87466666666667,14.869333333333337,133,167,34,ki_chroma_acts_smoothed
445,5,72.87466666666667,113.10933333333334,40.23466666666667,167,259,92,ki_chroma_acts_smoothed
445,6,113.10933333333334,142.41066666666666,29.301333333333318,259,326,67,ki_chroma_acts_smoothed
445,7,142.41066666666666,170.4,27.98933333333335,326,390,64,ki_chroma_acts_smoothed
445,8,170.4,173.89866666666668,3.4986666666666792,390,398,8,ki_chroma_acts_smoothed
445,9,173.89866666666668,191.722,17.823333333333323,398,437,39,ki_chroma_acts_smoothed
447,1,0.0,14.15466666666667,14.15466666666667,0,32,32,chromagram
447,2,14.15466666666667,71.49866666666668,57.34400000000001,32,160,128,chromagram
447,3,71.49866666666668,100.17066666666668,28.671999999999997,160,224,64,chromagram
447,4,100.17066666666668,110.92266666666669,10.75200000000001,224,248,24,chromagram
447,5,110.92266666666669,129.7386666666667,18.816000000000003,248,290,42,chromagram
447,6,129.7386666666667,140.9386666666667,11.200000000000017,290,315,25,chromagram
447,7,140.9386666666667,157.5146666666667,16.575999999999993,315,352,37,chromagram
447,8,157.5146666666667,200.0746666666667,42.56,352,447,95,chromagram
447,9,200.0746666666667,209.105,9.030333333333289,447,466,19,chromagram
447,1,0.0,14.15466666666667,14.15466666666667,0,32,32,chroma_acts
447,2,14.15466666666667,71.49866666666668,57.34400000000001,32,160,128,chroma_acts
447,3,71.49866666666668,97.48266666666667,25.983999999999995,160,218,58,chroma_acts
447,4,97.48266666666667,114.50666666666669,17.024000000000015,218,256,38,chroma_acts
447,5,114.50666666666669,140.9386666666667,26.432000000000016,256,315,59,chroma_acts
447,6,140.9386666666667,146.7626666666667,5.823999999999984,315,328,13,chroma_acts
447,7,146.7626666666667,157.5146666666667,10.75200000000001,328,352,24,chroma_acts
447,8,157.5146666666667,200.0746666666667,42.56,352,447,95,chroma_acts
447,9,200.0746666666667,209.105,9.030333333333289,447,466,19,chroma_acts
447,1,0.0,14.15466666666667,14.15466666666667,0,32,32,chroma_acts_smoothed
447,2,14.15466666666667,71.49866666666668,57.34400000000001,32,160,128,chroma_acts_smoothed
447,3,71.49866666666668,100.17066666666668,28.671999999999997,160,224,64,chroma_acts_smoothed
447,4,100.17066666666668,114.50666666666669,14.336000000000013,224,256,32,chroma_acts_smoothed
447,5,114.50666666666669,141.3866666666667,26.880000000000024,256,316,60,chroma_acts_smoothed
447,6,141.3866666666667,146.3146666666667,4.927999999999997,316,327,11,chroma_acts_smoothed
447,7,146.3146666666667,156.1706666666667,9.855999999999995,327,349,22,chroma_acts_smoothed
447,8,156.1706666666667,200.0746666666667,43.903999999999996,349,447,98,chroma_acts_smoothed
447,9,200.0746666666667,209.105,9.030333333333289,447,466,19,chroma_acts_smoothed
447,1,0.0,14.15466666666667,14.15466666666667,0,32,32,ki_chroma
447,2,14.15466666666667,71.49866666666668,57.34400000000001,32,160,128,ki_chroma
447,3,71.49866666666668,100.17066666666668,28.671999999999997,160,224,64,ki_chroma
447,4,100.17066666666668,110.92266666666669,10.75200000000001,224,248,24,ki_chroma
447,5,110.92266666666669,129.7386666666667,18.816000000000003,248,290,42,ki_chroma
447,6,129.7386666666667,140.9386666666667,11.200000000000017,290,315,25,ki_chroma
447,7,140.9386666666667,157.5146666666667,16.575999999999993,315,352,37,ki_chroma
447,8,157.5146666666667,200.0746666666667,42.56,352,447,95,ki_chroma
447,9,200.0746666666667,209.105,9.030333333333289,447,466,19,ki_chroma
447,1,0.0,14.15466666666667,14.15466666666667,0,32,32,ki_chroma_acts
447,2,14.15466666666667,71.49866666666668,57.34400000000001,32,160,128,ki_chroma_acts
447,3,71.49866666666668,97.48266666666667,25.983999999999995,160,218,58,ki_chroma_acts
447,4,97.48266666666667,114.50666666666669,17.024000000000015,218,256,38,ki_chroma_acts
447,5,114.50666666666669,140.9386666666667,26.432000000000016,256,315,59,ki_chroma_acts
447,6,140.9386666666667,146.7626666666667,5.823999999999984,315,328,13,ki_chroma_acts
447,7,146.7626666666667,157.5146666666667,10.75200000000001,328,352,24,ki_chroma_acts
447,8,157.5146666666667,200.0746666666667,42.56,352,447,95,ki_chroma_acts
447,9,200.0746666666667,209.105,9.030333333333289,447,466,19,ki_chroma_acts
447,1,0.0,14.15466666666667,14.15466666666667,0,32,32,ki_chroma_acts_smoothed
447,2,14.15466666666667,71.49866666666668,57.34400000000001,32,160,128,ki_chroma_acts_smoothed
447,3,71.49866666666668,100.17066666666668,28.671999999999997,160,224,64,ki_chroma_acts_smoothed
447,4,100.17066666666668,114.50666666666669,14.336000000000013,224,256,32,ki_chroma_acts_smoothed
447,5,114.50666666666669,141.3866666666667,26.880000000000024,256,316,60,ki_chroma_acts_smoothed
447,6,141.3866666666667,146.3146666666667,4.927999999999997,316,327,11,ki_chroma_acts_smoothed
447,7,146.3146666666667,156.1706666666667,9.855999999999995,327,349,22,ki_chroma_acts_smoothed
447,8,156.1706666666667,200.0746666666667,43.903999999999996,349,447,98,ki_chroma_acts_smoothed
447,9,200.0746666666667,209.105,9.030333333333289,447,466,19,ki_chroma_acts_smoothed
448,1,0.0,32.40533333333333,32.40533333333333,0,67,67,chromagram
448,2,32.40533333333333,35.349333333333334,2.9440000000000026,67,73,6,chromagram
448,3,35.349333333333334,56.448,21.098666666666666,73,116,43,chromagram
448,4,56.448,117.29066666666668,60.84266666666668,116,240,124,chromagram
448,5,117.29066666666668,184.02133333333333,66.73066666666665,240,376,136,chromagram
448,6,184.02133333333333,187.45600000000002,3.4346666666666863,376,383,7,chromagram
448,7,187.45600000000002,230.144,42.68799999999999,383,470,87,chromagram
448,8,230.144,275.28533333333337,45.141333333333364,470,562,92,chromagram
448,9,275.28533333333337,293.563,18.27766666666662,562,598,36,chromagram
448,1,0.0,29.461333333333336,29.461333333333336,0,61,61,chroma_acts
448,2,29.461333333333336,38.29333333333334,8.832,61,79,18,chroma_acts
448,3,38.29333333333334,56.448,18.154666666666664,79,116,37,chroma_acts
448,4,56.448,73.13066666666667,16.68266666666667,116,150,34,chroma_acts
448,5,73.13066666666667,89.81333333333333,16.682666666666663,150,184,34,chroma_acts
448,6,89.81333333333333,120.72533333333334,30.912000000000006,184,247,63,chroma_acts
448,7,120.72533333333334,185.00266666666667,64.27733333333333,247,378,131,chroma_acts
448,8,185.00266666666667,232.10666666666668,47.10400000000001,378,474,96,chroma_acts
448,9,232.10666666666668,293.563,61.456333333333305,474,598,124,chroma_acts
448,1,0.0,29.461333333333336,29.461333333333336,0,61,61,chroma_acts_smoothed
448,2,29.461333333333336,36.821333333333335,7.359999999999999,61,76,15,chroma_acts_smoothed
448,3,36.821333333333335,56.448,19.626666666666665,76,116,40,chroma_acts_smoothed
448,4,56.448,72.64,16.192,116,149,33,chroma_acts_smoothed
448,5,72.64,89.81333333333333,17.173333333333332,149,184,35,chroma_acts_smoothed
448,6,89.81333333333333,111.40266666666668,21.589333333333343,184,228,44,chroma_acts_smoothed
448,7,111.40266666666668,184.02133333333333,72.61866666666666,228,376,148,chroma_acts_smoothed
448,8,184.02133333333333,232.10666666666668,48.08533333333335,376,474,98,chroma_acts_smoothed
448,9,232.10666666666668,293.563,61.456333333333305,474,598,124,chroma_acts_smoothed
448,1,0.0,32.40533333333333,32.40533333333333,0,67,67,ki_chroma
448,2,32.40533333333333,35.349333333333334,2.9440000000000026,67,73,6,ki_chroma
448,3,35.349333333333334,56.448,21.098666666666666,73,116,43,ki_chroma
448,4,56.448,117.29066666666668,60.84266666666668,116,240,124,ki_chroma
448,5,117.29066666666668,184.02133333333333,66.73066666666665,240,376,136,ki_chroma
448,6,184.02133333333333,187.45600000000002,3.4346666666666863,376,383,7,ki_chroma
448,7,187.45600000000002,230.144,42.68799999999999,383,470,87,ki_chroma
448,8,230.144,275.28533333333337,45.141333333333364,470,562,92,ki_chroma
448,9,275.28533333333337,293.563,18.27766666666662,562,598,36,ki_chroma
448,1,0.0,29.461333333333336,29.461333333333336,0,61,61,ki_chroma_acts
448,2,29.461333333333336,38.29333333333334,8.832,61,79,18,ki_chroma_acts
448,3,38.29333333333334,56.448,18.154666666666664,79,116,37,ki_chroma_acts
448,4,56.448,73.13066666666667,16.68266666666667,116,150,34,ki_chroma_acts
448,5,73.13066666666667,89.81333333333333,16.682666666666663,150,184,34,ki_chroma_acts
448,6,89.81333333333333,120.72533333333334,30.912000000000006,184,247,63,ki_chroma_acts
448,7,120.72533333333334,185.00266666666667,64.27733333333333,247,378,131,ki_chroma_acts
448,8,185.00266666666667,232.10666666666668,47.10400000000001,378,474,96,ki_chroma_acts
448,9,232.10666666666668,293.563,61.456333333333305,474,598,124,ki_chroma_acts
448,1,0.0,29.461333333333336,29.461333333333336,0,61,61,ki_chroma_acts_smoothed
448,2,29.461333333333336,36.821333333333335,7.359999999999999,61,76,15,ki_chroma_acts_smoothed
448,3,36.821333333333335,56.448,19.626666666666665,76,116,40,ki_chroma_acts_smoothed
448,4,56.448,72.64,16.192,116,149,33,ki_chroma_acts_smoothed
448,5,72.64,89.81333333333333,17.173333333333332,149,184,35,ki_chroma_acts_smoothed
448,6,89.81333333333333,111.40266666666668,21.589333333333343,184,228,44,ki_chroma_acts_smoothed
448,7,111.40266666666668,184.02133333333333,72.61866666666666,228,376,148,ki_chroma_acts_smoothed
448,8,184.02133333333333,232.10666666666668,48.08533333333335,376,474,98,ki_chroma_acts_smoothed
448,9,232.10666666666668,293.563,61.456333333333305,474,598,124,ki_chroma_acts_smoothed
450,1,0.0,12.672,12.672,0,26,26,chromagram
450,2,12.672,16.597333333333335,3.9253333333333345,26,34,8,chromagram
450,3,16.597333333333335,44.074666666666666,27.47733333333333,34,90,56,chromagram
450,4,44.074666666666666,87.25333333333333,43.178666666666665,90,178,88,chromagram
450,5,87.25333333333333,123.072,35.81866666666667,178,251,73,chromagram
450,6,123.072,132.88533333333336,9.813333333333361,251,271,20,chromagram
450,7,132.88533333333336,181.95200000000003,49.06666666666666,271,371,100,chromagram
450,8,181.95200000000003,189.80266666666668,7.850666666666655,371,387,16,chromagram
450,9,189.80266666666668,200.479,10.676333333333332,387,407,20,chromagram
450,1,0.0,12.672,12.672,0,26,26,chroma_acts
450,2,12.672,16.597333333333335,3.9253333333333345,26,34,8,chroma_acts
450,3,16.597333333333335,44.074666666666666,27.47733333333333,34,90,56,chroma_acts
450,4,44.074666666666666,87.25333333333333,43.178666666666665,90,178,88,chroma_acts
450,5,87.25333333333333,138.77333333333334,51.52000000000001,178,283,105,chroma_acts
450,6,138.77333333333334,181.95200000000003,43.178666666666686,283,371,88,chroma_acts
450,7,181.95200000000003,185.87733333333335,3.9253333333333273,371,379,8,chroma_acts
450,8,185.87733333333335,189.80266666666668,3.9253333333333273,379,387,8,chroma_acts
450,9,189.80266666666668,200.479,10.676333333333332,387,407,20,chroma_acts
450,1,0.0,12.672,12.672,0,26,26,chroma_acts_smoothed
450,2,12.672,16.597333333333335,3.9253333333333345,26,34,8,chroma_acts_smoothed
450,3,16.597333333333335,44.074666666666666,27.47733333333333,34,90,56,chroma_acts_smoothed
450,4,44.074666666666666,87.25333333333333,43.178666666666665,90,178,88,chroma_acts_smoothed
450,5,87.25333333333333,125.03466666666667,37.781333333333336,178,255,77,chroma_acts_smoothed
450,6,125.03466666666667,132.88533333333336,7.850666666666697,255,271,16,chroma_acts_smoothed
450,7,132.88533333333336,185.87733333333335,52.99199999999999,271,379,108,chroma_acts_smoothed
450,8,185.87733333333335,189.80266666666668,3.9253333333333273,379,387,8,chroma_acts_smoothed
450,9,189.80266666666668,200.479,10.676333333333332,387,407,20,chroma_acts_smoothed
450,1,0.0,12.672,12.672,0,26,26,ki_chroma
450,2,12.672,16.597333333333335,3.9253333333333345,26,34,8,ki_chroma
450,3,16.597333333333335,44.074666666666666,27.47733333333333,34,90,56,ki_chroma
450,4,44.074666666666666,87.25333333333333,43.178666666666665,90,178,88,ki_chroma
450,5,87.25333333333333,123.072,35.81866666666667,178,251,73,ki_chroma
450,6,123.072,132.88533333333336,9.813333333333361,251,271,20,ki_chroma
450,7,132.88533333333336,181.95200000000003,49.06666666666666,271,371,100,ki_chroma
450,8,181.95200000000003,189.80266666666668,7.850666666666655,371,387,16,ki_chroma
450,9,189.80266666666668,200.479,10.676333333333332,387,407,20,ki_chroma
450,1,0.0,12.672,12.672,0,26,26,ki_chroma_acts
450,2,12.672,16.597333333333335,3.9253333333333345,26,34,8,ki_chroma_acts
450,3,16.597333333333335,44.074666666666666,27.47733333333333,34,90,56,ki_chroma_acts
450,4,44.074666666666666,87.25333333333333,43.178666666666665,90,178,88,ki_chroma_acts
450,5,87.25333333333333,138.77333333333334,51.52000000000001,178,283,105,ki_chroma_acts
450,6,138.77333333333334,181.95200000000003,43.178666666666686,283,371,88,ki_chroma_acts
450,7,181.95200000000003,185.87733333333335,3.9253333333333273,371,379,8,ki_chroma_acts
450,8,185.87733333333335,189.80266666666668,3.9253333333333273,379,387,8,ki_chroma_acts
450,9,189.80266666666668,200.479,10.676333333333332,387,407,20,ki_chroma_acts
450,1,0.0,12.672,12.672,0,26,26,ki_chroma_acts_smoothed
450,2,12.672,16.597333333333335,3.9253333333333345,26,34,8,ki_chroma_acts_smoothed
450,3,16.597333333333335,44.074666666666666,27.47733333333333,34,90,56,ki_chroma_acts_smoothed
450,4,44.074666666666666,87.25333333333333,43.178666666666665,90,178,88,ki_chroma_acts_smoothed
450,5,87.25333333333333,125.03466666666667,37.781333333333336,178,255,77,ki_chroma_acts_smoothed
450,6,125.03466666666667,132.88533333333336,7.850666666666697,255,271,16,ki_chroma_acts_smoothed
450,7,132.88533333333336,185.87733333333335,52.99199999999999,271,379,108,ki_chroma_acts_smoothed
450,8,185.87733333333335,189.80266666666668,3.9253333333333273,379,387,8,ki_chroma_acts_smoothed
450,9,189.80266666666668,200.479,10.676333333333332,387,407,20,ki_chroma_acts_smoothed
451,1,0.0,22.496,22.496,0,48,48,chromagram
451,2,22.496,30.005333333333333,7.509333333333334,48,64,16,chromagram
451,3,30.005333333333333,58.16533333333333,28.159999999999997,64,124,60,chromagram
451,4,58.16533333333333,69.42933333333333,11.264000000000003,124,148,24,chromagram
451,5,69.42933333333333,76.0,6.570666666666668,148,162,14,chromagram
451,6,76.0,78.816,2.8160000000000025,162,168,6,chromagram
451,7,78.816,79.75466666666667,0.9386666666666628,168,170,2,chromagram
451,8,79.75466666666667,116.36266666666667,36.608000000000004,170,248,78,chromagram
451,9,116.36266666666667,165.0,48.63733333333333,248,350,102,chromagram
451,1,0.0,7.477333333333333,7.477333333333333,0,16,16,chroma_acts
451,2,7.477333333333333,30.005333333333333,22.528,16,64,48,chroma_acts
451,3,30.005333333333333,58.16533333333333,28.159999999999997,64,124,60,chroma_acts
451,4,58.16533333333333,73.184,15.018666666666668,124,156,32,chroma_acts
451,5,73.184,76.93866666666666,3.7546666666666653,156,164,8,chroma_acts
451,6,76.93866666666666,78.816,1.8773333333333397,164,168,4,chroma_acts
451,7,78.816,80.69333333333333,1.8773333333333255,168,172,4,chroma_acts
451,8,80.69333333333333,112.13866666666667,31.445333333333338,172,239,67,chroma_acts
451,9,112.13866666666667,165.0,52.861333333333334,239,350,111,chroma_acts
451,1,0.0,7.477333333333333,7.477333333333333,0,16,16,chroma_acts_smoothed
451,2,7.477333333333333,29.066666666666666,21.589333333333332,16,62,46,chroma_acts_smoothed
451,3,29.066666666666666,58.16533333333333,29.098666666666663,62,124,62,chroma_acts_smoothed
451,4,58.16533333333333,72.71466666666666,14.54933333333333,124,155,31,chroma_acts_smoothed
451,5,72.71466666666666,76.0,3.285333333333341,155,162,7,chroma_acts_smoothed
451,6,76.0,115.89333333333333,39.89333333333333,162,247,85,chroma_acts_smoothed
451,7,115.89333333333333,119.648,3.7546666666666653,247,255,8,chroma_acts_smoothed
451,8,119.648,165.0,45.352000000000004,255,350,95,chroma_acts_smoothed
451,1,0.0,22.496,22.496,0,48,48,ki_chroma
451,2,22.496,30.005333333333333,7.509333333333334,48,64,16,ki_chroma
451,3,30.005333333333333,58.16533333333333,28.159999999999997,64,124,60,ki_chroma
451,4,58.16533333333333,69.42933333333333,11.264000000000003,124,148,24,ki_chroma
451,5,69.42933333333333,76.0,6.570666666666668,148,162,14,ki_chroma
451,6,76.0,78.816,2.8160000000000025,162,168,6,ki_chroma
451,7,78.816,79.75466666666667,0.9386666666666628,168,170,2,ki_chroma
451,8,79.75466666666667,116.36266666666667,36.608000000000004,170,248,78,ki_chroma
451,9,116.36266666666667,165.0,48.63733333333333,248,350,102,ki_chroma
451,1,0.0,7.477333333333333,7.477333333333333,0,16,16,ki_chroma_acts
451,2,7.477333333333333,30.005333333333333,22.528,16,64,48,ki_chroma_acts
451,3,30.005333333333333,58.16533333333333,28.159999999999997,64,124,60,ki_chroma_acts
451,4,58.16533333333333,73.184,15.018666666666668,124,156,32,ki_chroma_acts
451,5,73.184,76.93866666666666,3.7546666666666653,156,164,8,ki_chroma_acts
451,6,76.93866666666666,78.816,1.8773333333333397,164,168,4,ki_chroma_acts
451,7,78.816,80.69333333333333,1.8773333333333255,168,172,4,ki_chroma_acts
451,8,80.69333333333333,112.13866666666667,31.445333333333338,172,239,67,ki_chroma_acts
451,9,112.13866666666667,165.0,52.861333333333334,239,350,111,ki_chroma_acts
451,1,0.0,7.477333333333333,7.477333333333333,0,16,16,ki_chroma_acts_smoothed
451,2,7.477333333333333,29.066666666666666,21.589333333333332,16,62,46,ki_chroma_acts_smoothed
451,3,29.066666666666666,58.16533333333333,29.098666666666663,62,124,62,ki_chroma_acts_smoothed
451,4,58.16533333333333,72.71466666666666,14.54933333333333,124,155,31,ki_chroma_acts_smoothed
451,5,72.71466666666666,76.0,3.285333333333341,155,162,7,ki_chroma_acts_smoothed
451,6,76.0,115.89333333333333,39.89333333333333,162,247,85,ki_chroma_acts_smoothed
451,7,115.89333333333333,119.648,3.7546666666666653,247,255,8,ki_chroma_acts_smoothed
451,8,119.648,165.0,45.352000000000004,255,350,95,ki_chroma_acts_smoothed
452,1,0.0,6.944,6.944,0,15,15,chromagram
452,2,6.944,11.168,4.223999999999999,15,24,9,chromagram
452,3,11.168,78.28266666666666,67.11466666666666,24,167,143,chromagram
452,4,78.28266666666666,128.032,49.749333333333354,167,273,106,chromagram
452,5,128.032,138.35733333333334,10.325333333333333,273,295,22,chromagram
452,6,138.35733333333334,143.05066666666667,4.693333333333328,295,305,10,chromagram
452,7,143.05066666666667,153.84533333333334,10.794666666666672,305,328,23,chromagram
452,8,153.84533333333334,187.781,33.93566666666666,328,399,71,chromagram
452,1,0.0,10.698666666666666,10.698666666666666,0,23,23,chroma_acts
452,2,10.698666666666666,14.453333333333333,3.754666666666667,23,31,8,chroma_acts
452,3,14.453333333333333,26.186666666666667,11.733333333333334,31,56,25,chroma_acts
452,4,26.186666666666667,29.472,3.285333333333334,56,63,7,chroma_acts
452,5,29.472,41.20533333333333,11.733333333333327,63,88,25,chroma_acts
452,6,41.20533333333333,78.752,37.54666666666667,88,168,80,chroma_acts
452,7,78.752,123.80799999999999,45.056,168,264,96,chroma_acts
452,8,123.80799999999999,154.31466666666668,30.50666666666669,264,329,65,chroma_acts
452,9,154.31466666666668,187.781,33.466333333333324,329,399,70,chroma_acts
452,1,0.0,44.49066666666666,44.49066666666666,0,95,95,chroma_acts_smoothed
452,2,44.49066666666666,56.69333333333333,12.202666666666666,95,121,26,chroma_acts_smoothed
452,3,56.69333333333333,59.50933333333333,2.8160000000000025,121,127,6,chroma_acts_smoothed
452,4,59.50933333333333,67.488,7.978666666666669,127,144,17,chroma_acts_smoothed
452,5,67.488,78.28266666666666,10.794666666666657,144,167,23,chroma_acts_smoothed
452,6,78.28266666666666,123.33866666666667,45.05600000000001,167,263,96,chroma_acts_smoothed
452,7,123.33866666666667,143.05066666666667,19.712000000000003,263,305,42,chroma_acts_smoothed
452,8,143.05066666666667,154.31466666666668,11.26400000000001,305,329,24,chroma_acts_smoothed
452,9,154.31466666666668,187.781,33.466333333333324,329,399,70,chroma_acts_smoothed
452,1,0.0,6.944,6.944,0,15,15,ki_chroma
452,2,6.944,11.168,4.223999999999999,15,24,9,ki_chroma
452,3,11.168,78.28266666666666,67.11466666666666,24,167,143,ki_chroma
452,4,78.28266666666666,128.032,49.749333333333354,167,273,106,ki_chroma
452,5,128.032,138.35733333333334,10.325333333333333,273,295,22,ki_chroma
452,6,138.35733333333334,143.05066666666667,4.693333333333328,295,305,10,ki_chroma
452,7,143.05066666666667,153.84533333333334,10.794666666666672,305,328,23,ki_chroma
452,8,153.84533333333334,187.781,33.93566666666666,328,399,71,ki_chroma
452,1,0.0,10.698666666666666,10.698666666666666,0,23,23,ki_chroma_acts
452,2,10.698666666666666,14.453333333333333,3.754666666666667,23,31,8,ki_chroma_acts
452,3,14.453333333333333,26.186666666666667,11.733333333333334,31,56,25,ki_chroma_acts
452,4,26.186666666666667,29.472,3.285333333333334,56,63,7,ki_chroma_acts
452,5,29.472,41.20533333333333,11.733333333333327,63,88,25,ki_chroma_acts
452,6,41.20533333333333,78.752,37.54666666666667,88,168,80,ki_chroma_acts
452,7,78.752,123.80799999999999,45.056,168,264,96,ki_chroma_acts
452,8,123.80799999999999,154.31466666666668,30.50666666666669,264,329,65,ki_chroma_acts
452,9,154.31466666666668,187.781,33.466333333333324,329,399,70,ki_chroma_acts
452,1,0.0,44.49066666666666,44.49066666666666,0,95,95,ki_chroma_acts_smoothed
452,2,44.49066666666666,56.69333333333333,12.202666666666666,95,121,26,ki_chroma_acts_smoothed
452,3,56.69333333333333,59.50933333333333,2.8160000000000025,121,127,6,ki_chroma_acts_smoothed
452,4,59.50933333333333,67.488,7.978666666666669,127,144,17,ki_chroma_acts_smoothed
452,5,67.488,78.28266666666666,10.794666666666657,144,167,23,ki_chroma_acts_smoothed
452,6,78.28266666666666,123.33866666666667,45.05600000000001,167,263,96,ki_chroma_acts_smoothed
452,7,123.33866666666667,143.05066666666667,19.712000000000003,263,305,42,ki_chroma_acts_smoothed
452,8,143.05066666666667,154.31466666666668,11.26400000000001,305,329,24,ki_chroma_acts_smoothed
452,9,154.31466666666668,187.781,33.466333333333324,329,399,70,ki_chroma_acts_smoothed
453,1,0.0,7.231999999999999,7.231999999999999,0,16,16,chromagram
453,2,7.231999999999999,14.911999999999999,7.68,16,32,16,chromagram
453,3,14.911999999999999,30.272,15.36,32,64,32,chromagram
453,4,30.272,37.952,7.68,64,80,16,chromagram
453,5,37.952,45.632,7.68,80,96,16,chromagram
453,6,45.632,92.192,46.559999999999995,96,193,97,chromagram
453,7,92.192,114.27199999999999,22.08,193,239,46,chromagram
453,8,114.27199999999999,121.952,7.680000000000007,239,255,16,chromagram
453,9,121.952,169.782,47.83000000000001,255,353,98,chromagram
453,1,0.0,14.911999999999999,14.911999999999999,0,32,32,chroma_acts
453,2,14.911999999999999,30.272,15.36,32,64,32,chroma_acts
453,3,30.272,37.952,7.68,64,80,16,chroma_acts
453,4,37.952,45.632,7.68,80,96,16,chroma_acts
453,5,45.632,94.112,48.48,96,197,101,chroma_acts
453,6,94.112,105.63199999999999,11.519999999999996,197,221,24,chroma_acts
453,7,105.63199999999999,114.27199999999999,8.64,221,239,18,chroma_acts
453,8,114.27199999999999,121.952,7.680000000000007,239,255,16,chroma_acts
453,9,121.952,169.782,47.83000000000001,255,353,98,chroma_acts
453,1,0.0,7.231999999999999,7.231999999999999,0,16,16,chroma_acts_smoothed
453,2,7.231999999999999,15.392,8.16,16,33,17,chroma_acts_smoothed
453,3,15.392,30.752,15.36,33,65,32,chroma_acts_smoothed
453,4,30.752,37.472,6.720000000000002,65,79,14,chroma_acts_smoothed
453,5,37.472,45.632,8.159999999999997,79,96,17,chroma_acts_smoothed
453,6,45.632,91.712,46.080000000000005,96,192,96,chroma_acts_smoothed
453,7,91.712,114.752,23.039999999999992,192,240,48,chroma_acts_smoothed
453,8,114.752,121.952,7.200000000000003,240,255,15,chroma_acts_smoothed
453,9,121.952,169.782,47.83000000000001,255,353,98,chroma_acts_smoothed
453,1,0.0,7.231999999999999,7.231999999999999,0,16,16,ki_chroma
453,2,7.231999999999999,14.911999999999999,7.68,16,32,16,ki_chroma
453,3,14.911999999999999,30.272,15.36,32,64,32,ki_chroma
453,4,30.272,37.952,7.68,64,80,16,ki_chroma
453,5,37.952,45.632,7.68,80,96,16,ki_chroma
453,6,45.632,92.192,46.559999999999995,96,193,97,ki_chroma
453,7,92.192,114.27199999999999,22.08,193,239,46,ki_chroma
453,8,114.27199999999999,121.952,7.680000000000007,239,255,16,ki_chroma
453,9,121.952,169.782,47.83000000000001,255,353,98,ki_chroma
453,1,0.0,14.911999999999999,14.911999999999999,0,32,32,ki_chroma_acts
453,2,14.911999999999999,30.272,15.36,32,64,32,ki_chroma_acts
453,3,30.272,37.952,7.68,64,80,16,ki_chroma_acts
453,4,37.952,45.632,7.68,80,96,16,ki_chroma_acts
453,5,45.632,94.112,48.48,96,197,101,ki_chroma_acts
453,6,94.112,105.63199999999999,11.519999999999996,197,221,24,ki_chroma_acts
453,7,105.63199999999999,114.27199999999999,8.64,221,239,18,ki_chroma_acts
453,8,114.27199999999999,121.952,7.680000000000007,239,255,16,ki_chroma_acts
453,9,121.952,169.782,47.83000000000001,255,353,98,ki_chroma_acts
453,1,0.0,7.231999999999999,7.231999999999999,0,16,16,ki_chroma_acts_smoothed
453,2,7.231999999999999,15.392,8.16,16,33,17,ki_chroma_acts_smoothed
453,3,15.392,30.752,15.36,33,65,32,ki_chroma_acts_smoothed
453,4,30.752,37.472,6.720000000000002,65,79,14,ki_chroma_acts_smoothed
453,5,37.472,45.632,8.159999999999997,79,96,17,ki_chroma_acts_smoothed
453,6,45.632,91.712,46.080000000000005,96,192,96,ki_chroma_acts_smoothed
453,7,91.712,114.752,23.039999999999992,192,240,48,ki_chroma_acts_smoothed
453,8,114.752,121.952,7.200000000000003,240,255,15,ki_chroma_acts_smoothed
453,9,121.952,169.782,47.83000000000001,255,353,98,ki_chroma_acts_smoothed
454,1,0.0,11.306666666666667,11.306666666666667,0,25,25,chromagram
454,2,11.306666666666667,15.061333333333334,3.754666666666667,25,33,8,chromagram
454,3,15.061333333333334,44.629333333333335,29.568,33,96,63,chromagram
454,4,44.629333333333335,76.07466666666667,31.445333333333338,96,163,67,chromagram
454,5,76.07466666666667,91.09333333333333,15.018666666666661,163,195,32,chromagram
454,6,91.09333333333333,135.68,44.58666666666667,195,290,95,chromagram
454,7,135.68,165.71733333333333,30.037333333333322,290,354,64,chromagram
454,8,165.71733333333333,213.383,47.66566666666668,354,454,100,chromagram
454,1,0.0,11.306666666666667,11.306666666666667,0,25,25,chroma_acts
454,2,11.306666666666667,15.061333333333334,3.754666666666667,25,33,8,chroma_acts
454,3,15.061333333333334,45.568,30.506666666666664,33,98,65,chroma_acts
454,4,45.568,75.60533333333333,30.037333333333336,98,162,64,chroma_acts
454,5,75.60533333333333,90.624,15.018666666666661,162,194,32,chroma_acts
454,6,90.624,135.68,45.05600000000001,194,290,96,chroma_acts
454,7,135.68,166.656,30.976,290,356,66,chroma_acts
454,8,166.656,213.383,46.727000000000004,356,454,98,chroma_acts
454,1,0.0,11.306666666666667,11.306666666666667,0,25,25,chroma_acts_smoothed
454,2,11.306666666666667,15.061333333333334,3.754666666666667,25,33,8,chroma_acts_smoothed
454,3,15.061333333333334,45.568,30.506666666666664,33,98,65,chroma_acts_smoothed
454,4,45.568,76.07466666666667,30.506666666666675,98,163,65,chroma_acts_smoothed
454,5,76.07466666666667,91.09333333333333,15.018666666666661,163,195,32,chroma_acts_smoothed
454,6,91.09333333333333,135.21066666666667,44.117333333333335,195,289,94,chroma_acts_smoothed
454,7,135.21066666666667,166.656,31.445333333333338,289,356,67,chroma_acts_smoothed
454,8,166.656,213.383,46.727000000000004,356,454,98,chroma_acts_smoothed
454,1,0.0,11.306666666666667,11.306666666666667,0,25,25,ki_chroma
454,2,11.306666666666667,15.061333333333334,3.754666666666667,25,33,8,ki_chroma
454,3,15.061333333333334,44.629333333333335,29.568,33,96,63,ki_chroma
454,4,44.629333333333335,76.07466666666667,31.445333333333338,96,163,67,ki_chroma
454,5,76.07466666666667,91.09333333333333,15.018666666666661,163,195,32,ki_chroma
454,6,91.09333333333333,135.68,44.58666666666667,195,290,95,ki_chroma
454,7,135.68,165.71733333333333,30.037333333333322,290,354,64,ki_chroma
454,8,165.71733333333333,213.383,47.66566666666668,354,454,100,ki_chroma
454,1,0.0,11.306666666666667,11.306666666666667,0,25,25,ki_chroma_acts
454,2,11.306666666666667,15.061333333333334,3.754666666666667,25,33,8,ki_chroma_acts
454,3,15.061333333333334,45.568,30.506666666666664,33,98,65,ki_chroma_acts
454,4,45.568,75.60533333333333,30.037333333333336,98,162,64,ki_chroma_acts
454,5,75.60533333333333,90.624,15.018666666666661,162,194,32,ki_chroma_acts
454,6,90.624,135.68,45.05600000000001,194,290,96,ki_chroma_acts
454,7,135.68,166.656,30.976,290,356,66,ki_chroma_acts
454,8,166.656,213.383,46.727000000000004,356,454,98,ki_chroma_acts
454,1,0.0,11.306666666666667,11.306666666666667,0,25,25,ki_chroma_acts_smoothed
454,2,11.306666666666667,15.061333333333334,3.754666666666667,25,33,8,ki_chroma_acts_smoothed
454,3,15.061333333333334,45.568,30.506666666666664,33,98,65,ki_chroma_acts_smoothed
454,4,45.568,76.07466666666667,30.506666666666675,98,163,65,ki_chroma_acts_smoothed
454,5,76.07466666666667,91.09333333333333,15.018666666666661,163,195,32,ki_chroma_acts_smoothed
454,6,91.09333333333333,135.21066666666667,44.117333333333335,195,289,94,ki_chroma_acts_smoothed
454,7,135.21066666666667,166.656,31.445333333333338,289,356,67,ki_chroma_acts_smoothed
454,8,166.656,213.383,46.727000000000004,356,454,98,ki_chroma_acts_smoothed
456,1,0.0,33.632,33.632,0,72,72,chromagram
456,2,33.632,59.91466666666667,26.28266666666667,72,128,56,chromagram
456,3,59.91466666666667,63.669333333333334,3.7546666666666653,128,136,8,chromagram
456,4,63.669333333333334,78.68799999999999,15.018666666666654,136,168,32,chromagram
456,5,78.68799999999999,114.82666666666665,36.138666666666666,168,245,77,chromagram
456,6,114.82666666666665,138.76266666666666,23.936000000000007,245,296,51,chromagram
456,7,138.76266666666666,165.04533333333333,26.28266666666667,296,352,56,chromagram
456,8,165.04533333333333,170.17,5.124666666666656,352,361,9,chromagram
456,1,0.0,33.632,33.632,0,72,72,chroma_acts
456,2,33.632,59.91466666666667,26.28266666666667,72,128,56,chroma_acts
456,3,59.91466666666667,63.669333333333334,3.7546666666666653,128,136,8,chroma_acts
456,4,63.669333333333334,78.68799999999999,15.018666666666654,136,168,32,chroma_acts
456,5,78.68799999999999,119.98933333333332,41.30133333333333,168,256,88,chroma_acts
456,6,119.98933333333332,135.47733333333335,15.488000000000028,256,289,33,chroma_acts
456,7,135.47733333333335,138.76266666666666,3.2853333333333126,289,296,7,chroma_acts
456,8,138.76266666666666,170.17,31.407333333333327,296,361,65,chroma_acts
456,1,0.0,33.16266666666667,33.16266666666667,0,71,71,chroma_acts_smoothed
456,2,33.16266666666667,59.91466666666667,26.752000000000002,71,128,57,chroma_acts_smoothed
456,3,59.91466666666667,63.669333333333334,3.7546666666666653,128,136,8,chroma_acts_smoothed
456,4,63.669333333333334,78.68799999999999,15.018666666666654,136,168,32,chroma_acts_smoothed
456,5,78.68799999999999,107.78666666666666,29.098666666666674,168,230,62,chroma_acts_smoothed
456,6,107.78666666666666,135.008,27.221333333333348,230,288,58,chroma_acts_smoothed
456,7,135.008,138.29333333333335,3.285333333333341,288,295,7,chroma_acts_smoothed
456,8,138.29333333333335,170.17,31.876666666666637,295,361,66,chroma_acts_smoothed
456,1,0.0,33.632,33.632,0,72,72,ki_chroma
456,2,33.632,59.91466666666667,26.28266666666667,72,128,56,ki_chroma
456,3,59.91466666666667,63.669333333333334,3.7546666666666653,128,136,8,ki_chroma
456,4,63.669333333333334,78.68799999999999,15.018666666666654,136,168,32,ki_chroma
456,5,78.68799999999999,114.82666666666665,36.138666666666666,168,245,77,ki_chroma
456,6,114.82666666666665,138.76266666666666,23.936000000000007,245,296,51,ki_chroma
456,7,138.76266666666666,165.04533333333333,26.28266666666667,296,352,56,ki_chroma
456,8,165.04533333333333,170.17,5.124666666666656,352,361,9,ki_chroma
456,1,0.0,33.632,33.632,0,72,72,ki_chroma_acts
456,2,33.632,59.91466666666667,26.28266666666667,72,128,56,ki_chroma_acts
456,3,59.91466666666667,63.669333333333334,3.7546666666666653,128,136,8,ki_chroma_acts
456,4,63.669333333333334,78.68799999999999,15.018666666666654,136,168,32,ki_chroma_acts
456,5,78.68799999999999,119.98933333333332,41.30133333333333,168,256,88,ki_chroma_acts
456,6,119.98933333333332,135.47733333333335,15.488000000000028,256,289,33,ki_chroma_acts
456,7,135.47733333333335,138.76266666666666,3.2853333333333126,289,296,7,ki_chroma_acts
456,8,138.76266666666666,170.17,31.407333333333327,296,361,65,ki_chroma_acts
456,1,0.0,33.16266666666667,33.16266666666667,0,71,71,ki_chroma_acts_smoothed
456,2,33.16266666666667,59.91466666666667,26.752000000000002,71,128,57,ki_chroma_acts_smoothed
456,3,59.91466666666667,63.669333333333334,3.7546666666666653,128,136,8,ki_chroma_acts_smoothed
456,4,63.669333333333334,78.68799999999999,15.018666666666654,136,168,32,ki_chroma_acts_smoothed
456,5,78.68799999999999,107.78666666666666,29.098666666666674,168,230,62,ki_chroma_acts_smoothed
456,6,107.78666666666666,135.008,27.221333333333348,230,288,58,ki_chroma_acts_smoothed
456,7,135.008,138.29333333333335,3.285333333333341,288,295,7,ki_chroma_acts_smoothed
456,8,138.29333333333335,170.17,31.876666666666637,295,361,66,ki_chroma_acts_smoothed
457,1,0.0,3.3173333333333335,3.3173333333333335,0,8,8,chromagram
457,2,3.3173333333333335,27.029333333333337,23.712000000000003,8,65,57,chromagram
457,3,27.029333333333337,52.40533333333334,25.376,65,126,61,chromagram
457,4,52.40533333333334,79.86133333333333,27.455999999999996,126,192,66,chromagram
457,5,79.86133333333333,92.34133333333335,12.480000000000018,192,222,30,chromagram
457,6,92.34133333333335,118.13333333333335,25.792,222,284,62,chromagram
457,7,118.13333333333335,145.17333333333335,27.039999999999992,284,349,65,chromagram
457,8,145.17333333333335,165.55733333333333,20.383999999999986,349,398,49,chromagram
457,9,165.55733333333333,200.244,34.68666666666667,398,480,82,chromagram
457,1,0.0,3.3173333333333335,3.3173333333333335,0,8,8,chroma_acts
457,2,3.3173333333333335,6.645333333333333,3.328,8,16,8,chroma_acts
457,3,6.645333333333333,27.029333333333337,20.384000000000004,16,65,49,chroma_acts
457,4,27.029333333333337,52.40533333333334,25.376,65,126,61,chroma_acts
457,5,52.40533333333334,79.86133333333333,27.455999999999996,126,192,66,chroma_acts
457,6,79.86133333333333,92.34133333333335,12.480000000000018,192,222,30,chroma_acts
457,7,92.34133333333335,118.13333333333335,25.792,222,284,62,chroma_acts
457,8,118.13333333333335,145.17333333333335,27.039999999999992,284,349,65,chroma_acts
457,9,145.17333333333335,200.244,55.070666666666654,349,480,131,chroma_acts
457,1,0.0,3.3173333333333335,3.3173333333333335,0,8,8,chroma_acts_smoothed
457,2,3.3173333333333335,23.285333333333334,19.968,8,56,48,chroma_acts_smoothed
457,3,23.285333333333334,27.029333333333337,3.7440000000000033,56,65,9,chroma_acts_smoothed
457,4,27.029333333333337,52.40533333333334,25.376,65,126,61,chroma_acts_smoothed
457,5,52.40533333333334,79.44533333333334,27.04,126,191,65,chroma_acts_smoothed
457,6,79.44533333333334,91.92533333333333,12.47999999999999,191,221,30,chroma_acts_smoothed
457,7,91.92533333333333,118.13333333333335,26.208000000000027,221,284,63,chroma_acts_smoothed
457,8,118.13333333333335,145.17333333333335,27.039999999999992,284,349,65,chroma_acts_smoothed
457,9,145.17333333333335,200.244,55.070666666666654,349,480,131,chroma_acts_smoothed
457,1,0.0,3.3173333333333335,3.3173333333333335,0,8,8,ki_chroma
457,2,3.3173333333333335,27.029333333333337,23.712000000000003,8,65,57,ki_chroma
457,3,27.029333333333337,52.40533333333334,25.376,65,126,61,ki_chroma
457,4,52.40533333333334,79.86133333333333,27.455999999999996,126,192,66,ki_chroma
457,5,79.86133333333333,92.34133333333335,12.480000000000018,192,222,30,ki_chroma
457,6,92.34133333333335,118.13333333333335,25.792,222,284,62,ki_chroma
457,7,118.13333333333335,145.17333333333335,27.039999999999992,284,349,65,ki_chroma
457,8,145.17333333333335,165.55733333333333,20.383999999999986,349,398,49,ki_chroma
457,9,165.55733333333333,200.244,34.68666666666667,398,480,82,ki_chroma
457,1,0.0,3.3173333333333335,3.3173333333333335,0,8,8,ki_chroma_acts
457,2,3.3173333333333335,6.645333333333333,3.328,8,16,8,ki_chroma_acts
457,3,6.645333333333333,27.029333333333337,20.384000000000004,16,65,49,ki_chroma_acts
457,4,27.029333333333337,52.40533333333334,25.376,65,126,61,ki_chroma_acts
457,5,52.40533333333334,79.86133333333333,27.455999999999996,126,192,66,ki_chroma_acts
457,6,79.86133333333333,92.34133333333335,12.480000000000018,192,222,30,ki_chroma_acts
457,7,92.34133333333335,118.13333333333335,25.792,222,284,62,ki_chroma_acts
457,8,118.13333333333335,145.17333333333335,27.039999999999992,284,349,65,ki_chroma_acts
457,9,145.17333333333335,200.244,55.070666666666654,349,480,131,ki_chroma_acts
457,1,0.0,3.3173333333333335,3.3173333333333335,0,8,8,ki_chroma_acts_smoothed
457,2,3.3173333333333335,23.285333333333334,19.968,8,56,48,ki_chroma_acts_smoothed
457,3,23.285333333333334,27.029333333333337,3.7440000000000033,56,65,9,ki_chroma_acts_smoothed
457,4,27.029333333333337,52.40533333333334,25.376,65,126,61,ki_chroma_acts_smoothed
457,5,52.40533333333334,79.44533333333334,27.04,126,191,65,ki_chroma_acts_smoothed
457,6,79.44533333333334,91.92533333333333,12.47999999999999,191,221,30,ki_chroma_acts_smoothed
457,7,91.92533333333333,118.13333333333335,26.208000000000027,221,284,63,ki_chroma_acts_smoothed
457,8,118.13333333333335,145.17333333333335,27.039999999999992,284,349,65,ki_chroma_acts_smoothed
457,9,145.17333333333335,200.244,55.070666666666654,349,480,131,ki_chroma_acts_smoothed
458,1,0.0,22.570666666666664,22.570666666666664,0,33,33,chromagram
458,2,22.570666666666664,45.80266666666667,23.232000000000003,33,66,33,chromagram
458,3,45.80266666666667,64.81066666666666,19.007999999999996,66,93,27,chromagram
458,4,64.81066666666666,67.62666666666667,2.8160000000000025,93,97,4,chromagram
458,5,67.62666666666667,90.85866666666666,23.232,97,130,33,chromagram
458,6,90.85866666666666,92.26666666666665,1.407999999999987,130,132,2,chromagram
458,7,92.26666666666665,101.41866666666665,9.152000000000001,132,145,13,chromagram
458,8,101.41866666666665,113.051,11.63233333333335,145,160,15,chromagram
458,1,0.0,21.866666666666667,21.866666666666667,0,32,32,chroma_acts
458,2,21.866666666666667,62.69866666666667,40.832,32,90,58,chroma_acts
458,3,62.69866666666667,64.10666666666667,1.4080000000000013,90,92,2,chroma_acts
458,4,64.10666666666667,67.62666666666667,3.519999999999996,92,97,5,chroma_acts
458,5,67.62666666666667,86.63466666666666,19.007999999999996,97,124,27,chroma_acts
458,6,86.63466666666666,90.85866666666666,4.224000000000004,124,130,6,chroma_acts
458,7,90.85866666666666,92.26666666666665,1.407999999999987,130,132,2,chroma_acts
458,8,92.26666666666665,101.41866666666665,9.152000000000001,132,145,13,chroma_acts
458,9,101.41866666666665,113.051,11.63233333333335,145,160,15,chroma_acts
458,1,0.0,22.570666666666664,22.570666666666664,0,33,33,chroma_acts_smoothed
458,2,22.570666666666664,45.09866666666666,22.527999999999995,33,65,32,chroma_acts_smoothed
458,3,45.09866666666666,47.91466666666666,2.8160000000000025,65,69,4,chroma_acts_smoothed
458,4,47.91466666666666,61.99466666666666,14.079999999999998,69,89,20,chroma_acts_smoothed
458,5,61.99466666666666,67.62666666666667,5.632000000000005,89,97,8,chroma_acts_smoothed
458,6,67.62666666666667,90.85866666666666,23.232,97,130,33,chroma_acts_smoothed
458,7,90.85866666666666,101.41866666666665,10.559999999999988,130,145,15,chroma_acts_smoothed
458,8,101.41866666666665,113.051,11.63233333333335,145,160,15,chroma_acts_smoothed
458,1,0.0,22.570666666666664,22.570666666666664,0,33,33,ki_chroma
458,2,22.570666666666664,45.80266666666667,23.232000000000003,33,66,33,ki_chroma
458,3,45.80266666666667,64.81066666666666,19.007999999999996,66,93,27,ki_chroma
458,4,64.81066666666666,67.62666666666667,2.8160000000000025,93,97,4,ki_chroma
458,5,67.62666666666667,90.85866666666666,23.232,97,130,33,ki_chroma
458,6,90.85866666666666,92.26666666666665,1.407999999999987,130,132,2,ki_chroma
458,7,92.26666666666665,101.41866666666665,9.152000000000001,132,145,13,ki_chroma
458,8,101.41866666666665,113.051,11.63233333333335,145,160,15,ki_chroma
458,1,0.0,21.866666666666667,21.866666666666667,0,32,32,ki_chroma_acts
458,2,21.866666666666667,62.69866666666667,40.832,32,90,58,ki_chroma_acts
458,3,62.69866666666667,64.10666666666667,1.4080000000000013,90,92,2,ki_chroma_acts
458,4,64.10666666666667,67.62666666666667,3.519999999999996,92,97,5,ki_chroma_acts
458,5,67.62666666666667,86.63466666666666,19.007999999999996,97,124,27,ki_chroma_acts
458,6,86.63466666666666,90.85866666666666,4.224000000000004,124,130,6,ki_chroma_acts
458,7,90.85866666666666,92.26666666666665,1.407999999999987,130,132,2,ki_chroma_acts
458,8,92.26666666666665,101.41866666666665,9.152000000000001,132,145,13,ki_chroma_acts
458,9,101.41866666666665,113.051,11.63233333333335,145,160,15,ki_chroma_acts
458,1,0.0,22.570666666666664,22.570666666666664,0,33,33,ki_chroma_acts_smoothed
458,2,22.570666666666664,45.09866666666666,22.527999999999995,33,65,32,ki_chroma_acts_smoothed
458,3,45.09866666666666,47.91466666666666,2.8160000000000025,65,69,4,ki_chroma_acts_smoothed
458,4,47.91466666666666,61.99466666666666,14.079999999999998,69,89,20,ki_chroma_acts_smoothed
458,5,61.99466666666666,67.62666666666667,5.632000000000005,89,97,8,ki_chroma_acts_smoothed
458,6,67.62666666666667,90.85866666666666,23.232,97,130,33,ki_chroma_acts_smoothed
458,7,90.85866666666666,101.41866666666665,10.559999999999988,130,145,15,ki_chroma_acts_smoothed
458,8,101.41866666666665,113.051,11.63233333333335,145,160,15,ki_chroma_acts_smoothed
459,1,0.0,54.35733333333334,54.35733333333334,0,128,128,chromagram
459,2,54.35733333333334,81.664,27.306666666666665,128,192,64,chromagram
459,3,81.664,110.67733333333334,29.013333333333335,192,260,68,chromagram
459,4,110.67733333333334,123.05066666666667,12.373333333333335,260,289,29,chromagram
459,5,123.05066666666667,137.13066666666668,14.080000000000013,289,322,33,chromagram
459,6,137.13066666666668,160.59733333333332,23.46666666666664,322,377,55,chromagram
459,7,160.59733333333332,164.01066666666668,3.4133333333333553,377,385,8,chromagram
459,8,164.01066666666668,193.45066666666668,29.439999999999998,385,454,69,chromagram
459,9,193.45066666666668,220.167,26.716333333333324,454,515,61,chromagram
459,1,0.0,55.21066666666667,55.21066666666667,0,130,130,chroma_acts
459,2,55.21066666666667,78.25066666666666,23.039999999999992,130,184,54,chroma_acts
459,3,78.25066666666666,81.664,3.413333333333341,184,192,8,chroma_acts
459,4,81.664,110.67733333333334,29.013333333333335,192,260,68,chroma_acts
459,5,110.67733333333334,124.75733333333334,14.079999999999998,260,293,33,chroma_acts
459,6,124.75733333333334,137.13066666666668,12.373333333333349,293,322,29,chroma_acts
459,7,137.13066666666668,149.9306666666667,12.800000000000011,322,352,30,chroma_acts
459,8,149.9306666666667,193.024,43.093333333333305,352,453,101,chroma_acts
459,9,193.024,220.167,27.143,453,515,62,chroma_acts
459,1,0.0,54.784000000000006,54.784000000000006,0,129,129,chroma_acts_smoothed
459,2,54.784000000000006,78.25066666666666,23.466666666666654,129,184,55,chroma_acts_smoothed
459,3,78.25066666666666,81.664,3.413333333333341,184,192,8,chroma_acts_smoothed
459,4,81.664,110.67733333333334,29.013333333333335,192,260,68,chroma_acts_smoothed
459,5,110.67733333333334,124.75733333333334,14.079999999999998,260,293,33,chroma_acts_smoothed
459,6,124.75733333333334,137.13066666666668,12.373333333333349,293,322,29,chroma_acts_smoothed
459,7,137.13066666666668,149.9306666666667,12.800000000000011,322,352,30,chroma_acts_smoothed
459,8,149.9306666666667,193.45066666666668,43.51999999999998,352,454,102,chroma_acts_smoothed
459,9,193.45066666666668,220.167,26.716333333333324,454,515,61,chroma_acts_smoothed
459,1,0.0,54.35733333333334,54.35733333333334,0,128,128,ki_chroma
459,2,54.35733333333334,81.664,27.306666666666665,128,192,64,ki_chroma
459,3,81.664,110.67733333333334,29.013333333333335,192,260,68,ki_chroma
459,4,110.67733333333334,123.05066666666667,12.373333333333335,260,289,29,ki_chroma
459,5,123.05066666666667,137.13066666666668,14.080000000000013,289,322,33,ki_chroma
459,6,137.13066666666668,160.59733333333332,23.46666666666664,322,377,55,ki_chroma
459,7,160.59733333333332,164.01066666666668,3.4133333333333553,377,385,8,ki_chroma
459,8,164.01066666666668,193.45066666666668,29.439999999999998,385,454,69,ki_chroma
459,9,193.45066666666668,220.167,26.716333333333324,454,515,61,ki_chroma
459,1,0.0,55.21066666666667,55.21066666666667,0,130,130,ki_chroma_acts
459,2,55.21066666666667,78.25066666666666,23.039999999999992,130,184,54,ki_chroma_acts
459,3,78.25066666666666,81.664,3.413333333333341,184,192,8,ki_chroma_acts
459,4,81.664,110.67733333333334,29.013333333333335,192,260,68,ki_chroma_acts
459,5,110.67733333333334,124.75733333333334,14.079999999999998,260,293,33,ki_chroma_acts
459,6,124.75733333333334,137.13066666666668,12.373333333333349,293,322,29,ki_chroma_acts
459,7,137.13066666666668,149.9306666666667,12.800000000000011,322,352,30,ki_chroma_acts
459,8,149.9306666666667,193.024,43.093333333333305,352,453,101,ki_chroma_acts
459,9,193.024,220.167,27.143,453,515,62,ki_chroma_acts
459,1,0.0,54.784000000000006,54.784000000000006,0,129,129,ki_chroma_acts_smoothed
459,2,54.784000000000006,78.25066666666666,23.466666666666654,129,184,55,ki_chroma_acts_smoothed
459,3,78.25066666666666,81.664,3.413333333333341,184,192,8,ki_chroma_acts_smoothed
459,4,81.664,110.67733333333334,29.013333333333335,192,260,68,ki_chroma_acts_smoothed
459,5,110.67733333333334,124.75733333333334,14.079999999999998,260,293,33,ki_chroma_acts_smoothed
459,6,124.75733333333334,137.13066666666668,12.373333333333349,293,322,29,ki_chroma_acts_smoothed
459,7,137.13066666666668,149.9306666666667,12.800000000000011,322,352,30,ki_chroma_acts_smoothed
459,8,149.9306666666667,193.45066666666668,43.51999999999998,352,454,102,ki_chroma_acts_smoothed
459,9,193.45066666666668,220.167,26.716333333333324,454,515,61,ki_chroma_acts_smoothed
460,1,0.0,21.25866666666667,21.25866666666667,0,56,56,chromagram
460,2,21.25866666666667,47.75466666666667,26.496000000000002,56,125,69,chromagram
460,3,47.75466666666667,73.09866666666667,25.344,125,191,66,chromagram
460,4,73.09866666666667,95.75466666666667,22.65599999999999,191,250,59,chromagram
460,5,95.75466666666667,122.25066666666666,26.495999999999995,250,319,69,chromagram
460,6,122.25066666666666,144.90666666666667,22.656000000000006,319,378,59,chromagram
460,7,144.90666666666667,150.28266666666667,5.376000000000005,378,392,14,chromagram
460,8,150.28266666666667,175.24266666666668,24.960000000000008,392,457,65,chromagram
460,9,175.24266666666668,198.077,22.83433333333332,457,515,58,chromagram
460,1,0.0,22.410666666666668,22.410666666666668,0,59,59,chroma_acts
460,2,22.410666666666668,47.75466666666667,25.344000000000005,59,125,66,chroma_acts
460,3,47.75466666666667,73.09866666666667,25.344,125,191,66,chroma_acts
460,4,73.09866666666667,95.75466666666667,22.65599999999999,191,250,59,chroma_acts
460,5,95.75466666666667,121.48266666666666,25.727999999999994,250,317,67,chroma_acts
460,6,121.48266666666666,144.90666666666667,23.424000000000007,317,378,61,chroma_acts
460,7,144.90666666666667,149.89866666666666,4.99199999999999,378,391,13,chroma_acts
460,8,149.89866666666666,175.24266666666668,25.344000000000023,391,457,66,chroma_acts
460,9,175.24266666666668,198.077,22.83433333333332,457,515,58,chroma_acts
460,1,0.0,21.25866666666667,21.25866666666667,0,56,56,chroma_acts_smoothed
460,2,21.25866666666667,47.75466666666667,26.496000000000002,56,125,69,chroma_acts_smoothed
460,3,47.75466666666667,73.48266666666666,25.727999999999987,125,192,67,chroma_acts_smoothed
460,4,73.48266666666666,95.75466666666667,22.272000000000006,192,250,58,chroma_acts_smoothed
460,5,95.75466666666667,127.62666666666667,31.872,250,333,83,chroma_acts_smoothed
460,6,127.62666666666667,143.75466666666665,16.127999999999986,333,375,42,chroma_acts_smoothed
460,7,143.75466666666665,149.51466666666667,5.760000000000019,375,390,15,chroma_acts_smoothed
460,8,149.51466666666667,175.24266666666668,25.72800000000001,390,457,67,chroma_acts_smoothed
460,9,175.24266666666668,198.077,22.83433333333332,457,515,58,chroma_acts_smoothed
460,1,0.0,21.25866666666667,21.25866666666667,0,56,56,ki_chroma
460,2,21.25866666666667,47.75466666666667,26.496000000000002,56,125,69,ki_chroma
460,3,47.75466666666667,73.09866666666667,25.344,125,191,66,ki_chroma
460,4,73.09866666666667,95.75466666666667,22.65599999999999,191,250,59,ki_chroma
460,5,95.75466666666667,122.25066666666666,26.495999999999995,250,319,69,ki_chroma
460,6,122.25066666666666,144.90666666666667,22.656000000000006,319,378,59,ki_chroma
460,7,144.90666666666667,150.28266666666667,5.376000000000005,378,392,14,ki_chroma
460,8,150.28266666666667,175.24266666666668,24.960000000000008,392,457,65,ki_chroma
460,9,175.24266666666668,198.077,22.83433333333332,457,515,58,ki_chroma
460,1,0.0,22.410666666666668,22.410666666666668,0,59,59,ki_chroma_acts
460,2,22.410666666666668,47.75466666666667,25.344000000000005,59,125,66,ki_chroma_acts
460,3,47.75466666666667,73.09866666666667,25.344,125,191,66,ki_chroma_acts
460,4,73.09866666666667,95.75466666666667,22.65599999999999,191,250,59,ki_chroma_acts
460,5,95.75466666666667,121.48266666666666,25.727999999999994,250,317,67,ki_chroma_acts
460,6,121.48266666666666,144.90666666666667,23.424000000000007,317,378,61,ki_chroma_acts
460,7,144.90666666666667,149.89866666666666,4.99199999999999,378,391,13,ki_chroma_acts
460,8,149.89866666666666,175.24266666666668,25.344000000000023,391,457,66,ki_chroma_acts
460,9,175.24266666666668,198.077,22.83433333333332,457,515,58,ki_chroma_acts
460,1,0.0,21.25866666666667,21.25866666666667,0,56,56,ki_chroma_acts_smoothed
460,2,21.25866666666667,47.75466666666667,26.496000000000002,56,125,69,ki_chroma_acts_smoothed
460,3,47.75466666666667,73.48266666666666,25.727999999999987,125,192,67,ki_chroma_acts_smoothed
460,4,73.48266666666666,95.75466666666667,22.272000000000006,192,250,58,ki_chroma_acts_smoothed
460,5,95.75466666666667,127.62666666666667,31.872,250,333,83,ki_chroma_acts_smoothed
460,6,127.62666666666667,143.75466666666665,16.127999999999986,333,375,42,ki_chroma_acts_smoothed
460,7,143.75466666666665,149.51466666666667,5.760000000000019,375,390,15,ki_chroma_acts_smoothed
460,8,149.51466666666667,175.24266666666668,25.72800000000001,390,457,67,ki_chroma_acts_smoothed
460,9,175.24266666666668,198.077,22.83433333333332,457,515,58,ki_chroma_acts_smoothed
461,1,0.0,17.994666666666667,17.994666666666667,0,33,33,chromagram
461,2,17.994666666666667,31.306666666666665,13.311999999999998,33,57,24,chromagram
461,3,31.306666666666665,54.602666666666664,23.296,57,99,42,chromagram
461,4,54.602666666666664,78.45333333333333,23.85066666666667,99,142,43,chromagram
461,5,78.45333333333333,80.672,2.218666666666664,142,146,4,chromagram
461,6,80.672,90.10133333333334,9.429333333333346,146,163,17,chromagram
461,7,90.10133333333334,116.72533333333334,26.623999999999995,163,211,48,chromagram
461,8,116.72533333333334,126.70933333333332,9.98399999999998,211,229,18,chromagram
461,9,126.70933333333332,199.805,73.09566666666669,229,359,130,chromagram
461,1,0.0,22.432000000000002,22.432000000000002,0,41,41,chroma_acts
461,2,22.432000000000002,26.314666666666668,3.8826666666666654,41,48,7,chroma_acts
461,3,26.314666666666668,31.306666666666665,4.991999999999997,48,57,9,chroma_acts
461,4,31.306666666666665,44.61866666666667,13.312000000000005,57,81,24,chroma_acts
461,5,44.61866666666667,54.602666666666664,9.983999999999995,81,99,18,chroma_acts
461,6,54.602666666666664,90.10133333333334,35.49866666666668,99,163,64,chroma_acts
461,7,90.10133333333334,116.72533333333334,26.623999999999995,163,211,48,chroma_acts
461,8,116.72533333333334,126.70933333333332,9.98399999999998,211,229,18,chroma_acts
461,9,126.70933333333332,199.805,73.09566666666669,229,359,130,chroma_acts
461,1,0.0,17.44,17.44,0,32,32,chroma_acts_smoothed
461,2,17.44,26.314666666666668,8.874666666666666,32,48,16,chroma_acts_smoothed
461,3,26.314666666666668,29.642666666666667,3.3279999999999994,48,54,6,chroma_acts_smoothed
461,4,29.642666666666667,45.17333333333333,15.530666666666665,54,82,28,chroma_acts_smoothed
461,5,45.17333333333333,55.157333333333334,9.984000000000002,82,100,18,chroma_acts_smoothed
461,6,55.157333333333334,90.656,35.49866666666667,100,164,64,chroma_acts_smoothed
461,7,90.656,116.72533333333334,26.069333333333333,164,211,47,chroma_acts_smoothed
461,8,116.72533333333334,126.70933333333332,9.98399999999998,211,229,18,chroma_acts_smoothed
461,9,126.70933333333332,199.805,73.09566666666669,229,359,130,chroma_acts_smoothed
461,1,0.0,17.994666666666667,17.994666666666667,0,33,33,ki_chroma
461,2,17.994666666666667,31.306666666666665,13.311999999999998,33,57,24,ki_chroma
461,3,31.306666666666665,54.602666666666664,23.296,57,99,42,ki_chroma
461,4,54.602666666666664,78.45333333333333,23.85066666666667,99,142,43,ki_chroma
461,5,78.45333333333333,80.672,2.218666666666664,142,146,4,ki_chroma
461,6,80.672,90.10133333333334,9.429333333333346,146,163,17,ki_chroma
461,7,90.10133333333334,116.72533333333334,26.623999999999995,163,211,48,ki_chroma
461,8,116.72533333333334,126.70933333333332,9.98399999999998,211,229,18,ki_chroma
461,9,126.70933333333332,199.805,73.09566666666669,229,359,130,ki_chroma
461,1,0.0,22.432000000000002,22.432000000000002,0,41,41,ki_chroma_acts
461,2,22.432000000000002,26.314666666666668,3.8826666666666654,41,48,7,ki_chroma_acts
461,3,26.314666666666668,31.306666666666665,4.991999999999997,48,57,9,ki_chroma_acts
461,4,31.306666666666665,44.61866666666667,13.312000000000005,57,81,24,ki_chroma_acts
461,5,44.61866666666667,54.602666666666664,9.983999999999995,81,99,18,ki_chroma_acts
461,6,54.602666666666664,90.10133333333334,35.49866666666668,99,163,64,ki_chroma_acts
461,7,90.10133333333334,116.72533333333334,26.623999999999995,163,211,48,ki_chroma_acts
461,8,116.72533333333334,126.70933333333332,9.98399999999998,211,229,18,ki_chroma_acts
461,9,126.70933333333332,199.805,73.09566666666669,229,359,130,ki_chroma_acts
461,1,0.0,17.44,17.44,0,32,32,ki_chroma_acts_smoothed
461,2,17.44,26.314666666666668,8.874666666666666,32,48,16,ki_chroma_acts_smoothed
461,3,26.314666666666668,29.642666666666667,3.3279999999999994,48,54,6,ki_chroma_acts_smoothed
461,4,29.642666666666667,45.17333333333333,15.530666666666665,54,82,28,ki_chroma_acts_smoothed
461,5,45.17333333333333,55.157333333333334,9.984000000000002,82,100,18,ki_chroma_acts_smoothed
461,6,55.157333333333334,90.656,35.49866666666667,100,164,64,ki_chroma_acts_smoothed
461,7,90.656,116.72533333333334,26.069333333333333,164,211,47,ki_chroma_acts_smoothed
461,8,116.72533333333334,126.70933333333332,9.98399999999998,211,229,18,ki_chroma_acts_smoothed
461,9,126.70933333333332,199.805,73.09566666666669,229,359,130,ki_chroma_acts_smoothed
462,1,0.0,74.39999999999999,74.39999999999999,0,163,163,chromagram
462,2,74.39999999999999,80.82133333333333,6.421333333333337,163,177,14,chromagram
462,3,80.82133333333333,89.07733333333333,8.256,177,195,18,chromagram
462,4,89.07733333333333,119.34933333333332,30.27199999999999,195,261,66,chromagram
462,5,119.34933333333332,145.4933333333333,26.14399999999999,261,318,57,chromagram
462,6,145.4933333333333,169.80266666666665,24.309333333333342,318,371,53,chromagram
462,7,169.80266666666665,177.1413333333333,7.338666666666654,371,387,16,chromagram
462,8,177.1413333333333,206.95466666666664,29.813333333333333,387,452,65,chromagram
462,9,206.95466666666664,220.699,13.744333333333373,452,480,28,chromagram
462,1,0.0,36.330666666666666,36.330666666666666,0,80,80,chroma_acts
462,2,36.330666666666666,43.66933333333333,7.338666666666661,80,96,16,chroma_acts
462,3,43.66933333333333,89.07733333333333,45.408,96,195,99,chroma_acts
462,4,89.07733333333333,119.34933333333332,30.27199999999999,195,261,66,chroma_acts
462,5,119.34933333333332,145.4933333333333,26.14399999999999,261,318,57,chroma_acts
462,6,145.4933333333333,169.80266666666665,24.309333333333342,318,371,53,chroma_acts
462,7,169.80266666666665,177.1413333333333,7.338666666666654,371,387,16,chroma_acts
462,8,177.1413333333333,206.95466666666664,29.813333333333333,387,452,65,chroma_acts
462,9,206.95466666666664,220.699,13.744333333333373,452,480,28,chroma_acts
462,1,0.0,36.330666666666666,36.330666666666666,0,80,80,chroma_acts_smoothed
462,2,36.330666666666666,43.66933333333333,7.338666666666661,80,96,16,chroma_acts_smoothed
462,3,43.66933333333333,89.07733333333333,45.408,96,195,99,chroma_acts_smoothed
462,4,89.07733333333333,117.51466666666666,28.437333333333328,195,257,62,chroma_acts_smoothed
462,5,117.51466666666666,145.4933333333333,27.978666666666655,257,318,61,chroma_acts_smoothed
462,6,145.4933333333333,169.34399999999997,23.850666666666655,318,370,52,chroma_acts_smoothed
462,7,169.34399999999997,177.1413333333333,7.797333333333341,370,387,17,chroma_acts_smoothed
462,8,177.1413333333333,207.4133333333333,30.27199999999999,387,453,66,chroma_acts_smoothed
462,9,207.4133333333333,220.699,13.285666666666714,453,480,27,chroma_acts_smoothed
462,1,0.0,74.39999999999999,74.39999999999999,0,163,163,ki_chroma
462,2,74.39999999999999,80.82133333333333,6.421333333333337,163,177,14,ki_chroma
462,3,80.82133333333333,89.07733333333333,8.256,177,195,18,ki_chroma
462,4,89.07733333333333,119.34933333333332,30.27199999999999,195,261,66,ki_chroma
462,5,119.34933333333332,145.4933333333333,26.14399999999999,261,318,57,ki_chroma
462,6,145.4933333333333,169.80266666666665,24.309333333333342,318,371,53,ki_chroma
462,7,169.80266666666665,177.1413333333333,7.338666666666654,371,387,16,ki_chroma
462,8,177.1413333333333,206.95466666666664,29.813333333333333,387,452,65,ki_chroma
462,9,206.95466666666664,220.699,13.744333333333373,452,480,28,ki_chroma
462,1,0.0,36.330666666666666,36.330666666666666,0,80,80,ki_chroma_acts
462,2,36.330666666666666,43.66933333333333,7.338666666666661,80,96,16,ki_chroma_acts
462,3,43.66933333333333,89.07733333333333,45.408,96,195,99,ki_chroma_acts
462,4,89.07733333333333,119.34933333333332,30.27199999999999,195,261,66,ki_chroma_acts
462,5,119.34933333333332,145.4933333333333,26.14399999999999,261,318,57,ki_chroma_acts
462,6,145.4933333333333,169.80266666666665,24.309333333333342,318,371,53,ki_chroma_acts
462,7,169.80266666666665,177.1413333333333,7.338666666666654,371,387,16,ki_chroma_acts
462,8,177.1413333333333,206.95466666666664,29.813333333333333,387,452,65,ki_chroma_acts
462,9,206.95466666666664,220.699,13.744333333333373,452,480,28,ki_chroma_acts
462,1,0.0,36.330666666666666,36.330666666666666,0,80,80,ki_chroma_acts_smoothed
462,2,36.330666666666666,43.66933333333333,7.338666666666661,80,96,16,ki_chroma_acts_smoothed
462,3,43.66933333333333,89.07733333333333,45.408,96,195,99,ki_chroma_acts_smoothed
462,4,89.07733333333333,117.51466666666666,28.437333333333328,195,257,62,ki_chroma_acts_smoothed
462,5,117.51466666666666,145.4933333333333,27.978666666666655,257,318,61,ki_chroma_acts_smoothed
462,6,145.4933333333333,169.34399999999997,23.850666666666655,318,370,52,ki_chroma_acts_smoothed
462,7,169.34399999999997,177.1413333333333,7.797333333333341,370,387,17,ki_chroma_acts_smoothed
462,8,177.1413333333333,207.4133333333333,30.27199999999999,387,453,66,ki_chroma_acts_smoothed
462,9,207.4133333333333,220.699,13.285666666666714,453,480,27,ki_chroma_acts_smoothed
463,1,0.0,21.610666666666667,21.610666666666667,0,32,32,chromagram
463,2,21.610666666666667,39.63733333333334,18.02666666666667,32,58,26,chromagram
463,3,39.63733333333334,67.37066666666666,27.733333333333327,58,98,40,chromagram
463,4,67.37066666666666,106.89066666666668,39.52000000000001,98,155,57,chromagram
463,5,106.89066666666668,110.35733333333334,3.4666666666666686,155,160,5,chromagram
463,6,110.35733333333334,132.544,22.186666666666667,160,192,32,chromagram
463,7,132.544,157.50400000000002,24.960000000000008,192,228,36,chromagram
463,8,157.50400000000002,174.588,17.083999999999975,228,251,23,chromagram
463,1,0.0,39.63733333333334,39.63733333333334,0,58,58,chroma_acts
463,2,39.63733333333334,45.87733333333334,6.240000000000002,58,67,9,chroma_acts
463,3,45.87733333333334,70.144,24.266666666666666,67,102,35,chroma_acts
463,4,70.144,99.95733333333334,29.813333333333333,102,145,43,chroma_acts
463,5,99.95733333333334,110.35733333333334,10.400000000000006,145,160,15,chroma_acts
463,6,110.35733333333334,132.544,22.186666666666667,160,192,32,chroma_acts
463,7,132.544,157.50400000000002,24.960000000000008,192,228,36,chroma_acts
463,8,157.50400000000002,174.588,17.083999999999975,228,251,23,chroma_acts
463,1,0.0,39.63733333333334,39.63733333333334,0,58,58,chroma_acts_smoothed
463,2,39.63733333333334,67.37066666666666,27.733333333333327,58,98,40,chroma_acts_smoothed
463,3,67.37066666666666,99.95733333333334,32.58666666666667,98,145,47,chroma_acts_smoothed
463,4,99.95733333333334,106.89066666666668,6.933333333333337,145,155,10,chroma_acts_smoothed
463,5,106.89066666666668,111.05066666666667,4.159999999999997,155,161,6,chroma_acts_smoothed
463,6,111.05066666666667,132.544,21.49333333333334,161,192,31,chroma_acts_smoothed
463,7,132.544,158.89066666666668,26.346666666666664,192,230,38,chroma_acts_smoothed
463,8,158.89066666666668,174.588,15.697333333333319,230,251,21,chroma_acts_smoothed
463,1,0.0,21.610666666666667,21.610666666666667,0,32,32,ki_chroma
463,2,21.610666666666667,39.63733333333334,18.02666666666667,32,58,26,ki_chroma
463,3,39.63733333333334,67.37066666666666,27.733333333333327,58,98,40,ki_chroma
463,4,67.37066666666666,106.89066666666668,39.52000000000001,98,155,57,ki_chroma
463,5,106.89066666666668,110.35733333333334,3.4666666666666686,155,160,5,ki_chroma
463,6,110.35733333333334,132.544,22.186666666666667,160,192,32,ki_chroma
463,7,132.544,157.50400000000002,24.960000000000008,192,228,36,ki_chroma
463,8,157.50400000000002,174.588,17.083999999999975,228,251,23,ki_chroma
463,1,0.0,39.63733333333334,39.63733333333334,0,58,58,ki_chroma_acts
463,2,39.63733333333334,45.87733333333334,6.240000000000002,58,67,9,ki_chroma_acts
463,3,45.87733333333334,70.144,24.266666666666666,67,102,35,ki_chroma_acts
463,4,70.144,99.95733333333334,29.813333333333333,102,145,43,ki_chroma_acts
463,5,99.95733333333334,110.35733333333334,10.400000000000006,145,160,15,ki_chroma_acts
463,6,110.35733333333334,132.544,22.186666666666667,160,192,32,ki_chroma_acts
463,7,132.544,157.50400000000002,24.960000000000008,192,228,36,ki_chroma_acts
463,8,157.50400000000002,174.588,17.083999999999975,228,251,23,ki_chroma_acts
463,1,0.0,39.63733333333334,39.63733333333334,0,58,58,ki_chroma_acts_smoothed
463,2,39.63733333333334,67.37066666666666,27.733333333333327,58,98,40,ki_chroma_acts_smoothed
463,3,67.37066666666666,99.95733333333334,32.58666666666667,98,145,47,ki_chroma_acts_smoothed
463,4,99.95733333333334,106.89066666666668,6.933333333333337,145,155,10,ki_chroma_acts_smoothed
463,5,106.89066666666668,111.05066666666667,4.159999999999997,155,161,6,ki_chroma_acts_smoothed
463,6,111.05066666666667,132.544,21.49333333333334,161,192,31,ki_chroma_acts_smoothed
463,7,132.544,158.89066666666668,26.346666666666664,192,230,38,ki_chroma_acts_smoothed
463,8,158.89066666666668,174.588,15.697333333333319,230,251,21,ki_chroma_acts_smoothed
464,1,0.0,15.456,15.456,0,33,33,chromagram
464,2,15.456,28.597333333333335,13.141333333333336,33,61,28,chromagram
464,3,28.597333333333335,45.49333333333333,16.895999999999997,61,97,36,chromagram
464,4,45.49333333333333,74.12266666666666,28.629333333333328,97,158,61,chromagram
464,5,74.12266666666666,122.464,48.34133333333334,158,261,103,chromagram
464,6,122.464,136.54399999999998,14.079999999999984,261,291,30,chromagram
464,7,136.54399999999998,181.6,45.05600000000001,291,387,96,chromagram
464,8,181.6,200.55,18.950000000000017,387,426,39,chromagram
464,1,0.0,28.597333333333335,28.597333333333335,0,61,61,chroma_acts
464,2,28.597333333333335,38.922666666666665,10.32533333333333,61,83,22,chroma_acts
464,3,38.922666666666665,74.12266666666666,35.199999999999996,83,158,75,chroma_acts
464,4,74.12266666666666,121.99466666666666,47.872,158,260,102,chroma_acts
464,5,121.99466666666666,136.07466666666667,14.080000000000013,260,290,30,chroma_acts
464,6,136.07466666666667,168.928,32.853333333333325,290,360,70,chroma_acts
464,7,168.928,181.6,12.671999999999997,360,387,27,chroma_acts
464,8,181.6,200.55,18.950000000000017,387,426,39,chroma_acts
464,1,0.0,28.597333333333335,28.597333333333335,0,61,61,chroma_acts_smoothed
464,2,28.597333333333335,38.922666666666665,10.32533333333333,61,83,22,chroma_acts_smoothed
464,3,38.922666666666665,104.16,65.23733333333334,83,222,139,chroma_acts_smoothed
464,4,104.16,122.464,18.304000000000002,222,261,39,chroma_acts_smoothed
464,5,122.464,137.01333333333332,14.549333333333323,261,292,31,chroma_acts_smoothed
464,6,137.01333333333332,168.928,31.914666666666676,292,360,68,chroma_acts_smoothed
464,7,168.928,181.6,12.671999999999997,360,387,27,chroma_acts_smoothed
464,8,181.6,200.55,18.950000000000017,387,426,39,chroma_acts_smoothed
464,1,0.0,15.456,15.456,0,33,33,ki_chroma
464,2,15.456,28.597333333333335,13.141333333333336,33,61,28,ki_chroma
464,3,28.597333333333335,45.49333333333333,16.895999999999997,61,97,36,ki_chroma
464,4,45.49333333333333,74.12266666666666,28.629333333333328,97,158,61,ki_chroma
464,5,74.12266666666666,122.464,48.34133333333334,158,261,103,ki_chroma
464,6,122.464,136.54399999999998,14.079999999999984,261,291,30,ki_chroma
464,7,136.54399999999998,181.6,45.05600000000001,291,387,96,ki_chroma
464,8,181.6,200.55,18.950000000000017,387,426,39,ki_chroma
464,1,0.0,28.597333333333335,28.597333333333335,0,61,61,ki_chroma_acts
464,2,28.597333333333335,38.922666666666665,10.32533333333333,61,83,22,ki_chroma_acts
464,3,38.922666666666665,74.12266666666666,35.199999999999996,83,158,75,ki_chroma_acts
464,4,74.12266666666666,121.99466666666666,47.872,158,260,102,ki_chroma_acts
464,5,121.99466666666666,136.07466666666667,14.080000000000013,260,290,30,ki_chroma_acts
464,6,136.07466666666667,168.928,32.853333333333325,290,360,70,ki_chroma_acts
464,7,168.928,181.6,12.671999999999997,360,387,27,ki_chroma_acts
464,8,181.6,200.55,18.950000000000017,387,426,39,ki_chroma_acts
464,1,0.0,28.597333333333335,28.597333333333335,0,61,61,ki_chroma_acts_smoothed
464,2,28.597333333333335,38.922666666666665,10.32533333333333,61,83,22,ki_chroma_acts_smoothed
464,3,38.922666666666665,104.16,65.23733333333334,83,222,139,ki_chroma_acts_smoothed
464,4,104.16,122.464,18.304000000000002,222,261,39,ki_chroma_acts_smoothed
464,5,122.464,137.01333333333332,14.549333333333323,261,292,31,ki_chroma_acts_smoothed
464,6,137.01333333333332,168.928,31.914666666666676,292,360,68,ki_chroma_acts_smoothed
464,7,168.928,181.6,12.671999999999997,360,387,27,ki_chroma_acts_smoothed
464,8,181.6,200.55,18.950000000000017,387,426,39,ki_chroma_acts_smoothed
465,1,0.0,45.70666666666667,45.70666666666667,0,96,96,chromagram
465,2,45.70666666666667,106.66666666666667,60.96,96,223,127,chromagram
465,3,106.66666666666667,136.90666666666664,30.239999999999966,223,286,63,chromagram
465,4,136.90666666666664,165.70666666666665,28.80000000000001,286,346,60,chromagram
465,5,165.70666666666665,182.98666666666665,17.28,346,382,36,chromagram
465,6,182.98666666666665,188.74666666666664,5.759999999999991,382,394,12,chromagram
465,7,188.74666666666664,191.14666666666665,2.4000000000000057,394,399,5,chromagram
465,8,191.14666666666665,196.42666666666665,5.280000000000001,399,410,11,chromagram
465,9,196.42666666666665,213.393,16.966333333333353,410,444,34,chromagram
465,1,0.0,45.70666666666667,45.70666666666667,0,96,96,chroma_acts
465,2,45.70666666666667,106.66666666666667,60.96,96,223,127,chroma_acts
465,3,106.66666666666667,136.90666666666664,30.239999999999966,223,286,63,chroma_acts
465,4,136.90666666666664,167.62666666666664,30.72,286,350,64,chroma_acts
465,5,167.62666666666664,182.98666666666665,15.360000000000014,350,382,32,chroma_acts
465,6,182.98666666666665,188.74666666666664,5.759999999999991,382,394,12,chroma_acts
465,7,188.74666666666664,191.14666666666665,2.4000000000000057,394,399,5,chroma_acts
465,8,191.14666666666665,196.42666666666665,5.280000000000001,399,410,11,chroma_acts
465,9,196.42666666666665,213.393,16.966333333333353,410,444,34,chroma_acts
465,1,0.0,45.70666666666667,45.70666666666667,0,96,96,chroma_acts_smoothed
465,2,45.70666666666667,106.18666666666667,60.48,96,222,126,chroma_acts_smoothed
465,3,106.18666666666667,136.90666666666664,30.71999999999997,222,286,64,chroma_acts_smoothed
465,4,136.90666666666664,167.14666666666665,30.24000000000001,286,349,63,chroma_acts_smoothed
465,5,167.14666666666665,182.98666666666665,15.840000000000003,349,382,33,chroma_acts_smoothed
465,6,182.98666666666665,188.74666666666664,5.759999999999991,382,394,12,chroma_acts_smoothed
465,7,188.74666666666664,190.66666666666666,1.920000000000016,394,398,4,chroma_acts_smoothed
465,8,190.66666666666666,196.42666666666665,5.759999999999991,398,410,12,chroma_acts_smoothed
465,9,196.42666666666665,213.393,16.966333333333353,410,444,34,chroma_acts_smoothed
465,1,0.0,45.70666666666667,45.70666666666667,0,96,96,ki_chroma
465,2,45.70666666666667,106.66666666666667,60.96,96,223,127,ki_chroma
465,3,106.66666666666667,136.90666666666664,30.239999999999966,223,286,63,ki_chroma
465,4,136.90666666666664,165.70666666666665,28.80000000000001,286,346,60,ki_chroma
465,5,165.70666666666665,182.98666666666665,17.28,346,382,36,ki_chroma
465,6,182.98666666666665,188.74666666666664,5.759999999999991,382,394,12,ki_chroma
465,7,188.74666666666664,191.14666666666665,2.4000000000000057,394,399,5,ki_chroma
465,8,191.14666666666665,196.42666666666665,5.280000000000001,399,410,11,ki_chroma
465,9,196.42666666666665,213.393,16.966333333333353,410,444,34,ki_chroma
465,1,0.0,45.70666666666667,45.70666666666667,0,96,96,ki_chroma_acts
465,2,45.70666666666667,106.66666666666667,60.96,96,223,127,ki_chroma_acts
465,3,106.66666666666667,136.90666666666664,30.239999999999966,223,286,63,ki_chroma_acts
465,4,136.90666666666664,167.62666666666664,30.72,286,350,64,ki_chroma_acts
465,5,167.62666666666664,182.98666666666665,15.360000000000014,350,382,32,ki_chroma_acts
465,6,182.98666666666665,188.74666666666664,5.759999999999991,382,394,12,ki_chroma_acts
465,7,188.74666666666664,191.14666666666665,2.4000000000000057,394,399,5,ki_chroma_acts
465,8,191.14666666666665,196.42666666666665,5.280000000000001,399,410,11,ki_chroma_acts
465,9,196.42666666666665,213.393,16.966333333333353,410,444,34,ki_chroma_acts
465,1,0.0,45.70666666666667,45.70666666666667,0,96,96,ki_chroma_acts_smoothed
465,2,45.70666666666667,106.18666666666667,60.48,96,222,126,ki_chroma_acts_smoothed
465,3,106.18666666666667,136.90666666666664,30.71999999999997,222,286,64,ki_chroma_acts_smoothed
465,4,136.90666666666664,167.14666666666665,30.24000000000001,286,349,63,ki_chroma_acts_smoothed
465,5,167.14666666666665,182.98666666666665,15.840000000000003,349,382,33,ki_chroma_acts_smoothed
465,6,182.98666666666665,188.74666666666664,5.759999999999991,382,394,12,ki_chroma_acts_smoothed
465,7,188.74666666666664,190.66666666666666,1.920000000000016,394,398,4,ki_chroma_acts_smoothed
465,8,190.66666666666666,196.42666666666665,5.759999999999991,398,410,12,ki_chroma_acts_smoothed
465,9,196.42666666666665,213.393,16.966333333333353,410,444,34,ki_chroma_acts_smoothed
466,1,0.0,15.189333333333334,15.189333333333334,0,32,32,chromagram
466,2,15.189333333333334,64.62933333333334,49.44,32,135,103,chromagram
466,3,64.62933333333334,67.50933333333333,2.8799999999999955,135,141,6,chromagram
466,4,67.50933333333333,72.30933333333333,4.799999999999997,141,151,10,chromagram
466,5,72.30933333333333,75.18933333333334,2.8800000000000097,151,157,6,chromagram
466,6,75.18933333333334,79.98933333333333,4.799999999999997,157,167,10,chromagram
466,7,79.98933333333333,87.18933333333334,7.200000000000003,167,182,15,chromagram
466,8,87.18933333333334,91.02933333333333,3.839999999999989,182,190,8,chromagram
466,9,91.02933333333333,152.376,61.34666666666668,190,316,126,chromagram
466,1,0.0,15.189333333333334,15.189333333333334,0,32,32,chroma_acts
466,2,15.189333333333334,64.62933333333334,49.44,32,135,103,chroma_acts
466,3,64.62933333333334,91.02933333333333,26.39999999999999,135,190,55,chroma_acts
466,4,91.02933333333333,94.86933333333333,3.8400000000000034,190,198,8,chroma_acts
466,5,94.86933333333333,136.62933333333334,41.760000000000005,198,285,87,chroma_acts
466,6,136.62933333333334,140.46933333333334,3.8400000000000034,285,293,8,chroma_acts
466,7,140.46933333333334,144.78933333333333,4.319999999999993,293,302,9,chroma_acts
466,8,144.78933333333333,152.376,7.586666666666673,302,316,14,chroma_acts
466,1,0.0,15.189333333333334,15.189333333333334,0,32,32,chroma_acts_smoothed
466,2,15.189333333333334,64.62933333333334,49.44,32,135,103,chroma_acts_smoothed
466,3,64.62933333333334,67.50933333333333,2.8799999999999955,135,141,6,chroma_acts_smoothed
466,4,67.50933333333333,72.30933333333333,4.799999999999997,141,151,10,chroma_acts_smoothed
466,5,72.30933333333333,75.18933333333334,2.8800000000000097,151,157,6,chroma_acts_smoothed
466,6,75.18933333333334,87.18933333333334,12.0,157,182,25,chroma_acts_smoothed
466,7,87.18933333333334,91.50933333333333,4.319999999999993,182,191,9,chroma_acts_smoothed
466,8,91.50933333333333,94.86933333333333,3.3599999999999994,191,198,7,chroma_acts_smoothed
466,9,94.86933333333333,152.376,57.506666666666675,198,316,118,chroma_acts_smoothed
466,1,0.0,15.189333333333334,15.189333333333334,0,32,32,ki_chroma
466,2,15.189333333333334,64.62933333333334,49.44,32,135,103,ki_chroma
466,3,64.62933333333334,67.50933333333333,2.8799999999999955,135,141,6,ki_chroma
466,4,67.50933333333333,72.30933333333333,4.799999999999997,141,151,10,ki_chroma
466,5,72.30933333333333,75.18933333333334,2.8800000000000097,151,157,6,ki_chroma
466,6,75.18933333333334,79.98933333333333,4.799999999999997,157,167,10,ki_chroma
466,7,79.98933333333333,87.18933333333334,7.200000000000003,167,182,15,ki_chroma
466,8,87.18933333333334,91.02933333333333,3.839999999999989,182,190,8,ki_chroma
466,9,91.02933333333333,152.376,61.34666666666668,190,316,126,ki_chroma
466,1,0.0,15.189333333333334,15.189333333333334,0,32,32,ki_chroma_acts
466,2,15.189333333333334,64.62933333333334,49.44,32,135,103,ki_chroma_acts
466,3,64.62933333333334,91.02933333333333,26.39999999999999,135,190,55,ki_chroma_acts
466,4,91.02933333333333,94.86933333333333,3.8400000000000034,190,198,8,ki_chroma_acts
466,5,94.86933333333333,136.62933333333334,41.760000000000005,198,285,87,ki_chroma_acts
466,6,136.62933333333334,140.46933333333334,3.8400000000000034,285,293,8,ki_chroma_acts
466,7,140.46933333333334,144.78933333333333,4.319999999999993,293,302,9,ki_chroma_acts
466,8,144.78933333333333,152.376,7.586666666666673,302,316,14,ki_chroma_acts
466,1,0.0,15.189333333333334,15.189333333333334,0,32,32,ki_chroma_acts_smoothed
466,2,15.189333333333334,64.62933333333334,49.44,32,135,103,ki_chroma_acts_smoothed
466,3,64.62933333333334,67.50933333333333,2.8799999999999955,135,141,6,ki_chroma_acts_smoothed
466,4,67.50933333333333,72.30933333333333,4.799999999999997,141,151,10,ki_chroma_acts_smoothed
466,5,72.30933333333333,75.18933333333334,2.8800000000000097,151,157,6,ki_chroma_acts_smoothed
466,6,75.18933333333334,87.18933333333334,12.0,157,182,25,ki_chroma_acts_smoothed
466,7,87.18933333333334,91.50933333333333,4.319999999999993,182,191,9,ki_chroma_acts_smoothed
466,8,91.50933333333333,94.86933333333333,3.3599999999999994,191,198,7,ki_chroma_acts_smoothed
466,9,94.86933333333333,152.376,57.506666666666675,198,316,118,ki_chroma_acts_smoothed
467,1,0.0,14.186666666666667,14.186666666666667,0,31,31,chromagram
467,2,14.186666666666667,30.144,15.957333333333331,31,65,34,chromagram
467,3,30.144,59.711999999999996,29.567999999999998,65,128,63,chromagram
467,4,59.711999999999996,118.37866666666666,58.666666666666664,128,253,125,chromagram
467,5,118.37866666666666,119.78666666666666,1.4080000000000013,253,256,3,chromagram
467,6,119.78666666666666,134.33599999999998,14.549333333333323,256,287,31,chromagram
467,7,134.33599999999998,149.82399999999998,15.488,287,320,33,chromagram
467,8,149.82399999999998,210.83733333333333,61.01333333333335,320,450,130,chromagram
467,9,210.83733333333333,240.305,29.467666666666673,450,511,61,chromagram
467,1,0.0,15.125333333333334,15.125333333333334,0,33,33,chroma_acts
467,2,15.125333333333334,30.144,15.018666666666665,33,65,32,chroma_acts
467,3,30.144,59.711999999999996,29.567999999999998,65,128,63,chroma_acts
467,4,59.711999999999996,118.848,59.136,128,254,126,chroma_acts
467,5,118.848,119.78666666666666,0.9386666666666628,254,256,2,chroma_acts
467,6,119.78666666666666,134.33599999999998,14.549333333333323,256,287,31,chroma_acts
467,7,134.33599999999998,149.82399999999998,15.488,287,320,33,chroma_acts
467,8,149.82399999999998,209.89866666666666,60.07466666666667,320,448,128,chroma_acts
467,9,209.89866666666666,240.305,30.40633333333335,448,511,63,chroma_acts
467,1,0.0,15.125333333333334,15.125333333333334,0,33,33,chroma_acts_smoothed
467,2,15.125333333333334,30.144,15.018666666666665,33,65,32,chroma_acts_smoothed
467,3,30.144,59.711999999999996,29.567999999999998,65,128,63,chroma_acts_smoothed
467,4,59.711999999999996,118.37866666666666,58.666666666666664,128,253,125,chroma_acts_smoothed
467,5,118.37866666666666,120.256,1.8773333333333397,253,257,4,chroma_acts_smoothed
467,6,120.256,134.80533333333332,14.549333333333323,257,288,31,chroma_acts_smoothed
467,7,134.80533333333332,149.82399999999998,15.018666666666661,288,320,32,chroma_acts_smoothed
467,8,149.82399999999998,210.83733333333333,61.01333333333335,320,450,130,chroma_acts_smoothed
467,9,210.83733333333333,240.305,29.467666666666673,450,511,61,chroma_acts_smoothed
467,1,0.0,14.186666666666667,14.186666666666667,0,31,31,ki_chroma
467,2,14.186666666666667,30.144,15.957333333333331,31,65,34,ki_chroma
467,3,30.144,59.711999999999996,29.567999999999998,65,128,63,ki_chroma
467,4,59.711999999999996,118.37866666666666,58.666666666666664,128,253,125,ki_chroma
467,5,118.37866666666666,119.78666666666666,1.4080000000000013,253,256,3,ki_chroma
467,6,119.78666666666666,134.33599999999998,14.549333333333323,256,287,31,ki_chroma
467,7,134.33599999999998,149.82399999999998,15.488,287,320,33,ki_chroma
467,8,149.82399999999998,210.83733333333333,61.01333333333335,320,450,130,ki_chroma
467,9,210.83733333333333,240.305,29.467666666666673,450,511,61,ki_chroma
467,1,0.0,15.125333333333334,15.125333333333334,0,33,33,ki_chroma_acts
467,2,15.125333333333334,30.144,15.018666666666665,33,65,32,ki_chroma_acts
467,3,30.144,59.711999999999996,29.567999999999998,65,128,63,ki_chroma_acts
467,4,59.711999999999996,118.848,59.136,128,254,126,ki_chroma_acts
467,5,118.848,119.78666666666666,0.9386666666666628,254,256,2,ki_chroma_acts
467,6,119.78666666666666,134.33599999999998,14.549333333333323,256,287,31,ki_chroma_acts
467,7,134.33599999999998,149.82399999999998,15.488,287,320,33,ki_chroma_acts
467,8,149.82399999999998,209.89866666666666,60.07466666666667,320,448,128,ki_chroma_acts
467,9,209.89866666666666,240.305,30.40633333333335,448,511,63,ki_chroma_acts
467,1,0.0,15.125333333333334,15.125333333333334,0,33,33,ki_chroma_acts_smoothed
467,2,15.125333333333334,30.144,15.018666666666665,33,65,32,ki_chroma_acts_smoothed
467,3,30.144,59.711999999999996,29.567999999999998,65,128,63,ki_chroma_acts_smoothed
467,4,59.711999999999996,118.37866666666666,58.666666666666664,128,253,125,ki_chroma_acts_smoothed
467,5,118.37866666666666,120.256,1.8773333333333397,253,257,4,ki_chroma_acts_smoothed
467,6,120.256,134.80533333333332,14.549333333333323,257,288,31,ki_chroma_acts_smoothed
467,7,134.80533333333332,149.82399999999998,15.018666666666661,288,320,32,ki_chroma_acts_smoothed
467,8,149.82399999999998,210.83733333333333,61.01333333333335,320,450,130,ki_chroma_acts_smoothed
467,9,210.83733333333333,240.305,29.467666666666673,450,511,61,ki_chroma_acts_smoothed
468,1,0.0,31.232,31.232,0,66,66,chromagram
468,2,31.232,75.392,44.16,66,158,92,chromagram
468,3,75.392,77.312,1.9200000000000017,158,162,4,chromagram
468,4,77.312,92.192,14.879999999999995,162,193,31,chromagram
468,5,92.192,99.872,7.680000000000007,193,209,16,chromagram
468,6,99.872,117.152,17.28,209,245,36,chromagram
468,7,117.152,131.072,13.920000000000002,245,274,29,chromagram
468,8,131.072,192.693,61.62100000000001,274,401,127,chromagram
468,1,0.0,30.752,30.752,0,65,65,chroma_acts
468,2,30.752,75.392,44.64,65,158,93,chroma_acts
468,3,75.392,77.312,1.9200000000000017,158,162,4,chroma_acts
468,4,77.312,92.192,14.879999999999995,162,193,31,chroma_acts
468,5,92.192,99.872,7.680000000000007,193,209,16,chroma_acts
468,6,99.872,120.032,20.159999999999997,209,251,42,chroma_acts
468,7,120.032,131.072,11.040000000000006,251,274,23,chroma_acts
468,8,131.072,192.693,61.62100000000001,274,401,127,chroma_acts
468,1,0.0,31.232,31.232,0,66,66,chroma_acts_smoothed
468,2,31.232,75.392,44.16,66,158,92,chroma_acts_smoothed
468,3,75.392,92.192,16.799999999999997,158,193,35,chroma_acts_smoothed
468,4,92.192,99.872,7.680000000000007,193,209,16,chroma_acts_smoothed
468,5,99.872,119.072,19.200000000000003,209,249,40,chroma_acts_smoothed
468,6,119.072,126.752,7.679999999999993,249,265,16,chroma_acts_smoothed
468,7,126.752,131.072,4.320000000000007,265,274,9,chroma_acts_smoothed
468,8,131.072,192.693,61.62100000000001,274,401,127,chroma_acts_smoothed
468,1,0.0,31.232,31.232,0,66,66,ki_chroma
468,2,31.232,75.392,44.16,66,158,92,ki_chroma
468,3,75.392,77.312,1.9200000000000017,158,162,4,ki_chroma
468,4,77.312,92.192,14.879999999999995,162,193,31,ki_chroma
468,5,92.192,99.872,7.680000000000007,193,209,16,ki_chroma
468,6,99.872,117.152,17.28,209,245,36,ki_chroma
468,7,117.152,131.072,13.920000000000002,245,274,29,ki_chroma
468,8,131.072,192.693,61.62100000000001,274,401,127,ki_chroma
468,1,0.0,30.752,30.752,0,65,65,ki_chroma_acts
468,2,30.752,75.392,44.64,65,158,93,ki_chroma_acts
468,3,75.392,77.312,1.9200000000000017,158,162,4,ki_chroma_acts
468,4,77.312,92.192,14.879999999999995,162,193,31,ki_chroma_acts
468,5,92.192,99.872,7.680000000000007,193,209,16,ki_chroma_acts
468,6,99.872,120.032,20.159999999999997,209,251,42,ki_chroma_acts
468,7,120.032,131.072,11.040000000000006,251,274,23,ki_chroma_acts
468,8,131.072,192.693,61.62100000000001,274,401,127,ki_chroma_acts
468,1,0.0,31.232,31.232,0,66,66,ki_chroma_acts_smoothed
468,2,31.232,75.392,44.16,66,158,92,ki_chroma_acts_smoothed
468,3,75.392,92.192,16.799999999999997,158,193,35,ki_chroma_acts_smoothed
468,4,92.192,99.872,7.680000000000007,193,209,16,ki_chroma_acts_smoothed
468,5,99.872,119.072,19.200000000000003,209,249,40,ki_chroma_acts_smoothed
468,6,119.072,126.752,7.679999999999993,249,265,16,ki_chroma_acts_smoothed
468,7,126.752,131.072,4.320000000000007,265,274,9,ki_chroma_acts_smoothed
468,8,131.072,192.693,61.62100000000001,274,401,127,ki_chroma_acts_smoothed
470,1,0.0,14.911999999999999,14.911999999999999,0,32,32,chromagram
470,2,14.911999999999999,29.311999999999998,14.399999999999999,32,62,30,chromagram
470,3,29.311999999999998,44.672,15.36,62,94,32,chromagram
470,4,44.672,60.512,15.840000000000003,94,127,33,chromagram
470,5,60.512,105.152,44.64,127,220,93,chromagram
470,6,105.152,121.952,16.799999999999997,220,255,35,chromagram
470,7,121.952,137.31199999999998,15.359999999999985,255,287,32,chromagram
470,8,137.31199999999998,152.192,14.880000000000024,287,318,31,chromagram
470,9,152.192,212.851,60.65899999999999,318,443,125,chromagram
470,1,0.0,14.911999999999999,14.911999999999999,0,32,32,chroma_acts
470,2,14.911999999999999,29.311999999999998,14.399999999999999,32,62,30,chroma_acts
470,3,29.311999999999998,44.672,15.36,62,94,32,chroma_acts
470,4,44.672,105.152,60.480000000000004,94,220,126,chroma_acts
470,5,105.152,125.792,20.64,220,263,43,chroma_acts
470,6,125.792,128.672,2.8799999999999955,263,269,6,chroma_acts
470,7,128.672,136.352,7.680000000000007,269,285,16,chroma_acts
470,8,136.352,152.192,15.840000000000003,285,318,33,chroma_acts
470,9,152.192,212.851,60.65899999999999,318,443,125,chroma_acts
470,1,0.0,14.911999999999999,14.911999999999999,0,32,32,chroma_acts_smoothed
470,2,14.911999999999999,28.832,13.920000000000002,32,61,29,chroma_acts_smoothed
470,3,28.832,44.672,15.839999999999996,61,94,33,chroma_acts_smoothed
470,4,44.672,60.512,15.840000000000003,94,127,33,chroma_acts_smoothed
470,5,60.512,105.152,44.64,127,220,93,chroma_acts_smoothed
470,6,105.152,123.872,18.72,220,259,39,chroma_acts_smoothed
470,7,123.872,136.352,12.480000000000004,259,285,26,chroma_acts_smoothed
470,8,136.352,152.192,15.840000000000003,285,318,33,chroma_acts_smoothed
470,9,152.192,212.851,60.65899999999999,318,443,125,chroma_acts_smoothed
470,1,0.0,14.911999999999999,14.911999999999999,0,32,32,ki_chroma
470,2,14.911999999999999,29.311999999999998,14.399999999999999,32,62,30,ki_chroma
470,3,29.311999999999998,44.672,15.36,62,94,32,ki_chroma
470,4,44.672,60.512,15.840000000000003,94,127,33,ki_chroma
470,5,60.512,105.152,44.64,127,220,93,ki_chroma
470,6,105.152,121.952,16.799999999999997,220,255,35,ki_chroma
470,7,121.952,137.31199999999998,15.359999999999985,255,287,32,ki_chroma
470,8,137.31199999999998,152.192,14.880000000000024,287,318,31,ki_chroma
470,9,152.192,212.851,60.65899999999999,318,443,125,ki_chroma
470,1,0.0,14.911999999999999,14.911999999999999,0,32,32,ki_chroma_acts
470,2,14.911999999999999,29.311999999999998,14.399999999999999,32,62,30,ki_chroma_acts
470,3,29.311999999999998,44.672,15.36,62,94,32,ki_chroma_acts
470,4,44.672,105.152,60.480000000000004,94,220,126,ki_chroma_acts
470,5,105.152,125.792,20.64,220,263,43,ki_chroma_acts
470,6,125.792,128.672,2.8799999999999955,263,269,6,ki_chroma_acts
470,7,128.672,136.352,7.680000000000007,269,285,16,ki_chroma_acts
470,8,136.352,152.192,15.840000000000003,285,318,33,ki_chroma_acts
470,9,152.192,212.851,60.65899999999999,318,443,125,ki_chroma_acts
470,1,0.0,14.911999999999999,14.911999999999999,0,32,32,ki_chroma_acts_smoothed
470,2,14.911999999999999,28.832,13.920000000000002,32,61,29,ki_chroma_acts_smoothed
470,3,28.832,44.672,15.839999999999996,61,94,33,ki_chroma_acts_smoothed
470,4,44.672,60.512,15.840000000000003,94,127,33,ki_chroma_acts_smoothed
470,5,60.512,105.152,44.64,127,220,93,ki_chroma_acts_smoothed
470,6,105.152,123.872,18.72,220,259,39,ki_chroma_acts_smoothed
470,7,123.872,136.352,12.480000000000004,259,285,26,ki_chroma_acts_smoothed
470,8,136.352,152.192,15.840000000000003,285,318,33,ki_chroma_acts_smoothed
470,9,152.192,212.851,60.65899999999999,318,443,125,ki_chroma_acts_smoothed
472,1,0.0,54.272,54.272,0,114,114,chromagram
472,2,54.272,123.392,69.12,114,258,144,chromagram
472,3,123.392,140.672,17.28,258,294,36,chromagram
472,4,140.672,161.792,21.120000000000005,294,338,44,chromagram
472,5,161.792,195.392,33.599999999999994,338,408,70,chromagram
472,6,195.392,224.672,29.28,408,469,61,chromagram
472,7,224.672,240.03199999999998,15.359999999999985,469,501,32,chromagram
472,8,240.03199999999998,265.581,25.549000000000035,501,553,52,chromagram
472,1,0.0,54.272,54.272,0,114,114,chroma_acts
472,2,54.272,94.592,40.32,114,198,84,chroma_acts
472,3,94.592,123.392,28.799999999999997,198,258,60,chroma_acts
472,4,123.392,139.232,15.840000000000003,258,291,33,chroma_acts
472,5,139.232,161.792,22.560000000000002,291,338,47,chroma_acts
472,6,161.792,224.672,62.879999999999995,338,469,131,chroma_acts
472,7,224.672,240.03199999999998,15.359999999999985,469,501,32,chroma_acts
472,8,240.03199999999998,265.581,25.549000000000035,501,553,52,chroma_acts
472,1,0.0,53.792,53.792,0,113,113,chroma_acts_smoothed
472,2,53.792,94.592,40.8,113,198,85,chroma_acts_smoothed
472,3,94.592,122.91199999999999,28.319999999999993,198,257,59,chroma_acts_smoothed
472,4,122.91199999999999,139.232,16.320000000000007,257,291,34,chroma_acts_smoothed
472,5,139.232,161.792,22.560000000000002,291,338,47,chroma_acts_smoothed
472,6,161.792,195.392,33.599999999999994,338,408,70,chroma_acts_smoothed
472,7,195.392,240.03199999999998,44.639999999999986,408,501,93,chroma_acts_smoothed
472,8,240.03199999999998,265.581,25.549000000000035,501,553,52,chroma_acts_smoothed
472,1,0.0,54.272,54.272,0,114,114,ki_chroma
472,2,54.272,123.392,69.12,114,258,144,ki_chroma
472,3,123.392,140.672,17.28,258,294,36,ki_chroma
472,4,140.672,161.792,21.120000000000005,294,338,44,ki_chroma
472,5,161.792,195.392,33.599999999999994,338,408,70,ki_chroma
472,6,195.392,224.672,29.28,408,469,61,ki_chroma
472,7,224.672,240.03199999999998,15.359999999999985,469,501,32,ki_chroma
472,8,240.03199999999998,265.581,25.549000000000035,501,553,52,ki_chroma
472,1,0.0,54.272,54.272,0,114,114,ki_chroma_acts
472,2,54.272,94.592,40.32,114,198,84,ki_chroma_acts
472,3,94.592,123.392,28.799999999999997,198,258,60,ki_chroma_acts
472,4,123.392,139.232,15.840000000000003,258,291,33,ki_chroma_acts
472,5,139.232,161.792,22.560000000000002,291,338,47,ki_chroma_acts
472,6,161.792,224.672,62.879999999999995,338,469,131,ki_chroma_acts
472,7,224.672,240.03199999999998,15.359999999999985,469,501,32,ki_chroma_acts
472,8,240.03199999999998,265.581,25.549000000000035,501,553,52,ki_chroma_acts
472,1,0.0,53.792,53.792,0,113,113,ki_chroma_acts_smoothed
472,2,53.792,94.592,40.8,113,198,85,ki_chroma_acts_smoothed
472,3,94.592,122.91199999999999,28.319999999999993,198,257,59,ki_chroma_acts_smoothed
472,4,122.91199999999999,139.232,16.320000000000007,257,291,34,ki_chroma_acts_smoothed
472,5,139.232,161.792,22.560000000000002,291,338,47,ki_chroma_acts_smoothed
472,6,161.792,195.392,33.599999999999994,338,408,70,ki_chroma_acts_smoothed
472,7,195.392,240.03199999999998,44.639999999999986,408,501,93,ki_chroma_acts_smoothed
472,8,240.03199999999998,265.581,25.549000000000035,501,553,52,ki_chroma_acts_smoothed
474,1,0.0,30.282666666666664,30.282666666666664,0,64,64,chromagram
474,2,30.282666666666664,61.00266666666667,30.720000000000006,64,128,64,chromagram
474,3,61.00266666666667,75.88266666666667,14.879999999999995,128,159,31,chromagram
474,4,75.88266666666667,106.60266666666666,30.72,159,223,64,chromagram
474,5,106.60266666666666,145.48266666666666,38.879999999999995,223,304,81,chromagram
474,6,145.48266666666666,213.16266666666667,67.68,304,445,141,chromagram
474,7,213.16266666666667,215.08266666666665,1.9199999999999875,445,449,4,chromagram
474,8,215.08266666666665,227.221,12.13833333333335,449,473,24,chromagram
474,1,0.0,30.282666666666664,30.282666666666664,0,64,64,chroma_acts
474,2,30.282666666666664,61.00266666666667,30.720000000000006,64,128,64,chroma_acts
474,3,61.00266666666667,75.88266666666667,14.879999999999995,128,159,31,chroma_acts
474,4,75.88266666666667,106.60266666666666,30.72,159,223,64,chroma_acts
474,5,106.60266666666666,152.20266666666666,45.599999999999994,223,318,95,chroma_acts
474,6,152.20266666666666,215.08266666666665,62.879999999999995,318,449,131,chroma_acts
474,7,215.08266666666665,220.84266666666667,5.760000000000019,449,461,12,chroma_acts
474,8,220.84266666666667,227.221,6.37833333333333,461,473,12,chroma_acts
474,1,0.0,30.282666666666664,30.282666666666664,0,64,64,chroma_acts_smoothed
474,2,30.282666666666664,61.00266666666667,30.720000000000006,64,128,64,chroma_acts_smoothed
474,3,61.00266666666667,75.88266666666667,14.879999999999995,128,159,31,chroma_acts_smoothed
474,4,75.88266666666667,106.60266666666666,30.72,159,223,64,chroma_acts_smoothed
474,5,106.60266666666666,152.20266666666666,45.599999999999994,223,318,95,chroma_acts_smoothed
474,6,152.20266666666666,215.56266666666667,63.360000000000014,318,450,132,chroma_acts_smoothed
474,7,215.56266666666667,220.84266666666667,5.280000000000001,450,461,11,chroma_acts_smoothed
474,8,220.84266666666667,227.221,6.37833333333333,461,473,12,chroma_acts_smoothed
474,1,0.0,30.282666666666664,30.282666666666664,0,64,64,ki_chroma
474,2,30.282666666666664,61.00266666666667,30.720000000000006,64,128,64,ki_chroma
474,3,61.00266666666667,75.88266666666667,14.879999999999995,128,159,31,ki_chroma
474,4,75.88266666666667,106.60266666666666,30.72,159,223,64,ki_chroma
474,5,106.60266666666666,145.48266666666666,38.879999999999995,223,304,81,ki_chroma
474,6,145.48266666666666,213.16266666666667,67.68,304,445,141,ki_chroma
474,7,213.16266666666667,215.08266666666665,1.9199999999999875,445,449,4,ki_chroma
474,8,215.08266666666665,227.221,12.13833333333335,449,473,24,ki_chroma
474,1,0.0,30.282666666666664,30.282666666666664,0,64,64,ki_chroma_acts
474,2,30.282666666666664,61.00266666666667,30.720000000000006,64,128,64,ki_chroma_acts
474,3,61.00266666666667,75.88266666666667,14.879999999999995,128,159,31,ki_chroma_acts
474,4,75.88266666666667,106.60266666666666,30.72,159,223,64,ki_chroma_acts
474,5,106.60266666666666,152.20266666666666,45.599999999999994,223,318,95,ki_chroma_acts
474,6,152.20266666666666,215.08266666666665,62.879999999999995,318,449,131,ki_chroma_acts
474,7,215.08266666666665,220.84266666666667,5.760000000000019,449,461,12,ki_chroma_acts
474,8,220.84266666666667,227.221,6.37833333333333,461,473,12,ki_chroma_acts
474,1,0.0,30.282666666666664,30.282666666666664,0,64,64,ki_chroma_acts_smoothed
474,2,30.282666666666664,61.00266666666667,30.720000000000006,64,128,64,ki_chroma_acts_smoothed
474,3,61.00266666666667,75.88266666666667,14.879999999999995,128,159,31,ki_chroma_acts_smoothed
474,4,75.88266666666667,106.60266666666666,30.72,159,223,64,ki_chroma_acts_smoothed
474,5,106.60266666666666,152.20266666666666,45.599999999999994,223,318,95,ki_chroma_acts_smoothed
474,6,152.20266666666666,215.56266666666667,63.360000000000014,318,450,132,ki_chroma_acts_smoothed
474,7,215.56266666666667,220.84266666666667,5.280000000000001,450,461,11,ki_chroma_acts_smoothed
474,8,220.84266666666667,227.221,6.37833333333333,461,473,12,ki_chroma_acts_smoothed
476,1,0.0,22.08,22.08,0,49,49,chromagram
476,2,22.08,29.418666666666663,7.338666666666665,49,65,16,chromagram
476,3,29.418666666666663,58.31466666666666,28.895999999999997,65,128,63,chromagram
476,4,58.31466666666666,73.45066666666666,15.136000000000003,128,161,33,chromagram
476,5,73.45066666666666,102.80533333333332,29.35466666666666,161,225,64,chromagram
476,6,102.80533333333332,139.49866666666665,36.69333333333333,225,305,80,chromagram
476,7,139.49866666666665,212.42666666666662,72.92799999999997,305,464,159,chromagram
476,8,212.42666666666662,231.69066666666663,19.26400000000001,464,506,42,chromagram
476,9,231.69066666666663,268.609,36.91833333333335,506,585,79,chromagram
476,1,0.0,22.08,22.08,0,49,49,chroma_acts
476,2,22.08,29.418666666666663,7.338666666666665,49,65,16,chroma_acts
476,3,29.418666666666663,58.773333333333326,29.354666666666663,65,129,64,chroma_acts
476,4,58.773333333333326,73.45066666666666,14.677333333333337,129,161,32,chroma_acts
476,5,73.45066666666666,102.80533333333332,29.35466666666666,161,225,64,chroma_acts
476,6,102.80533333333332,145.00266666666664,42.19733333333332,225,317,92,chroma_acts
476,7,145.00266666666664,146.8373333333333,1.8346666666666636,317,321,4,chroma_acts
476,8,146.8373333333333,222.05866666666662,75.22133333333332,321,485,164,chroma_acts
476,9,222.05866666666662,268.609,46.550333333333356,485,585,100,chroma_acts
476,1,0.0,21.621333333333332,21.621333333333332,0,48,48,chroma_acts_smoothed
476,2,21.621333333333332,29.418666666666663,7.797333333333331,48,65,17,chroma_acts_smoothed
476,3,29.418666666666663,58.773333333333326,29.354666666666663,65,129,64,chroma_acts_smoothed
476,4,58.773333333333326,73.45066666666666,14.677333333333337,129,161,32,chroma_acts_smoothed
476,5,73.45066666666666,103.264,29.813333333333333,161,226,65,chroma_acts_smoothed
476,6,103.264,139.03999999999996,35.77599999999997,226,304,78,chroma_acts_smoothed
476,7,139.03999999999996,147.29599999999996,8.256,304,322,18,chroma_acts_smoothed
476,8,147.29599999999996,223.8933333333333,76.59733333333332,322,489,167,chroma_acts_smoothed
476,9,223.8933333333333,268.609,44.71566666666669,489,585,96,chroma_acts_smoothed
476,1,0.0,22.08,22.08,0,49,49,ki_chroma
476,2,22.08,29.418666666666663,7.338666666666665,49,65,16,ki_chroma
476,3,29.418666666666663,58.31466666666666,28.895999999999997,65,128,63,ki_chroma
476,4,58.31466666666666,73.45066666666666,15.136000000000003,128,161,33,ki_chroma
476,5,73.45066666666666,102.80533333333332,29.35466666666666,161,225,64,ki_chroma
476,6,102.80533333333332,139.49866666666665,36.69333333333333,225,305,80,ki_chroma
476,7,139.49866666666665,212.42666666666662,72.92799999999997,305,464,159,ki_chroma
476,8,212.42666666666662,231.69066666666663,19.26400000000001,464,506,42,ki_chroma
476,9,231.69066666666663,268.609,36.91833333333335,506,585,79,ki_chroma
476,1,0.0,22.08,22.08,0,49,49,ki_chroma_acts
476,2,22.08,29.418666666666663,7.338666666666665,49,65,16,ki_chroma_acts
476,3,29.418666666666663,58.773333333333326,29.354666666666663,65,129,64,ki_chroma_acts
476,4,58.773333333333326,73.45066666666666,14.677333333333337,129,161,32,ki_chroma_acts
476,5,73.45066666666666,102.80533333333332,29.35466666666666,161,225,64,ki_chroma_acts
476,6,102.80533333333332,145.00266666666664,42.19733333333332,225,317,92,ki_chroma_acts
476,7,145.00266666666664,146.8373333333333,1.8346666666666636,317,321,4,ki_chroma_acts
476,8,146.8373333333333,222.05866666666662,75.22133333333332,321,485,164,ki_chroma_acts
476,9,222.05866666666662,268.609,46.550333333333356,485,585,100,ki_chroma_acts
476,1,0.0,21.621333333333332,21.621333333333332,0,48,48,ki_chroma_acts_smoothed
476,2,21.621333333333332,29.418666666666663,7.797333333333331,48,65,17,ki_chroma_acts_smoothed
476,3,29.418666666666663,58.773333333333326,29.354666666666663,65,129,64,ki_chroma_acts_smoothed
476,4,58.773333333333326,73.45066666666666,14.677333333333337,129,161,32,ki_chroma_acts_smoothed
476,5,73.45066666666666,103.264,29.813333333333333,161,226,65,ki_chroma_acts_smoothed
476,6,103.264,139.03999999999996,35.77599999999997,226,304,78,ki_chroma_acts_smoothed
476,7,139.03999999999996,147.29599999999996,8.256,304,322,18,ki_chroma_acts_smoothed
476,8,147.29599999999996,223.8933333333333,76.59733333333332,322,489,167,ki_chroma_acts_smoothed
476,9,223.8933333333333,268.609,44.71566666666669,489,585,96,ki_chroma_acts_smoothed
478,1,0.0,16.821333333333335,16.821333333333335,0,33,33,chromagram
478,2,16.821333333333335,64.43733333333333,47.61599999999999,33,126,93,chromagram
478,3,64.43733333333333,82.86933333333333,18.432000000000002,126,162,36,chromagram
478,4,82.86933333333333,100.27733333333333,17.408,162,196,34,chromagram
478,5,100.27733333333333,108.98133333333332,8.703999999999994,196,213,17,chromagram
478,6,108.98133333333332,122.80533333333334,13.824000000000012,213,240,27,chromagram
478,7,122.80533333333334,128.94933333333333,6.143999999999991,240,252,12,chromagram
478,8,128.94933333333333,164.27733333333333,35.328,252,321,69,chromagram
478,9,164.27733333333333,180.805,16.527666666666676,321,352,31,chromagram
478,1,0.0,64.43733333333333,64.43733333333333,0,126,126,chroma_acts
478,2,64.43733333333333,81.84533333333333,17.408,126,160,34,chroma_acts
478,3,81.84533333333333,96.18133333333333,14.335999999999999,160,188,28,chroma_acts
478,4,96.18133333333333,100.27733333333333,4.096000000000004,188,196,8,chroma_acts
478,5,100.27733333333333,111.02933333333333,10.751999999999995,196,217,21,chroma_acts
478,6,111.02933333333333,128.94933333333333,17.92,217,252,35,chroma_acts
478,7,128.94933333333333,163.76533333333333,34.816,252,320,68,chroma_acts
478,8,163.76533333333333,180.805,17.039666666666676,320,352,32,chroma_acts
478,1,0.0,17.333333333333336,17.333333333333336,0,34,34,chroma_acts_smoothed
478,2,17.333333333333336,64.94933333333333,47.61599999999999,34,127,93,chroma_acts_smoothed
478,3,64.94933333333333,81.84533333333333,16.896,127,160,33,chroma_acts_smoothed
478,4,81.84533333333333,100.78933333333333,18.944000000000003,160,197,37,chroma_acts_smoothed
478,5,100.78933333333333,108.46933333333332,7.679999999999993,197,212,15,chroma_acts_smoothed
478,6,108.46933333333332,123.31733333333332,14.847999999999999,212,241,29,chroma_acts_smoothed
478,7,123.31733333333332,128.94933333333333,5.632000000000005,241,252,11,chroma_acts_smoothed
478,8,128.94933333333333,164.27733333333333,35.328,252,321,69,chroma_acts_smoothed
478,9,164.27733333333333,180.805,16.527666666666676,321,352,31,chroma_acts_smoothed
478,1,0.0,16.821333333333335,16.821333333333335,0,33,33,ki_chroma
478,2,16.821333333333335,64.43733333333333,47.61599999999999,33,126,93,ki_chroma
478,3,64.43733333333333,82.86933333333333,18.432000000000002,126,162,36,ki_chroma
478,4,82.86933333333333,100.27733333333333,17.408,162,196,34,ki_chroma
478,5,100.27733333333333,108.98133333333332,8.703999999999994,196,213,17,ki_chroma
478,6,108.98133333333332,122.80533333333334,13.824000000000012,213,240,27,ki_chroma
478,7,122.80533333333334,128.94933333333333,6.143999999999991,240,252,12,ki_chroma
478,8,128.94933333333333,164.27733333333333,35.328,252,321,69,ki_chroma
478,9,164.27733333333333,180.805,16.527666666666676,321,352,31,ki_chroma
478,1,0.0,64.43733333333333,64.43733333333333,0,126,126,ki_chroma_acts
478,2,64.43733333333333,81.84533333333333,17.408,126,160,34,ki_chroma_acts
478,3,81.84533333333333,96.18133333333333,14.335999999999999,160,188,28,ki_chroma_acts
478,4,96.18133333333333,100.27733333333333,4.096000000000004,188,196,8,ki_chroma_acts
478,5,100.27733333333333,111.02933333333333,10.751999999999995,196,217,21,ki_chroma_acts
478,6,111.02933333333333,128.94933333333333,17.92,217,252,35,ki_chroma_acts
478,7,128.94933333333333,163.76533333333333,34.816,252,320,68,ki_chroma_acts
478,8,163.76533333333333,180.805,17.039666666666676,320,352,32,ki_chroma_acts
478,1,0.0,17.333333333333336,17.333333333333336,0,34,34,ki_chroma_acts_smoothed
478,2,17.333333333333336,64.94933333333333,47.61599999999999,34,127,93,ki_chroma_acts_smoothed
478,3,64.94933333333333,81.84533333333333,16.896,127,160,33,ki_chroma_acts_smoothed
478,4,81.84533333333333,100.78933333333333,18.944000000000003,160,197,37,ki_chroma_acts_smoothed
478,5,100.78933333333333,108.46933333333332,7.679999999999993,197,212,15,ki_chroma_acts_smoothed
478,6,108.46933333333332,123.31733333333332,14.847999999999999,212,241,29,ki_chroma_acts_smoothed
478,7,123.31733333333332,128.94933333333333,5.632000000000005,241,252,11,ki_chroma_acts_smoothed
478,8,128.94933333333333,164.27733333333333,35.328,252,321,69,ki_chroma_acts_smoothed
478,9,164.27733333333333,180.805,16.527666666666676,321,352,31,ki_chroma_acts_smoothed
479,1,0.0,25.568,25.568,0,55,55,chromagram
479,2,25.568,61.23733333333333,35.66933333333333,55,131,76,chromagram
479,3,61.23733333333333,107.232,45.99466666666667,131,229,98,chromagram
479,4,107.232,120.37333333333333,13.141333333333336,229,257,28,chromagram
479,5,120.37333333333333,135.392,15.018666666666661,257,289,32,chromagram
479,6,135.392,164.95999999999998,29.567999999999984,289,352,63,chromagram
479,7,164.95999999999998,212.36266666666666,47.402666666666676,352,453,101,chromagram
479,8,212.36266666666666,240.52266666666665,28.159999999999997,453,513,60,chromagram
479,9,240.52266666666665,251.706,11.183333333333337,513,535,22,chromagram
479,1,0.0,11.488,11.488,0,25,25,chroma_acts
479,2,11.488,15.242666666666667,3.754666666666667,25,33,8,chroma_acts
479,3,15.242666666666667,61.23733333333333,45.99466666666667,33,131,98,chroma_acts
479,4,61.23733333333333,107.232,45.99466666666667,131,229,98,chroma_acts
479,5,107.232,120.37333333333333,13.141333333333336,229,257,28,chroma_acts
479,6,120.37333333333333,170.59199999999998,50.21866666666665,257,364,107,chroma_acts
479,7,170.59199999999998,212.36266666666666,41.77066666666667,364,453,89,chroma_acts
479,8,212.36266666666666,240.52266666666665,28.159999999999997,453,513,60,chroma_acts
479,9,240.52266666666665,251.706,11.183333333333337,513,535,22,chroma_acts
479,1,0.0,25.568,25.568,0,55,55,chroma_acts_smoothed
479,2,25.568,61.23733333333333,35.66933333333333,55,131,76,chroma_acts_smoothed
479,3,61.23733333333333,107.232,45.99466666666667,131,229,98,chroma_acts_smoothed
479,4,107.232,120.37333333333333,13.141333333333336,229,257,28,chroma_acts_smoothed
479,5,120.37333333333333,165.42933333333332,45.05599999999998,257,353,96,chroma_acts_smoothed
479,6,165.42933333333332,170.59199999999998,5.1626666666666665,353,364,11,chroma_acts_smoothed
479,7,170.59199999999998,212.36266666666666,41.77066666666667,364,453,89,chroma_acts_smoothed
479,8,212.36266666666666,240.992,28.629333333333335,453,514,61,chroma_acts_smoothed
479,9,240.992,251.706,10.713999999999999,514,535,21,chroma_acts_smoothed
479,1,0.0,25.568,25.568,0,55,55,ki_chroma
479,2,25.568,61.23733333333333,35.66933333333333,55,131,76,ki_chroma
479,3,61.23733333333333,107.232,45.99466666666667,131,229,98,ki_chroma
479,4,107.232,120.37333333333333,13.141333333333336,229,257,28,ki_chroma
479,5,120.37333333333333,135.392,15.018666666666661,257,289,32,ki_chroma
479,6,135.392,164.95999999999998,29.567999999999984,289,352,63,ki_chroma
479,7,164.95999999999998,212.36266666666666,47.402666666666676,352,453,101,ki_chroma
479,8,212.36266666666666,240.52266666666665,28.159999999999997,453,513,60,ki_chroma
479,9,240.52266666666665,251.706,11.183333333333337,513,535,22,ki_chroma
479,1,0.0,11.488,11.488,0,25,25,ki_chroma_acts
479,2,11.488,15.242666666666667,3.754666666666667,25,33,8,ki_chroma_acts
479,3,15.242666666666667,61.23733333333333,45.99466666666667,33,131,98,ki_chroma_acts
479,4,61.23733333333333,107.232,45.99466666666667,131,229,98,ki_chroma_acts
479,5,107.232,120.37333333333333,13.141333333333336,229,257,28,ki_chroma_acts
479,6,120.37333333333333,170.59199999999998,50.21866666666665,257,364,107,ki_chroma_acts
479,7,170.59199999999998,212.36266666666666,41.77066666666667,364,453,89,ki_chroma_acts
479,8,212.36266666666666,240.52266666666665,28.159999999999997,453,513,60,ki_chroma_acts
479,9,240.52266666666665,251.706,11.183333333333337,513,535,22,ki_chroma_acts
479,1,0.0,25.568,25.568,0,55,55,ki_chroma_acts_smoothed
479,2,25.568,61.23733333333333,35.66933333333333,55,131,76,ki_chroma_acts_smoothed
479,3,61.23733333333333,107.232,45.99466666666667,131,229,98,ki_chroma_acts_smoothed
479,4,107.232,120.37333333333333,13.141333333333336,229,257,28,ki_chroma_acts_smoothed
479,5,120.37333333333333,165.42933333333332,45.05599999999998,257,353,96,ki_chroma_acts_smoothed
479,6,165.42933333333332,170.59199999999998,5.1626666666666665,353,364,11,ki_chroma_acts_smoothed
479,7,170.59199999999998,212.36266666666666,41.77066666666667,364,453,89,ki_chroma_acts_smoothed
479,8,212.36266666666666,240.992,28.629333333333335,453,514,61,ki_chroma_acts_smoothed
479,9,240.992,251.706,10.713999999999999,514,535,21,ki_chroma_acts_smoothed
480,1,0.0,46.592,46.592,0,98,98,chromagram
480,2,46.592,92.672,46.08,98,194,96,chromagram
480,3,92.672,122.432,29.760000000000005,194,256,62,chromagram
480,4,122.432,127.71199999999999,5.279999999999987,256,267,11,chromagram
480,5,127.71199999999999,153.632,25.920000000000016,267,321,54,chromagram
480,6,153.632,216.512,62.879999999999995,321,452,131,chromagram
480,7,216.512,246.272,29.75999999999999,452,514,62,chromagram
480,8,246.272,251.552,5.280000000000001,514,525,11,chromagram
480,9,251.552,325.08,73.52799999999999,525,677,152,chromagram
480,1,0.0,46.592,46.592,0,98,98,chroma_acts
480,2,46.592,92.672,46.08,98,194,96,chroma_acts
480,3,92.672,122.432,29.760000000000005,194,256,62,chroma_acts
480,4,122.432,127.71199999999999,5.279999999999987,256,267,11,chroma_acts
480,5,127.71199999999999,154.112,26.400000000000006,267,322,55,chroma_acts
480,6,154.112,216.512,62.400000000000006,322,452,130,chroma_acts
480,7,216.512,246.272,29.75999999999999,452,514,62,chroma_acts
480,8,246.272,251.552,5.280000000000001,514,525,11,chroma_acts
480,9,251.552,325.08,73.52799999999999,525,677,152,chroma_acts
480,1,0.0,47.071999999999996,47.071999999999996,0,99,99,chroma_acts_smoothed
480,2,47.071999999999996,91.232,44.160000000000004,99,191,92,chroma_acts_smoothed
480,3,91.232,122.432,31.200000000000003,191,256,65,chroma_acts_smoothed
480,4,122.432,154.112,31.679999999999993,256,322,66,chroma_acts_smoothed
480,5,154.112,173.31199999999998,19.19999999999999,322,362,40,chroma_acts_smoothed
480,6,173.31199999999998,215.552,42.24000000000001,362,450,88,chroma_acts_smoothed
480,7,215.552,246.75199999999998,31.19999999999999,450,515,65,chroma_acts_smoothed
480,8,246.75199999999998,251.552,4.800000000000011,515,525,10,chroma_acts_smoothed
480,9,251.552,325.08,73.52799999999999,525,677,152,chroma_acts_smoothed
480,1,0.0,46.592,46.592,0,98,98,ki_chroma
480,2,46.592,92.672,46.08,98,194,96,ki_chroma
480,3,92.672,122.432,29.760000000000005,194,256,62,ki_chroma
480,4,122.432,127.71199999999999,5.279999999999987,256,267,11,ki_chroma
480,5,127.71199999999999,153.632,25.920000000000016,267,321,54,ki_chroma
480,6,153.632,216.512,62.879999999999995,321,452,131,ki_chroma
480,7,216.512,246.272,29.75999999999999,452,514,62,ki_chroma
480,8,246.272,251.552,5.280000000000001,514,525,11,ki_chroma
480,9,251.552,325.08,73.52799999999999,525,677,152,ki_chroma
480,1,0.0,46.592,46.592,0,98,98,ki_chroma_acts
480,2,46.592,92.672,46.08,98,194,96,ki_chroma_acts
480,3,92.672,122.432,29.760000000000005,194,256,62,ki_chroma_acts
480,4,122.432,127.71199999999999,5.279999999999987,256,267,11,ki_chroma_acts
480,5,127.71199999999999,154.112,26.400000000000006,267,322,55,ki_chroma_acts
480,6,154.112,216.512,62.400000000000006,322,452,130,ki_chroma_acts
480,7,216.512,246.272,29.75999999999999,452,514,62,ki_chroma_acts
480,8,246.272,251.552,5.280000000000001,514,525,11,ki_chroma_acts
480,9,251.552,325.08,73.52799999999999,525,677,152,ki_chroma_acts
480,1,0.0,47.071999999999996,47.071999999999996,0,99,99,ki_chroma_acts_smoothed
480,2,47.071999999999996,91.232,44.160000000000004,99,191,92,ki_chroma_acts_smoothed
480,3,91.232,122.432,31.200000000000003,191,256,65,ki_chroma_acts_smoothed
480,4,122.432,154.112,31.679999999999993,256,322,66,ki_chroma_acts_smoothed
480,5,154.112,173.31199999999998,19.19999999999999,322,362,40,ki_chroma_acts_smoothed
480,6,173.31199999999998,215.552,42.24000000000001,362,450,88,ki_chroma_acts_smoothed
480,7,215.552,246.75199999999998,31.19999999999999,450,515,65,ki_chroma_acts_smoothed
480,8,246.75199999999998,251.552,4.800000000000011,515,525,10,ki_chroma_acts_smoothed
480,9,251.552,325.08,73.52799999999999,525,677,152,ki_chroma_acts_smoothed
481,1,0.0,42.261333333333326,42.261333333333326,0,89,89,chromagram
481,2,42.261333333333326,63.38133333333333,21.120000000000005,89,133,44,chromagram
481,3,63.38133333333333,76.82133333333333,13.439999999999998,133,161,28,chromagram
481,4,76.82133333333333,90.74133333333333,13.920000000000002,161,190,29,chromagram
481,5,90.74133333333333,136.34133333333332,45.599999999999994,190,285,95,chromagram
481,6,136.34133333333332,168.9813333333333,32.639999999999986,285,353,68,chromagram
481,7,168.9813333333333,182.90133333333333,13.920000000000016,353,382,29,chromagram
481,8,182.90133333333333,259.70133333333337,76.80000000000004,382,542,160,chromagram
481,9,259.70133333333337,275.358,15.656666666666638,542,573,31,chromagram
481,1,0.0,42.261333333333326,42.261333333333326,0,89,89,chroma_acts
481,2,42.261333333333326,62.901333333333326,20.64,89,132,43,chroma_acts
481,3,62.901333333333326,76.82133333333333,13.920000000000002,132,161,29,chroma_acts
481,4,76.82133333333333,92.18133333333333,15.36,161,193,32,chroma_acts
481,5,92.18133333333333,140.18133333333333,48.0,193,293,100,chroma_acts
481,6,140.18133333333333,168.9813333333333,28.799999999999983,293,353,60,chroma_acts
481,7,168.9813333333333,182.90133333333333,13.920000000000016,353,382,29,chroma_acts
481,8,182.90133333333333,259.70133333333337,76.80000000000004,382,542,160,chroma_acts
481,9,259.70133333333337,275.358,15.656666666666638,542,573,31,chroma_acts
481,1,0.0,42.261333333333326,42.261333333333326,0,89,89,chroma_acts_smoothed
481,2,42.261333333333326,62.42133333333333,20.160000000000004,89,131,42,chroma_acts_smoothed
481,3,62.42133333333333,76.82133333333333,14.399999999999999,131,161,30,chroma_acts_smoothed
481,4,76.82133333333333,91.70133333333332,14.879999999999995,161,192,31,chroma_acts_smoothed
481,5,91.70133333333332,140.18133333333333,48.480000000000004,192,293,101,chroma_acts_smoothed
481,6,140.18133333333333,169.46133333333333,29.28,293,354,61,chroma_acts_smoothed
481,7,169.46133333333333,183.86133333333333,14.400000000000006,354,384,30,chroma_acts_smoothed
481,8,183.86133333333333,259.70133333333337,75.84000000000003,384,542,158,chroma_acts_smoothed
481,9,259.70133333333337,275.358,15.656666666666638,542,573,31,chroma_acts_smoothed
481,1,0.0,42.261333333333326,42.261333333333326,0,89,89,ki_chroma
481,2,42.261333333333326,63.38133333333333,21.120000000000005,89,133,44,ki_chroma
481,3,63.38133333333333,76.82133333333333,13.439999999999998,133,161,28,ki_chroma
481,4,76.82133333333333,90.74133333333333,13.920000000000002,161,190,29,ki_chroma
481,5,90.74133333333333,136.34133333333332,45.599999999999994,190,285,95,ki_chroma
481,6,136.34133333333332,168.9813333333333,32.639999999999986,285,353,68,ki_chroma
481,7,168.9813333333333,182.90133333333333,13.920000000000016,353,382,29,ki_chroma
481,8,182.90133333333333,259.70133333333337,76.80000000000004,382,542,160,ki_chroma
481,9,259.70133333333337,275.358,15.656666666666638,542,573,31,ki_chroma
481,1,0.0,42.261333333333326,42.261333333333326,0,89,89,ki_chroma_acts
481,2,42.261333333333326,62.901333333333326,20.64,89,132,43,ki_chroma_acts
481,3,62.901333333333326,76.82133333333333,13.920000000000002,132,161,29,ki_chroma_acts
481,4,76.82133333333333,92.18133333333333,15.36,161,193,32,ki_chroma_acts
481,5,92.18133333333333,140.18133333333333,48.0,193,293,100,ki_chroma_acts
481,6,140.18133333333333,168.9813333333333,28.799999999999983,293,353,60,ki_chroma_acts
481,7,168.9813333333333,182.90133333333333,13.920000000000016,353,382,29,ki_chroma_acts
481,8,182.90133333333333,259.70133333333337,76.80000000000004,382,542,160,ki_chroma_acts
481,9,259.70133333333337,275.358,15.656666666666638,542,573,31,ki_chroma_acts
481,1,0.0,42.261333333333326,42.261333333333326,0,89,89,ki_chroma_acts_smoothed
481,2,42.261333333333326,62.42133333333333,20.160000000000004,89,131,42,ki_chroma_acts_smoothed
481,3,62.42133333333333,76.82133333333333,14.399999999999999,131,161,30,ki_chroma_acts_smoothed
481,4,76.82133333333333,91.70133333333332,14.879999999999995,161,192,31,ki_chroma_acts_smoothed
481,5,91.70133333333332,140.18133333333333,48.480000000000004,192,293,101,ki_chroma_acts_smoothed
481,6,140.18133333333333,169.46133333333333,29.28,293,354,61,ki_chroma_acts_smoothed
481,7,169.46133333333333,183.86133333333333,14.400000000000006,354,384,30,ki_chroma_acts_smoothed
481,8,183.86133333333333,259.70133333333337,75.84000000000003,384,542,158,ki_chroma_acts_smoothed
481,9,259.70133333333337,275.358,15.656666666666638,542,573,31,ki_chroma_acts_smoothed
487,1,0.0,19.807999999999996,19.807999999999996,0,54,54,chromagram
487,2,19.807999999999996,46.687999999999995,26.88,54,126,72,chromagram
487,3,46.687999999999995,81.40799999999999,34.71999999999999,126,219,93,chromagram
487,4,81.40799999999999,93.35466666666666,11.946666666666673,219,251,32,chromagram
487,5,93.35466666666666,113.51466666666666,20.159999999999997,251,305,54,chromagram
487,6,113.51466666666666,151.59466666666665,38.08,305,407,102,chromagram
487,7,151.59466666666665,196.0213333333333,44.42666666666665,407,526,119,chromagram
487,8,196.0213333333333,226.442,30.420666666666705,526,606,80,chromagram
487,1,0.0,46.687999999999995,46.687999999999995,0,126,126,chroma_acts
487,2,46.687999999999995,81.40799999999999,34.71999999999999,126,219,93,chroma_acts
487,3,81.40799999999999,93.35466666666666,11.946666666666673,219,251,32,chroma_acts
487,4,93.35466666666666,113.51466666666666,20.159999999999997,251,305,54,chroma_acts
487,5,113.51466666666666,140.02133333333333,26.506666666666675,305,376,71,chroma_acts
487,6,140.02133333333333,151.59466666666665,11.573333333333323,376,407,31,chroma_acts
487,7,151.59466666666665,196.76799999999997,45.17333333333332,407,528,121,chroma_acts
487,8,196.76799999999997,226.442,29.674000000000035,528,606,78,chroma_acts
487,1,0.0,46.687999999999995,46.687999999999995,0,126,126,chroma_acts_smoothed
487,2,46.687999999999995,81.40799999999999,34.71999999999999,126,219,93,chroma_acts_smoothed
487,3,81.40799999999999,93.35466666666666,11.946666666666673,219,251,32,chroma_acts_smoothed
487,4,93.35466666666666,113.51466666666666,20.159999999999997,251,305,54,chroma_acts_smoothed
487,5,113.51466666666666,140.02133333333333,26.506666666666675,305,376,71,chroma_acts_smoothed
487,6,140.02133333333333,151.968,11.946666666666658,376,408,32,chroma_acts_smoothed
487,7,151.968,196.0213333333333,44.05333333333331,408,526,118,chroma_acts_smoothed
487,8,196.0213333333333,226.442,30.420666666666705,526,606,80,chroma_acts_smoothed
487,1,0.0,19.807999999999996,19.807999999999996,0,54,54,ki_chroma
487,2,19.807999999999996,46.687999999999995,26.88,54,126,72,ki_chroma
487,3,46.687999999999995,81.40799999999999,34.71999999999999,126,219,93,ki_chroma
487,4,81.40799999999999,93.35466666666666,11.946666666666673,219,251,32,ki_chroma
487,5,93.35466666666666,113.51466666666666,20.159999999999997,251,305,54,ki_chroma
487,6,113.51466666666666,151.59466666666665,38.08,305,407,102,ki_chroma
487,7,151.59466666666665,196.0213333333333,44.42666666666665,407,526,119,ki_chroma
487,8,196.0213333333333,226.442,30.420666666666705,526,606,80,ki_chroma
487,1,0.0,46.687999999999995,46.687999999999995,0,126,126,ki_chroma_acts
487,2,46.687999999999995,81.40799999999999,34.71999999999999,126,219,93,ki_chroma_acts
487,3,81.40799999999999,93.35466666666666,11.946666666666673,219,251,32,ki_chroma_acts
487,4,93.35466666666666,113.51466666666666,20.159999999999997,251,305,54,ki_chroma_acts
487,5,113.51466666666666,140.02133333333333,26.506666666666675,305,376,71,ki_chroma_acts
487,6,140.02133333333333,151.59466666666665,11.573333333333323,376,407,31,ki_chroma_acts
487,7,151.59466666666665,196.76799999999997,45.17333333333332,407,528,121,ki_chroma_acts
487,8,196.76799999999997,226.442,29.674000000000035,528,606,78,ki_chroma_acts
487,1,0.0,46.687999999999995,46.687999999999995,0,126,126,ki_chroma_acts_smoothed
487,2,46.687999999999995,81.40799999999999,34.71999999999999,126,219,93,ki_chroma_acts_smoothed
487,3,81.40799999999999,93.35466666666666,11.946666666666673,219,251,32,ki_chroma_acts_smoothed
487,4,93.35466666666666,113.51466666666666,20.159999999999997,251,305,54,ki_chroma_acts_smoothed
487,5,113.51466666666666,140.02133333333333,26.506666666666675,305,376,71,ki_chroma_acts_smoothed
487,6,140.02133333333333,151.968,11.946666666666658,376,408,32,ki_chroma_acts_smoothed
487,7,151.968,196.0213333333333,44.05333333333331,408,526,118,ki_chroma_acts_smoothed
487,8,196.0213333333333,226.442,30.420666666666705,526,606,80,ki_chroma_acts_smoothed
489,1,0.0,92.93866666666668,92.93866666666668,0,131,131,chromagram
489,2,92.93866666666668,96.512,3.5733333333333235,131,136,5,chromagram
489,3,96.512,100.8,4.287999999999997,136,142,6,chromagram
489,4,100.8,104.37333333333333,3.5733333333333377,142,147,5,chromagram
489,5,104.37333333333333,123.66933333333334,19.296000000000006,147,174,27,chromagram
489,6,123.66933333333334,127.24266666666666,3.5733333333333235,174,179,5,chromagram
489,7,127.24266666666666,130.816,3.5733333333333377,179,184,5,chromagram
489,8,130.816,170.197,39.381,184,238,54,chromagram
489,1,0.0,104.37333333333333,104.37333333333333,0,147,147,chroma_acts
489,2,104.37333333333333,107.94666666666667,3.5733333333333377,147,152,5,chroma_acts
489,3,107.94666666666667,112.23466666666667,4.287999999999997,152,158,6,chroma_acts
489,4,112.23466666666667,115.808,3.5733333333333377,158,163,5,chroma_acts
489,5,115.808,119.38133333333333,3.5733333333333235,163,168,5,chroma_acts
489,6,119.38133333333333,123.66933333333334,4.288000000000011,168,174,6,chroma_acts
489,7,123.66933333333334,127.24266666666666,3.5733333333333235,174,179,5,chroma_acts
489,8,127.24266666666666,130.816,3.5733333333333377,179,184,5,chroma_acts
489,9,130.816,170.197,39.381,184,238,54,chroma_acts
489,1,0.0,104.37333333333333,104.37333333333333,0,147,147,chroma_acts_smoothed
489,2,104.37333333333333,107.94666666666667,3.5733333333333377,147,152,5,chroma_acts_smoothed
489,3,107.94666666666667,112.23466666666667,4.287999999999997,152,158,6,chroma_acts_smoothed
489,4,112.23466666666667,115.808,3.5733333333333377,158,163,5,chroma_acts_smoothed
489,5,115.808,119.38133333333333,3.5733333333333235,163,168,5,chroma_acts_smoothed
489,6,119.38133333333333,123.66933333333334,4.288000000000011,168,174,6,chroma_acts_smoothed
489,7,123.66933333333334,127.24266666666666,3.5733333333333235,174,179,5,chroma_acts_smoothed
489,8,127.24266666666666,130.816,3.5733333333333377,179,184,5,chroma_acts_smoothed
489,9,130.816,170.197,39.381,184,238,54,chroma_acts_smoothed
489,1,0.0,92.93866666666668,92.93866666666668,0,131,131,ki_chroma
489,2,92.93866666666668,96.512,3.5733333333333235,131,136,5,ki_chroma
489,3,96.512,100.8,4.287999999999997,136,142,6,ki_chroma
489,4,100.8,104.37333333333333,3.5733333333333377,142,147,5,ki_chroma
489,5,104.37333333333333,123.66933333333334,19.296000000000006,147,174,27,ki_chroma
489,6,123.66933333333334,127.24266666666666,3.5733333333333235,174,179,5,ki_chroma
489,7,127.24266666666666,130.816,3.5733333333333377,179,184,5,ki_chroma
489,8,130.816,170.197,39.381,184,238,54,ki_chroma
489,1,0.0,104.37333333333333,104.37333333333333,0,147,147,ki_chroma_acts
489,2,104.37333333333333,107.94666666666667,3.5733333333333377,147,152,5,ki_chroma_acts
489,3,107.94666666666667,112.23466666666667,4.287999999999997,152,158,6,ki_chroma_acts
489,4,112.23466666666667,115.808,3.5733333333333377,158,163,5,ki_chroma_acts
489,5,115.808,119.38133333333333,3.5733333333333235,163,168,5,ki_chroma_acts
489,6,119.38133333333333,123.66933333333334,4.288000000000011,168,174,6,ki_chroma_acts
489,7,123.66933333333334,127.24266666666666,3.5733333333333235,174,179,5,ki_chroma_acts
489,8,127.24266666666666,130.816,3.5733333333333377,179,184,5,ki_chroma_acts
489,9,130.816,170.197,39.381,184,238,54,ki_chroma_acts
489,1,0.0,104.37333333333333,104.37333333333333,0,147,147,ki_chroma_acts_smoothed
489,2,104.37333333333333,107.94666666666667,3.5733333333333377,147,152,5,ki_chroma_acts_smoothed
489,3,107.94666666666667,112.23466666666667,4.287999999999997,152,158,6,ki_chroma_acts_smoothed
489,4,112.23466666666667,115.808,3.5733333333333377,158,163,5,ki_chroma_acts_smoothed
489,5,115.808,119.38133333333333,3.5733333333333235,163,168,5,ki_chroma_acts_smoothed
489,6,119.38133333333333,123.66933333333334,4.288000000000011,168,174,6,ki_chroma_acts_smoothed
489,7,123.66933333333334,127.24266666666666,3.5733333333333235,174,179,5,ki_chroma_acts_smoothed
489,8,127.24266666666666,130.816,3.5733333333333377,179,184,5,ki_chroma_acts_smoothed
489,9,130.816,170.197,39.381,184,238,54,ki_chroma_acts_smoothed
490,1,0.0,18.112000000000002,18.112000000000002,0,39,39,chromagram
490,2,18.112000000000002,30.314666666666668,12.202666666666666,39,65,26,chromagram
490,3,30.314666666666668,75.84,45.525333333333336,65,162,97,chromagram
490,4,75.84,106.34666666666666,30.50666666666666,162,227,65,chromagram
490,5,106.34666666666666,120.896,14.549333333333337,227,258,31,chromagram
490,6,120.896,134.50666666666666,13.61066666666666,258,287,29,chromagram
490,7,134.50666666666666,171.11466666666666,36.608000000000004,287,365,78,chromagram
490,8,171.11466666666666,183.31733333333332,12.202666666666659,365,391,26,chromagram
490,9,183.31733333333332,201.443,18.12566666666669,391,428,37,chromagram
490,1,0.0,13.418666666666667,13.418666666666667,0,29,29,chroma_acts
490,2,13.418666666666667,30.314666666666668,16.896,29,65,36,chroma_acts
490,3,30.314666666666668,75.84,45.525333333333336,65,162,97,chroma_acts
490,4,75.84,106.34666666666666,30.50666666666666,162,227,65,chroma_acts
490,5,106.34666666666666,122.304,15.957333333333338,227,261,34,chroma_acts
490,6,122.304,134.50666666666666,12.202666666666659,261,287,26,chroma_acts
490,7,134.50666666666666,170.176,35.66933333333333,287,363,76,chroma_acts
490,8,170.176,183.31733333333332,13.141333333333336,363,391,28,chroma_acts
490,9,183.31733333333332,201.443,18.12566666666669,391,428,37,chroma_acts
490,1,0.0,13.418666666666667,13.418666666666667,0,29,29,chroma_acts_smoothed
490,2,13.418666666666667,30.314666666666668,16.896,29,65,36,chroma_acts_smoothed
490,3,30.314666666666668,75.37066666666666,45.056,65,161,96,chroma_acts_smoothed
490,4,75.37066666666666,106.34666666666666,30.976,161,227,66,chroma_acts_smoothed
490,5,106.34666666666666,122.304,15.957333333333338,227,261,34,chroma_acts_smoothed
490,6,122.304,134.50666666666666,12.202666666666659,261,287,26,chroma_acts_smoothed
490,7,134.50666666666666,170.64533333333333,36.138666666666666,287,364,77,chroma_acts_smoothed
490,8,170.64533333333333,183.31733333333332,12.671999999999997,364,391,27,chroma_acts_smoothed
490,9,183.31733333333332,201.443,18.12566666666669,391,428,37,chroma_acts_smoothed
490,1,0.0,18.112000000000002,18.112000000000002,0,39,39,ki_chroma
490,2,18.112000000000002,30.314666666666668,12.202666666666666,39,65,26,ki_chroma
490,3,30.314666666666668,75.84,45.525333333333336,65,162,97,ki_chroma
490,4,75.84,106.34666666666666,30.50666666666666,162,227,65,ki_chroma
490,5,106.34666666666666,120.896,14.549333333333337,227,258,31,ki_chroma
490,6,120.896,134.50666666666666,13.61066666666666,258,287,29,ki_chroma
490,7,134.50666666666666,171.11466666666666,36.608000000000004,287,365,78,ki_chroma
490,8,171.11466666666666,183.31733333333332,12.202666666666659,365,391,26,ki_chroma
490,9,183.31733333333332,201.443,18.12566666666669,391,428,37,ki_chroma
490,1,0.0,13.418666666666667,13.418666666666667,0,29,29,ki_chroma_acts
490,2,13.418666666666667,30.314666666666668,16.896,29,65,36,ki_chroma_acts
490,3,30.314666666666668,75.84,45.525333333333336,65,162,97,ki_chroma_acts
490,4,75.84,106.34666666666666,30.50666666666666,162,227,65,ki_chroma_acts
490,5,106.34666666666666,122.304,15.957333333333338,227,261,34,ki_chroma_acts
490,6,122.304,134.50666666666666,12.202666666666659,261,287,26,ki_chroma_acts
490,7,134.50666666666666,170.176,35.66933333333333,287,363,76,ki_chroma_acts
490,8,170.176,183.31733333333332,13.141333333333336,363,391,28,ki_chroma_acts
490,9,183.31733333333332,201.443,18.12566666666669,391,428,37,ki_chroma_acts
490,1,0.0,13.418666666666667,13.418666666666667,0,29,29,ki_chroma_acts_smoothed
490,2,13.418666666666667,30.314666666666668,16.896,29,65,36,ki_chroma_acts_smoothed
490,3,30.314666666666668,75.37066666666666,45.056,65,161,96,ki_chroma_acts_smoothed
490,4,75.37066666666666,106.34666666666666,30.976,161,227,66,ki_chroma_acts_smoothed
490,5,106.34666666666666,122.304,15.957333333333338,227,261,34,ki_chroma_acts_smoothed
490,6,122.304,134.50666666666666,12.202666666666659,261,287,26,ki_chroma_acts_smoothed
490,7,134.50666666666666,170.64533333333333,36.138666666666666,287,364,77,ki_chroma_acts_smoothed
490,8,170.64533333333333,183.31733333333332,12.671999999999997,364,391,27,ki_chroma_acts_smoothed
490,9,183.31733333333332,201.443,18.12566666666669,391,428,37,ki_chroma_acts_smoothed
491,1,0.0,19.274666666666665,19.274666666666665,0,41,41,chromagram
491,2,19.274666666666665,23.114666666666665,3.84,41,49,8,chromagram
491,3,23.114666666666665,26.954666666666665,3.84,49,57,8,chromagram
491,4,26.954666666666665,30.794666666666664,3.84,57,65,8,chromagram
491,5,30.794666666666664,55.754666666666665,24.96,65,117,52,chromagram
491,6,55.754666666666665,61.51466666666667,5.760000000000005,117,129,12,chromagram
491,7,61.51466666666667,121.03466666666665,59.51999999999998,129,253,124,chromagram
491,8,121.03466666666665,169.03466666666665,48.0,253,353,100,chromagram
491,9,169.03466666666665,200.64,31.605333333333334,353,417,64,chromagram
491,1,0.0,19.274666666666665,19.274666666666665,0,41,41,chroma_acts
491,2,19.274666666666665,53.35466666666667,34.08,41,112,71,chroma_acts
491,3,53.35466666666667,63.434666666666665,10.079999999999998,112,133,21,chroma_acts
491,4,63.434666666666665,90.31466666666665,26.87999999999999,133,189,56,chroma_acts
491,5,90.31466666666665,92.71466666666666,2.4000000000000057,189,194,5,chroma_acts
491,6,92.71466666666666,121.99466666666666,29.28,194,255,61,chroma_acts
491,7,121.99466666666666,170.95466666666667,48.96000000000001,255,357,102,chroma_acts
491,8,170.95466666666667,200.64,29.68533333333332,357,417,60,chroma_acts
491,1,0.0,56.23466666666667,56.23466666666667,0,118,118,chroma_acts_smoothed
491,2,56.23466666666667,61.51466666666667,5.280000000000001,118,129,11,chroma_acts_smoothed
491,3,61.51466666666667,90.31466666666665,28.799999999999983,129,189,60,chroma_acts_smoothed
491,4,90.31466666666665,92.71466666666666,2.4000000000000057,189,194,5,chroma_acts_smoothed
491,5,92.71466666666666,122.47466666666666,29.760000000000005,194,256,62,chroma_acts_smoothed
491,6,122.47466666666666,163.75466666666665,41.27999999999999,256,342,86,chroma_acts_smoothed
491,7,163.75466666666665,169.03466666666665,5.280000000000001,342,353,11,chroma_acts_smoothed
491,8,169.03466666666665,200.64,31.605333333333334,353,417,64,chroma_acts_smoothed
491,1,0.0,19.274666666666665,19.274666666666665,0,41,41,ki_chroma
491,2,19.274666666666665,23.114666666666665,3.84,41,49,8,ki_chroma
491,3,23.114666666666665,26.954666666666665,3.84,49,57,8,ki_chroma
491,4,26.954666666666665,30.794666666666664,3.84,57,65,8,ki_chroma
491,5,30.794666666666664,55.754666666666665,24.96,65,117,52,ki_chroma
491,6,55.754666666666665,61.51466666666667,5.760000000000005,117,129,12,ki_chroma
491,7,61.51466666666667,121.03466666666665,59.51999999999998,129,253,124,ki_chroma
491,8,121.03466666666665,169.03466666666665,48.0,253,353,100,ki_chroma
491,9,169.03466666666665,200.64,31.605333333333334,353,417,64,ki_chroma
491,1,0.0,19.274666666666665,19.274666666666665,0,41,41,ki_chroma_acts
491,2,19.274666666666665,53.35466666666667,34.08,41,112,71,ki_chroma_acts
491,3,53.35466666666667,63.434666666666665,10.079999999999998,112,133,21,ki_chroma_acts
491,4,63.434666666666665,90.31466666666665,26.87999999999999,133,189,56,ki_chroma_acts
491,5,90.31466666666665,92.71466666666666,2.4000000000000057,189,194,5,ki_chroma_acts
491,6,92.71466666666666,121.99466666666666,29.28,194,255,61,ki_chroma_acts
491,7,121.99466666666666,170.95466666666667,48.96000000000001,255,357,102,ki_chroma_acts
491,8,170.95466666666667,200.64,29.68533333333332,357,417,60,ki_chroma_acts
491,1,0.0,56.23466666666667,56.23466666666667,0,118,118,ki_chroma_acts_smoothed
491,2,56.23466666666667,61.51466666666667,5.280000000000001,118,129,11,ki_chroma_acts_smoothed
491,3,61.51466666666667,90.31466666666665,28.799999999999983,129,189,60,ki_chroma_acts_smoothed
491,4,90.31466666666665,92.71466666666666,2.4000000000000057,189,194,5,ki_chroma_acts_smoothed
491,5,92.71466666666666,122.47466666666666,29.760000000000005,194,256,62,ki_chroma_acts_smoothed
491,6,122.47466666666666,163.75466666666665,41.27999999999999,256,342,86,ki_chroma_acts_smoothed
491,7,163.75466666666665,169.03466666666665,5.280000000000001,342,353,11,ki_chroma_acts_smoothed
491,8,169.03466666666665,200.64,31.605333333333334,353,417,64,ki_chroma_acts_smoothed
493,1,0.0,7.4879999999999995,7.4879999999999995,0,16,16,chromagram
493,2,7.4879999999999995,22.368,14.879999999999999,16,47,31,chromagram
493,3,22.368,54.047999999999995,31.679999999999996,47,113,66,chromagram
493,4,54.047999999999995,85.728,31.68,113,179,66,chromagram
493,5,85.728,105.88799999999999,20.159999999999997,179,221,42,chromagram
493,6,105.88799999999999,121.24799999999999,15.36,221,253,32,chromagram
493,7,121.24799999999999,122.68799999999999,1.4399999999999977,253,256,3,chromagram
493,8,122.68799999999999,138.725,16.037000000000006,256,288,32,chromagram
493,1,0.0,7.968,7.968,0,17,17,chroma_acts
493,2,7.968,22.848,14.879999999999999,17,48,31,chroma_acts
493,3,22.848,54.047999999999995,31.199999999999996,48,113,65,chroma_acts
493,4,54.047999999999995,85.24799999999999,31.199999999999996,113,178,65,chroma_acts
493,5,85.24799999999999,105.88799999999999,20.64,178,221,43,chroma_acts
493,6,105.88799999999999,121.24799999999999,15.36,221,253,32,chroma_acts
493,7,121.24799999999999,122.68799999999999,1.4399999999999977,253,256,3,chroma_acts
493,8,122.68799999999999,138.725,16.037000000000006,256,288,32,chroma_acts
493,1,0.0,7.968,7.968,0,17,17,chroma_acts_smoothed
493,2,7.968,21.887999999999998,13.919999999999998,17,46,29,chroma_acts_smoothed
493,3,21.887999999999998,54.047999999999995,32.16,46,113,67,chroma_acts_smoothed
493,4,54.047999999999995,69.408,15.360000000000007,113,145,32,chroma_acts_smoothed
493,5,69.408,85.728,16.319999999999993,145,179,34,chroma_acts_smoothed
493,6,85.728,105.40799999999999,19.679999999999993,179,220,41,chroma_acts_smoothed
493,7,105.40799999999999,122.68799999999999,17.28,220,256,36,chroma_acts_smoothed
493,8,122.68799999999999,138.725,16.037000000000006,256,288,32,chroma_acts_smoothed
493,1,0.0,7.4879999999999995,7.4879999999999995,0,16,16,ki_chroma
493,2,7.4879999999999995,22.368,14.879999999999999,16,47,31,ki_chroma
493,3,22.368,54.047999999999995,31.679999999999996,47,113,66,ki_chroma
493,4,54.047999999999995,85.728,31.68,113,179,66,ki_chroma
493,5,85.728,105.88799999999999,20.159999999999997,179,221,42,ki_chroma
493,6,105.88799999999999,121.24799999999999,15.36,221,253,32,ki_chroma
493,7,121.24799999999999,122.68799999999999,1.4399999999999977,253,256,3,ki_chroma
493,8,122.68799999999999,138.725,16.037000000000006,256,288,32,ki_chroma
493,1,0.0,7.968,7.968,0,17,17,ki_chroma_acts
493,2,7.968,22.848,14.879999999999999,17,48,31,ki_chroma_acts
493,3,22.848,54.047999999999995,31.199999999999996,48,113,65,ki_chroma_acts
493,4,54.047999999999995,85.24799999999999,31.199999999999996,113,178,65,ki_chroma_acts
493,5,85.24799999999999,105.88799999999999,20.64,178,221,43,ki_chroma_acts
493,6,105.88799999999999,121.24799999999999,15.36,221,253,32,ki_chroma_acts
493,7,121.24799999999999,122.68799999999999,1.4399999999999977,253,256,3,ki_chroma_acts
493,8,122.68799999999999,138.725,16.037000000000006,256,288,32,ki_chroma_acts
493,1,0.0,7.968,7.968,0,17,17,ki_chroma_acts_smoothed
493,2,7.968,21.887999999999998,13.919999999999998,17,46,29,ki_chroma_acts_smoothed
493,3,21.887999999999998,54.047999999999995,32.16,46,113,67,ki_chroma_acts_smoothed
493,4,54.047999999999995,69.408,15.360000000000007,113,145,32,ki_chroma_acts_smoothed
493,5,69.408,85.728,16.319999999999993,145,179,34,ki_chroma_acts_smoothed
493,6,85.728,105.40799999999999,19.679999999999993,179,220,41,ki_chroma_acts_smoothed
493,7,105.40799999999999,122.68799999999999,17.28,220,256,36,ki_chroma_acts_smoothed
493,8,122.68799999999999,138.725,16.037000000000006,256,288,32,ki_chroma_acts_smoothed
494,1,0.0,29.674666666666663,29.674666666666663,0,64,64,chromagram
494,2,29.674666666666663,52.672000000000004,22.99733333333334,64,113,49,chromagram
494,3,52.672000000000004,67.69066666666667,15.018666666666668,113,145,32,chromagram
494,4,67.69066666666667,105.23733333333334,37.54666666666667,145,225,80,chromagram
494,5,105.23733333333334,187.83999999999997,82.60266666666664,225,401,176,chromagram
494,6,187.83999999999997,224.91733333333332,37.07733333333334,401,480,79,chromagram
494,7,224.91733333333332,292.5013333333333,67.584,480,624,144,chromagram
494,8,292.5013333333333,322.06933333333336,29.56800000000004,624,687,63,chromagram
494,9,322.06933333333336,357.226,35.15666666666664,687,760,73,chromagram
494,1,0.0,29.205333333333332,29.205333333333332,0,63,63,chroma_acts
494,2,29.205333333333332,52.672000000000004,23.466666666666672,63,113,50,chroma_acts
494,3,52.672000000000004,69.568,16.895999999999994,113,149,36,chroma_acts
494,4,69.568,105.23733333333334,35.66933333333334,149,225,76,chroma_acts
494,5,105.23733333333334,187.83999999999997,82.60266666666664,225,401,176,chroma_acts
494,6,187.83999999999997,223.04,35.20000000000002,401,476,75,chroma_acts
494,7,223.04,292.5013333333333,69.46133333333333,476,624,148,chroma_acts
494,8,292.5013333333333,322.06933333333336,29.56800000000004,624,687,63,chroma_acts
494,9,322.06933333333336,357.226,35.15666666666664,687,760,73,chroma_acts
494,1,0.0,29.205333333333332,29.205333333333332,0,63,63,chroma_acts_smoothed
494,2,29.205333333333332,52.202666666666666,22.997333333333334,63,112,49,chroma_acts_smoothed
494,3,52.202666666666666,69.568,17.365333333333332,112,149,37,chroma_acts_smoothed
494,4,69.568,103.36,33.792,149,221,72,chroma_acts_smoothed
494,5,103.36,176.10666666666665,72.74666666666666,221,376,155,chroma_acts_smoothed
494,6,176.10666666666665,223.04,46.93333333333334,376,476,100,chroma_acts_smoothed
494,7,223.04,292.5013333333333,69.46133333333333,476,624,148,chroma_acts_smoothed
494,8,292.5013333333333,322.5386666666667,30.03733333333338,624,688,64,chroma_acts_smoothed
494,9,322.5386666666667,357.226,34.6873333333333,688,760,72,chroma_acts_smoothed
494,1,0.0,29.674666666666663,29.674666666666663,0,64,64,ki_chroma
494,2,29.674666666666663,52.672000000000004,22.99733333333334,64,113,49,ki_chroma
494,3,52.672000000000004,67.69066666666667,15.018666666666668,113,145,32,ki_chroma
494,4,67.69066666666667,105.23733333333334,37.54666666666667,145,225,80,ki_chroma
494,5,105.23733333333334,187.83999999999997,82.60266666666664,225,401,176,ki_chroma
494,6,187.83999999999997,224.91733333333332,37.07733333333334,401,480,79,ki_chroma
494,7,224.91733333333332,292.5013333333333,67.584,480,624,144,ki_chroma
494,8,292.5013333333333,322.06933333333336,29.56800000000004,624,687,63,ki_chroma
494,9,322.06933333333336,357.226,35.15666666666664,687,760,73,ki_chroma
494,1,0.0,29.205333333333332,29.205333333333332,0,63,63,ki_chroma_acts
494,2,29.205333333333332,52.672000000000004,23.466666666666672,63,113,50,ki_chroma_acts
494,3,52.672000000000004,69.568,16.895999999999994,113,149,36,ki_chroma_acts
494,4,69.568,105.23733333333334,35.66933333333334,149,225,76,ki_chroma_acts
494,5,105.23733333333334,187.83999999999997,82.60266666666664,225,401,176,ki_chroma_acts
494,6,187.83999999999997,223.04,35.20000000000002,401,476,75,ki_chroma_acts
494,7,223.04,292.5013333333333,69.46133333333333,476,624,148,ki_chroma_acts
494,8,292.5013333333333,322.06933333333336,29.56800000000004,624,687,63,ki_chroma_acts
494,9,322.06933333333336,357.226,35.15666666666664,687,760,73,ki_chroma_acts
494,1,0.0,29.205333333333332,29.205333333333332,0,63,63,ki_chroma_acts_smoothed
494,2,29.205333333333332,52.202666666666666,22.997333333333334,63,112,49,ki_chroma_acts_smoothed
494,3,52.202666666666666,69.568,17.365333333333332,112,149,37,ki_chroma_acts_smoothed
494,4,69.568,103.36,33.792,149,221,72,ki_chroma_acts_smoothed
494,5,103.36,176.10666666666665,72.74666666666666,221,376,155,ki_chroma_acts_smoothed
494,6,176.10666666666665,223.04,46.93333333333334,376,476,100,ki_chroma_acts_smoothed
494,7,223.04,292.5013333333333,69.46133333333333,476,624,148,ki_chroma_acts_smoothed
494,8,292.5013333333333,322.5386666666667,30.03733333333338,624,688,64,ki_chroma_acts_smoothed
494,9,322.5386666666667,357.226,34.6873333333333,688,760,72,ki_chroma_acts_smoothed
498,1,0.0,11.573333333333332,11.573333333333332,0,25,25,chromagram
498,2,11.573333333333332,14.933333333333332,3.3599999999999994,25,32,7,chromagram
498,3,14.933333333333332,44.21333333333333,29.28,32,93,61,chromagram
498,4,44.21333333333333,74.93333333333332,30.71999999999999,93,157,64,chromagram
498,5,74.93333333333332,110.45333333333332,35.519999999999996,157,231,74,chromagram
498,6,110.45333333333332,135.41333333333333,24.960000000000008,231,283,52,chromagram
498,7,135.41333333333333,141.17333333333332,5.759999999999991,283,295,12,chromagram
498,8,141.17333333333332,183.724,42.55066666666667,295,382,87,chromagram
498,1,0.0,14.933333333333332,14.933333333333332,0,32,32,chroma_acts
498,2,14.933333333333332,44.21333333333333,29.28,32,93,61,chroma_acts
498,3,44.21333333333333,74.93333333333332,30.71999999999999,93,157,64,chroma_acts
498,4,74.93333333333332,97.49333333333333,22.560000000000002,157,204,47,chroma_acts
498,5,97.49333333333333,102.77333333333333,5.280000000000001,204,215,11,chroma_acts
498,6,102.77333333333333,105.17333333333333,2.4000000000000057,215,220,5,chroma_acts
498,7,105.17333333333333,133.01333333333332,27.83999999999999,220,278,58,chroma_acts
498,8,133.01333333333332,135.41333333333333,2.4000000000000057,278,283,5,chroma_acts
498,9,135.41333333333333,183.724,48.31066666666666,283,382,99,chroma_acts
498,1,0.0,11.093333333333332,11.093333333333332,0,24,24,chroma_acts_smoothed
498,2,11.093333333333332,13.973333333333333,2.880000000000001,24,30,6,chroma_acts_smoothed
498,3,13.973333333333333,44.21333333333333,30.24,30,93,63,chroma_acts_smoothed
498,4,44.21333333333333,74.45333333333333,30.240000000000002,93,156,63,chroma_acts_smoothed
498,5,74.45333333333333,105.17333333333333,30.72,156,220,64,chroma_acts_smoothed
498,6,105.17333333333333,133.01333333333332,27.83999999999999,220,278,58,chroma_acts_smoothed
498,7,133.01333333333332,135.41333333333333,2.4000000000000057,278,283,5,chroma_acts_smoothed
498,8,135.41333333333333,141.17333333333332,5.759999999999991,283,295,12,chroma_acts_smoothed
498,9,141.17333333333332,183.724,42.55066666666667,295,382,87,chroma_acts_smoothed
498,1,0.0,11.573333333333332,11.573333333333332,0,25,25,ki_chroma
498,2,11.573333333333332,14.933333333333332,3.3599999999999994,25,32,7,ki_chroma
498,3,14.933333333333332,44.21333333333333,29.28,32,93,61,ki_chroma
498,4,44.21333333333333,74.93333333333332,30.71999999999999,93,157,64,ki_chroma
498,5,74.93333333333332,110.45333333333332,35.519999999999996,157,231,74,ki_chroma
498,6,110.45333333333332,135.41333333333333,24.960000000000008,231,283,52,ki_chroma
498,7,135.41333333333333,141.17333333333332,5.759999999999991,283,295,12,ki_chroma
498,8,141.17333333333332,183.724,42.55066666666667,295,382,87,ki_chroma
498,1,0.0,14.933333333333332,14.933333333333332,0,32,32,ki_chroma_acts
498,2,14.933333333333332,44.21333333333333,29.28,32,93,61,ki_chroma_acts
498,3,44.21333333333333,74.93333333333332,30.71999999999999,93,157,64,ki_chroma_acts
498,4,74.93333333333332,97.49333333333333,22.560000000000002,157,204,47,ki_chroma_acts
498,5,97.49333333333333,102.77333333333333,5.280000000000001,204,215,11,ki_chroma_acts
498,6,102.77333333333333,105.17333333333333,2.4000000000000057,215,220,5,ki_chroma_acts
498,7,105.17333333333333,133.01333333333332,27.83999999999999,220,278,58,ki_chroma_acts
498,8,133.01333333333332,135.41333333333333,2.4000000000000057,278,283,5,ki_chroma_acts
498,9,135.41333333333333,183.724,48.31066666666666,283,382,99,ki_chroma_acts
498,1,0.0,11.093333333333332,11.093333333333332,0,24,24,ki_chroma_acts_smoothed
498,2,11.093333333333332,13.973333333333333,2.880000000000001,24,30,6,ki_chroma_acts_smoothed
498,3,13.973333333333333,44.21333333333333,30.24,30,93,63,ki_chroma_acts_smoothed
498,4,44.21333333333333,74.45333333333333,30.240000000000002,93,156,63,ki_chroma_acts_smoothed
498,5,74.45333333333333,105.17333333333333,30.72,156,220,64,ki_chroma_acts_smoothed
498,6,105.17333333333333,133.01333333333332,27.83999999999999,220,278,58,ki_chroma_acts_smoothed
498,7,133.01333333333332,135.41333333333333,2.4000000000000057,278,283,5,ki_chroma_acts_smoothed
498,8,135.41333333333333,141.17333333333332,5.759999999999991,283,295,12,ki_chroma_acts_smoothed
498,9,141.17333333333332,183.724,42.55066666666667,295,382,87,ki_chroma_acts_smoothed
499,1,0.0,30.410666666666664,30.410666666666664,0,64,64,chromagram
499,2,30.410666666666664,63.53066666666667,33.120000000000005,64,133,69,chromagram
499,3,63.53066666666667,77.93066666666665,14.399999999999984,133,163,30,chromagram
499,4,77.93066666666665,87.05066666666666,9.120000000000005,163,182,19,chromagram
499,5,87.05066666666666,91.37066666666666,4.320000000000007,182,191,9,chromagram
499,6,91.37066666666666,96.17066666666666,4.799999999999997,191,201,10,chromagram
499,7,96.17066666666666,168.538,72.36733333333335,201,350,149,chromagram
499,1,0.0,30.410666666666664,30.410666666666664,0,64,64,chroma_acts
499,2,30.410666666666664,63.53066666666667,33.120000000000005,64,133,69,chroma_acts
499,3,63.53066666666667,87.53066666666666,23.999999999999993,133,183,50,chroma_acts
499,4,87.53066666666666,91.37066666666666,3.8400000000000034,183,191,8,chroma_acts
499,5,91.37066666666666,96.17066666666666,4.799999999999997,191,201,10,chroma_acts
499,6,96.17066666666666,133.13066666666668,36.96000000000002,201,278,77,chroma_acts
499,7,133.13066666666668,168.538,35.40733333333333,278,350,72,chroma_acts
499,1,0.0,30.410666666666664,30.410666666666664,0,64,64,chroma_acts_smoothed
499,2,30.410666666666664,63.53066666666667,33.120000000000005,64,133,69,chroma_acts_smoothed
499,3,63.53066666666667,87.53066666666666,23.999999999999993,133,183,50,chroma_acts_smoothed
499,4,87.53066666666666,91.37066666666666,3.8400000000000034,183,191,8,chroma_acts_smoothed
499,5,91.37066666666666,96.17066666666666,4.799999999999997,191,201,10,chroma_acts_smoothed
499,6,96.17066666666666,128.33066666666667,32.16000000000001,201,268,67,chroma_acts_smoothed
499,7,128.33066666666667,168.538,40.20733333333334,268,350,82,chroma_acts_smoothed
499,1,0.0,30.410666666666664,30.410666666666664,0,64,64,ki_chroma
499,2,30.410666666666664,63.53066666666667,33.120000000000005,64,133,69,ki_chroma
499,3,63.53066666666667,77.93066666666665,14.399999999999984,133,163,30,ki_chroma
499,4,77.93066666666665,87.05066666666666,9.120000000000005,163,182,19,ki_chroma
499,5,87.05066666666666,91.37066666666666,4.320000000000007,182,191,9,ki_chroma
499,6,91.37066666666666,96.17066666666666,4.799999999999997,191,201,10,ki_chroma
499,7,96.17066666666666,168.538,72.36733333333335,201,350,149,ki_chroma
499,1,0.0,30.410666666666664,30.410666666666664,0,64,64,ki_chroma_acts
499,2,30.410666666666664,63.53066666666667,33.120000000000005,64,133,69,ki_chroma_acts
499,3,63.53066666666667,87.53066666666666,23.999999999999993,133,183,50,ki_chroma_acts
499,4,87.53066666666666,91.37066666666666,3.8400000000000034,183,191,8,ki_chroma_acts
499,5,91.37066666666666,96.17066666666666,4.799999999999997,191,201,10,ki_chroma_acts
499,6,96.17066666666666,133.13066666666668,36.96000000000002,201,278,77,ki_chroma_acts
499,7,133.13066666666668,168.538,35.40733333333333,278,350,72,ki_chroma_acts
499,1,0.0,30.410666666666664,30.410666666666664,0,64,64,ki_chroma_acts_smoothed
499,2,30.410666666666664,63.53066666666667,33.120000000000005,64,133,69,ki_chroma_acts_smoothed
499,3,63.53066666666667,87.53066666666666,23.999999999999993,133,183,50,ki_chroma_acts_smoothed
499,4,87.53066666666666,91.37066666666666,3.8400000000000034,183,191,8,ki_chroma_acts_smoothed
499,5,91.37066666666666,96.17066666666666,4.799999999999997,191,201,10,ki_chroma_acts_smoothed
499,6,96.17066666666666,128.33066666666667,32.16000000000001,201,268,67,ki_chroma_acts_smoothed
499,7,128.33066666666667,168.538,40.20733333333334,268,350,82,ki_chroma_acts_smoothed
501,1,0.0,24.981333333333332,24.981333333333332,0,54,54,chromagram
501,2,24.981333333333332,30.144,5.1626666666666665,54,65,11,chromagram
501,3,30.144,75.66933333333334,45.52533333333334,65,162,97,chromagram
501,4,75.66933333333334,88.34133333333334,12.671999999999997,162,189,27,chromagram
501,5,88.34133333333334,92.096,3.7546666666666653,189,197,8,chromagram
501,6,92.096,93.97333333333333,1.8773333333333255,197,201,4,chromagram
501,7,93.97333333333333,95.85066666666667,1.8773333333333397,201,205,4,chromagram
501,8,95.85066666666667,105.23733333333334,9.38666666666667,205,225,20,chromagram
501,9,105.23733333333334,165.219,59.981666666666655,225,351,126,chromagram
501,1,0.0,24.981333333333332,24.981333333333332,0,54,54,chroma_acts
501,2,24.981333333333332,30.144,5.1626666666666665,54,65,11,chroma_acts
501,3,30.144,75.66933333333334,45.52533333333334,65,162,97,chroma_acts
501,4,75.66933333333334,88.34133333333334,12.671999999999997,162,189,27,chroma_acts
501,5,88.34133333333334,92.096,3.7546666666666653,189,197,8,chroma_acts
501,6,92.096,93.97333333333333,1.8773333333333255,197,201,4,chroma_acts
501,7,93.97333333333333,95.85066666666667,1.8773333333333397,201,205,4,chroma_acts
501,8,95.85066666666667,105.23733333333334,9.38666666666667,205,225,20,chroma_acts
501,9,105.23733333333334,165.219,59.981666666666655,225,351,126,chroma_acts
501,1,0.0,24.981333333333332,24.981333333333332,0,54,54,chroma_acts_smoothed
501,2,24.981333333333332,30.144,5.1626666666666665,54,65,11,chroma_acts_smoothed
501,3,30.144,76.13866666666667,45.99466666666667,65,163,98,chroma_acts_smoothed
501,4,76.13866666666667,88.34133333333334,12.202666666666673,163,189,26,chroma_acts_smoothed
501,5,88.34133333333334,92.096,3.7546666666666653,189,197,8,chroma_acts_smoothed
501,6,92.096,101.48266666666667,9.38666666666667,197,217,20,chroma_acts_smoothed
501,7,101.48266666666667,103.36,1.8773333333333255,217,221,4,chroma_acts_smoothed
501,8,103.36,106.176,2.8160000000000025,221,227,6,chroma_acts_smoothed
501,9,106.176,165.219,59.04299999999999,227,351,124,chroma_acts_smoothed
501,1,0.0,24.981333333333332,24.981333333333332,0,54,54,ki_chroma
501,2,24.981333333333332,30.144,5.1626666666666665,54,65,11,ki_chroma
501,3,30.144,75.66933333333334,45.52533333333334,65,162,97,ki_chroma
501,4,75.66933333333334,88.34133333333334,12.671999999999997,162,189,27,ki_chroma
501,5,88.34133333333334,92.096,3.7546666666666653,189,197,8,ki_chroma
501,6,92.096,93.97333333333333,1.8773333333333255,197,201,4,ki_chroma
501,7,93.97333333333333,95.85066666666667,1.8773333333333397,201,205,4,ki_chroma
501,8,95.85066666666667,105.23733333333334,9.38666666666667,205,225,20,ki_chroma
501,9,105.23733333333334,165.219,59.981666666666655,225,351,126,ki_chroma
501,1,0.0,24.981333333333332,24.981333333333332,0,54,54,ki_chroma_acts
501,2,24.981333333333332,30.144,5.1626666666666665,54,65,11,ki_chroma_acts
501,3,30.144,75.66933333333334,45.52533333333334,65,162,97,ki_chroma_acts
501,4,75.66933333333334,88.34133333333334,12.671999999999997,162,189,27,ki_chroma_acts
501,5,88.34133333333334,92.096,3.7546666666666653,189,197,8,ki_chroma_acts
501,6,92.096,93.97333333333333,1.8773333333333255,197,201,4,ki_chroma_acts
501,7,93.97333333333333,95.85066666666667,1.8773333333333397,201,205,4,ki_chroma_acts
501,8,95.85066666666667,105.23733333333334,9.38666666666667,205,225,20,ki_chroma_acts
501,9,105.23733333333334,165.219,59.981666666666655,225,351,126,ki_chroma_acts
501,1,0.0,24.981333333333332,24.981333333333332,0,54,54,ki_chroma_acts_smoothed
501,2,24.981333333333332,30.144,5.1626666666666665,54,65,11,ki_chroma_acts_smoothed
501,3,30.144,76.13866666666667,45.99466666666667,65,163,98,ki_chroma_acts_smoothed
501,4,76.13866666666667,88.34133333333334,12.202666666666673,163,189,26,ki_chroma_acts_smoothed
501,5,88.34133333333334,92.096,3.7546666666666653,189,197,8,ki_chroma_acts_smoothed
501,6,92.096,101.48266666666667,9.38666666666667,197,217,20,ki_chroma_acts_smoothed
501,7,101.48266666666667,103.36,1.8773333333333255,217,221,4,ki_chroma_acts_smoothed
501,8,103.36,106.176,2.8160000000000025,221,227,6,ki_chroma_acts_smoothed
501,9,106.176,165.219,59.04299999999999,227,351,124,ki_chroma_acts_smoothed
502,1,0.0,7.477333333333334,7.477333333333334,0,11,11,chromagram
502,2,7.477333333333334,60.17066666666666,52.69333333333333,11,87,76,chromagram
502,3,60.17066666666666,89.984,29.813333333333333,87,130,43,chromagram
502,4,89.984,112.17066666666666,22.186666666666667,130,162,32,chromagram
502,5,112.17066666666666,119.104,6.933333333333337,162,172,10,chromagram
502,6,119.104,146.144,27.040000000000006,172,211,39,chromagram
502,7,146.144,164.864,18.72,211,238,27,chromagram
502,8,164.864,180.0,15.135999999999996,238,258,20,chromagram
502,1,0.0,7.477333333333334,7.477333333333334,0,11,11,chroma_acts
502,2,7.477333333333334,60.17066666666666,52.69333333333333,11,87,76,chroma_acts
502,3,60.17066666666666,89.984,29.813333333333333,87,130,43,chroma_acts
502,4,89.984,112.17066666666666,22.186666666666667,130,162,32,chroma_acts
502,5,112.17066666666666,119.79733333333333,7.626666666666665,162,173,11,chroma_acts
502,6,119.79733333333333,146.144,26.34666666666668,173,211,38,chroma_acts
502,7,146.144,164.864,18.72,211,238,27,chroma_acts
502,8,164.864,180.0,15.135999999999996,238,258,20,chroma_acts
502,1,0.0,7.477333333333334,7.477333333333334,0,11,11,chroma_acts_smoothed
502,2,7.477333333333334,60.864,53.38666666666666,11,88,77,chroma_acts_smoothed
502,3,60.864,89.984,29.119999999999997,88,130,42,chroma_acts_smoothed
502,4,89.984,112.17066666666666,22.186666666666667,130,162,32,chroma_acts_smoothed
502,5,112.17066666666666,119.104,6.933333333333337,162,172,10,chroma_acts_smoothed
502,6,119.104,146.144,27.040000000000006,172,211,39,chroma_acts_smoothed
502,7,146.144,165.55733333333336,19.413333333333355,211,239,28,chroma_acts_smoothed
502,8,165.55733333333336,180.0,14.44266666666664,239,258,19,chroma_acts_smoothed
502,1,0.0,7.477333333333334,7.477333333333334,0,11,11,ki_chroma
502,2,7.477333333333334,60.17066666666666,52.69333333333333,11,87,76,ki_chroma
502,3,60.17066666666666,89.984,29.813333333333333,87,130,43,ki_chroma
502,4,89.984,112.17066666666666,22.186666666666667,130,162,32,ki_chroma
502,5,112.17066666666666,119.104,6.933333333333337,162,172,10,ki_chroma
502,6,119.104,146.144,27.040000000000006,172,211,39,ki_chroma
502,7,146.144,164.864,18.72,211,238,27,ki_chroma
502,8,164.864,180.0,15.135999999999996,238,258,20,ki_chroma
502,1,0.0,7.477333333333334,7.477333333333334,0,11,11,ki_chroma_acts
502,2,7.477333333333334,60.17066666666666,52.69333333333333,11,87,76,ki_chroma_acts
502,3,60.17066666666666,89.984,29.813333333333333,87,130,43,ki_chroma_acts
502,4,89.984,112.17066666666666,22.186666666666667,130,162,32,ki_chroma_acts
502,5,112.17066666666666,119.79733333333333,7.626666666666665,162,173,11,ki_chroma_acts
502,6,119.79733333333333,146.144,26.34666666666668,173,211,38,ki_chroma_acts
502,7,146.144,164.864,18.72,211,238,27,ki_chroma_acts
502,8,164.864,180.0,15.135999999999996,238,258,20,ki_chroma_acts
502,1,0.0,7.477333333333334,7.477333333333334,0,11,11,ki_chroma_acts_smoothed
502,2,7.477333333333334,60.864,53.38666666666666,11,88,77,ki_chroma_acts_smoothed
502,3,60.864,89.984,29.119999999999997,88,130,42,ki_chroma_acts_smoothed
502,4,89.984,112.17066666666666,22.186666666666667,130,162,32,ki_chroma_acts_smoothed
502,5,112.17066666666666,119.104,6.933333333333337,162,172,10,ki_chroma_acts_smoothed
502,6,119.104,146.144,27.040000000000006,172,211,39,ki_chroma_acts_smoothed
502,7,146.144,165.55733333333336,19.413333333333355,211,239,28,ki_chroma_acts_smoothed
502,8,165.55733333333336,180.0,14.44266666666664,239,258,19,ki_chroma_acts_smoothed
504,1,0.0,9.504000000000001,9.504000000000001,0,20,20,chromagram
504,2,9.504000000000001,21.024,11.52,20,44,24,chromagram
504,3,21.024,24.384,3.3599999999999994,44,51,7,chromagram
504,4,24.384,53.184,28.799999999999997,51,111,60,chromagram
504,5,53.184,69.98400000000001,16.80000000000001,111,146,35,chromagram
504,6,69.98400000000001,101.184,31.19999999999999,146,211,65,chromagram
504,7,101.184,144.864,43.68000000000001,211,302,91,chromagram
504,8,144.864,146.304,1.4399999999999977,302,305,3,chromagram
504,9,146.304,193.753,47.448999999999984,305,402,97,chromagram
504,1,0.0,21.024,21.024,0,44,44,chroma_acts
504,2,21.024,24.864,3.84,44,52,8,chroma_acts
504,3,24.864,53.184,28.319999999999997,52,111,59,chroma_acts
504,4,53.184,69.504,16.320000000000007,111,145,34,chroma_acts
504,5,69.504,101.184,31.679999999999993,145,211,66,chroma_acts
504,6,101.184,131.904,30.72,211,275,64,chroma_acts
504,7,131.904,146.784,14.879999999999995,275,306,31,chroma_acts
504,8,146.784,193.753,46.968999999999994,306,402,96,chroma_acts
504,1,0.0,21.024,21.024,0,44,44,chroma_acts_smoothed
504,2,21.024,24.864,3.84,44,52,8,chroma_acts_smoothed
504,3,24.864,53.184,28.319999999999997,52,111,59,chroma_acts_smoothed
504,4,53.184,69.98400000000001,16.80000000000001,111,146,35,chroma_acts_smoothed
504,5,69.98400000000001,101.184,31.19999999999999,146,211,65,chroma_acts_smoothed
504,6,101.184,131.904,30.72,211,275,64,chroma_acts_smoothed
504,7,131.904,146.784,14.879999999999995,275,306,31,chroma_acts_smoothed
504,8,146.784,193.753,46.968999999999994,306,402,96,chroma_acts_smoothed
504,1,0.0,9.504000000000001,9.504000000000001,0,20,20,ki_chroma
504,2,9.504000000000001,21.024,11.52,20,44,24,ki_chroma
504,3,21.024,24.384,3.3599999999999994,44,51,7,ki_chroma
504,4,24.384,53.184,28.799999999999997,51,111,60,ki_chroma
504,5,53.184,69.98400000000001,16.80000000000001,111,146,35,ki_chroma
504,6,69.98400000000001,101.184,31.19999999999999,146,211,65,ki_chroma
504,7,101.184,144.864,43.68000000000001,211,302,91,ki_chroma
504,8,144.864,146.304,1.4399999999999977,302,305,3,ki_chroma
504,9,146.304,193.753,47.448999999999984,305,402,97,ki_chroma
504,1,0.0,21.024,21.024,0,44,44,ki_chroma_acts
504,2,21.024,24.864,3.84,44,52,8,ki_chroma_acts
504,3,24.864,53.184,28.319999999999997,52,111,59,ki_chroma_acts
504,4,53.184,69.504,16.320000000000007,111,145,34,ki_chroma_acts
504,5,69.504,101.184,31.679999999999993,145,211,66,ki_chroma_acts
504,6,101.184,131.904,30.72,211,275,64,ki_chroma_acts
504,7,131.904,146.784,14.879999999999995,275,306,31,ki_chroma_acts
504,8,146.784,193.753,46.968999999999994,306,402,96,ki_chroma_acts
504,1,0.0,21.024,21.024,0,44,44,ki_chroma_acts_smoothed
504,2,21.024,24.864,3.84,44,52,8,ki_chroma_acts_smoothed
504,3,24.864,53.184,28.319999999999997,52,111,59,ki_chroma_acts_smoothed
504,4,53.184,69.98400000000001,16.80000000000001,111,146,35,ki_chroma_acts_smoothed
504,5,69.98400000000001,101.184,31.19999999999999,146,211,65,ki_chroma_acts_smoothed
504,6,101.184,131.904,30.72,211,275,64,ki_chroma_acts_smoothed
504,7,131.904,146.784,14.879999999999995,275,306,31,ki_chroma_acts_smoothed
504,8,146.784,193.753,46.968999999999994,306,402,96,ki_chroma_acts_smoothed
507,1,0.0,22.656000000000002,22.656000000000002,0,54,54,chromagram
507,2,22.656000000000002,42.70933333333333,20.05333333333333,54,101,47,chromagram
507,3,42.70933333333333,47.40266666666667,4.693333333333335,101,112,11,chromagram
507,4,47.40266666666667,68.30933333333334,20.906666666666673,112,161,49,chromagram
507,5,68.30933333333334,97.32266666666668,29.013333333333335,161,229,68,chromagram
507,6,97.32266666666668,116.94933333333334,19.626666666666665,229,275,46,chromagram
507,7,116.94933333333334,129.74933333333334,12.799999999999997,275,305,30,chromagram
507,8,129.74933333333334,213.376,83.62666666666667,305,501,196,chromagram
507,9,213.376,222.194,8.817999999999984,501,520,19,chromagram
507,1,0.0,27.349333333333337,27.349333333333337,0,65,65,chroma_acts
507,2,27.349333333333337,42.70933333333333,15.359999999999996,65,101,36,chroma_acts
507,3,42.70933333333333,47.40266666666667,4.693333333333335,101,112,11,chroma_acts
507,4,47.40266666666667,49.96266666666667,2.5600000000000023,112,118,6,chroma_acts
507,5,49.96266666666667,67.456,17.493333333333332,118,159,41,chroma_acts
507,6,67.456,97.32266666666668,29.866666666666674,159,229,70,chroma_acts
507,7,97.32266666666668,129.74933333333334,32.42666666666666,229,305,76,chroma_acts
507,8,129.74933333333334,206.54933333333335,76.80000000000001,305,485,180,chroma_acts
507,9,206.54933333333335,222.194,15.644666666666637,485,520,35,chroma_acts
507,1,0.0,27.349333333333337,27.349333333333337,0,65,65,chroma_acts_smoothed
507,2,27.349333333333337,42.70933333333333,15.359999999999996,65,101,36,chroma_acts_smoothed
507,3,42.70933333333333,46.976,4.266666666666666,101,111,10,chroma_acts_smoothed
507,4,46.976,67.88266666666668,20.90666666666668,111,160,49,chroma_acts_smoothed
507,5,67.88266666666668,97.32266666666668,29.439999999999998,160,229,69,chroma_acts_smoothed
507,6,97.32266666666668,116.52266666666668,19.200000000000003,229,274,45,chroma_acts_smoothed
507,7,116.52266666666668,129.74933333333334,13.22666666666666,274,305,31,chroma_acts_smoothed
507,8,129.74933333333334,206.54933333333335,76.80000000000001,305,485,180,chroma_acts_smoothed
507,9,206.54933333333335,222.194,15.644666666666637,485,520,35,chroma_acts_smoothed
507,1,0.0,22.656000000000002,22.656000000000002,0,54,54,ki_chroma
507,2,22.656000000000002,42.70933333333333,20.05333333333333,54,101,47,ki_chroma
507,3,42.70933333333333,47.40266666666667,4.693333333333335,101,112,11,ki_chroma
507,4,47.40266666666667,68.30933333333334,20.906666666666673,112,161,49,ki_chroma
507,5,68.30933333333334,97.32266666666668,29.013333333333335,161,229,68,ki_chroma
507,6,97.32266666666668,116.94933333333334,19.626666666666665,229,275,46,ki_chroma
507,7,116.94933333333334,129.74933333333334,12.799999999999997,275,305,30,ki_chroma
507,8,129.74933333333334,213.376,83.62666666666667,305,501,196,ki_chroma
507,9,213.376,222.194,8.817999999999984,501,520,19,ki_chroma
507,1,0.0,27.349333333333337,27.349333333333337,0,65,65,ki_chroma_acts
507,2,27.349333333333337,42.70933333333333,15.359999999999996,65,101,36,ki_chroma_acts
507,3,42.70933333333333,47.40266666666667,4.693333333333335,101,112,11,ki_chroma_acts
507,4,47.40266666666667,49.96266666666667,2.5600000000000023,112,118,6,ki_chroma_acts
507,5,49.96266666666667,67.456,17.493333333333332,118,159,41,ki_chroma_acts
507,6,67.456,97.32266666666668,29.866666666666674,159,229,70,ki_chroma_acts
507,7,97.32266666666668,129.74933333333334,32.42666666666666,229,305,76,ki_chroma_acts
507,8,129.74933333333334,206.54933333333335,76.80000000000001,305,485,180,ki_chroma_acts
507,9,206.54933333333335,222.194,15.644666666666637,485,520,35,ki_chroma_acts
507,1,0.0,27.349333333333337,27.349333333333337,0,65,65,ki_chroma_acts_smoothed
507,2,27.349333333333337,42.70933333333333,15.359999999999996,65,101,36,ki_chroma_acts_smoothed
507,3,42.70933333333333,46.976,4.266666666666666,101,111,10,ki_chroma_acts_smoothed
507,4,46.976,67.88266666666668,20.90666666666668,111,160,49,ki_chroma_acts_smoothed
507,5,67.88266666666668,97.32266666666668,29.439999999999998,160,229,69,ki_chroma_acts_smoothed
507,6,97.32266666666668,116.52266666666668,19.200000000000003,229,274,45,ki_chroma_acts_smoothed
507,7,116.52266666666668,129.74933333333334,13.22666666666666,274,305,31,ki_chroma_acts_smoothed
507,8,129.74933333333334,206.54933333333335,76.80000000000001,305,485,180,ki_chroma_acts_smoothed
507,9,206.54933333333335,222.194,15.644666666666637,485,520,35,ki_chroma_acts_smoothed
508,1,0.0,41.056,41.056,0,97,97,chromagram
508,2,41.056,66.656,25.60000000000001,97,157,60,chromagram
508,3,66.656,83.29599999999999,16.639999999999986,157,196,39,chromagram
508,4,83.29599999999999,93.96266666666668,10.666666666666686,196,221,25,chromagram
508,5,93.96266666666668,97.376,3.413333333333327,221,229,8,chromagram
508,6,97.376,107.61600000000001,10.240000000000009,229,253,24,chromagram
508,7,107.61600000000001,137.056,29.439999999999998,253,322,69,chromagram
508,8,137.056,176.30933333333334,39.25333333333333,322,414,92,chromagram
508,9,176.30933333333334,191.822,15.51266666666666,414,449,35,chromagram
508,1,0.0,7.775999999999999,7.775999999999999,0,19,19,chroma_acts
508,2,7.775999999999999,11.616,3.8400000000000007,19,28,9,chroma_acts
508,3,11.616,21.429333333333332,9.813333333333333,28,51,23,chroma_acts
508,4,21.429333333333332,25.269333333333336,3.8400000000000034,51,60,9,chroma_acts
508,5,25.269333333333336,35.08266666666667,9.813333333333333,60,83,23,chroma_acts
508,6,35.08266666666667,39.349333333333334,4.266666666666666,83,93,10,chroma_acts
508,7,39.349333333333334,107.61600000000001,68.26666666666668,93,253,160,chroma_acts
508,8,107.61600000000001,137.056,29.439999999999998,253,322,69,chroma_acts
508,9,137.056,191.822,54.76599999999999,322,449,127,chroma_acts
508,1,0.0,7.775999999999999,7.775999999999999,0,19,19,chroma_acts_smoothed
508,2,7.775999999999999,21.429333333333332,13.653333333333332,19,51,32,chroma_acts_smoothed
508,3,21.429333333333332,25.269333333333336,3.8400000000000034,51,60,9,chroma_acts_smoothed
508,4,25.269333333333336,35.08266666666667,9.813333333333333,60,83,23,chroma_acts_smoothed
508,5,35.08266666666667,39.349333333333334,4.266666666666666,83,93,10,chroma_acts_smoothed
508,6,39.349333333333334,107.61600000000001,68.26666666666668,93,253,160,chroma_acts_smoothed
508,7,107.61600000000001,137.48266666666666,29.866666666666646,253,323,70,chroma_acts_smoothed
508,8,137.48266666666666,176.30933333333334,38.82666666666668,323,414,91,chroma_acts_smoothed
508,9,176.30933333333334,191.822,15.51266666666666,414,449,35,chroma_acts_smoothed
508,1,0.0,41.056,41.056,0,97,97,ki_chroma
508,2,41.056,66.656,25.60000000000001,97,157,60,ki_chroma
508,3,66.656,83.29599999999999,16.639999999999986,157,196,39,ki_chroma
508,4,83.29599999999999,93.96266666666668,10.666666666666686,196,221,25,ki_chroma
508,5,93.96266666666668,97.376,3.413333333333327,221,229,8,ki_chroma
508,6,97.376,107.61600000000001,10.240000000000009,229,253,24,ki_chroma
508,7,107.61600000000001,137.056,29.439999999999998,253,322,69,ki_chroma
508,8,137.056,176.30933333333334,39.25333333333333,322,414,92,ki_chroma
508,9,176.30933333333334,191.822,15.51266666666666,414,449,35,ki_chroma
508,1,0.0,7.775999999999999,7.775999999999999,0,19,19,ki_chroma_acts
508,2,7.775999999999999,11.616,3.8400000000000007,19,28,9,ki_chroma_acts
508,3,11.616,21.429333333333332,9.813333333333333,28,51,23,ki_chroma_acts
508,4,21.429333333333332,25.269333333333336,3.8400000000000034,51,60,9,ki_chroma_acts
508,5,25.269333333333336,35.08266666666667,9.813333333333333,60,83,23,ki_chroma_acts
508,6,35.08266666666667,39.349333333333334,4.266666666666666,83,93,10,ki_chroma_acts
508,7,39.349333333333334,107.61600000000001,68.26666666666668,93,253,160,ki_chroma_acts
508,8,107.61600000000001,137.056,29.439999999999998,253,322,69,ki_chroma_acts
508,9,137.056,191.822,54.76599999999999,322,449,127,ki_chroma_acts
508,1,0.0,7.775999999999999,7.775999999999999,0,19,19,ki_chroma_acts_smoothed
508,2,7.775999999999999,21.429333333333332,13.653333333333332,19,51,32,ki_chroma_acts_smoothed
508,3,21.429333333333332,25.269333333333336,3.8400000000000034,51,60,9,ki_chroma_acts_smoothed
508,4,25.269333333333336,35.08266666666667,9.813333333333333,60,83,23,ki_chroma_acts_smoothed
508,5,35.08266666666667,39.349333333333334,4.266666666666666,83,93,10,ki_chroma_acts_smoothed
508,6,39.349333333333334,107.61600000000001,68.26666666666668,93,253,160,ki_chroma_acts_smoothed
508,7,107.61600000000001,137.48266666666666,29.866666666666646,253,323,70,ki_chroma_acts_smoothed
508,8,137.48266666666666,176.30933333333334,38.82666666666668,323,414,91,ki_chroma_acts_smoothed
508,9,176.30933333333334,191.822,15.51266666666666,414,449,35,ki_chroma_acts_smoothed
509,1,0.0,27.146666666666665,27.146666666666665,0,64,64,chromagram
509,2,27.146666666666665,79.62666666666667,52.480000000000004,64,187,123,chromagram
509,3,79.62666666666667,101.38666666666667,21.760000000000005,187,238,51,chromagram
509,4,101.38666666666667,134.24,32.85333333333334,238,315,77,chromagram
509,5,134.24,141.92000000000002,7.680000000000007,315,333,18,chromagram
509,6,141.92000000000002,148.32,6.399999999999977,333,348,15,chromagram
509,7,148.32,155.57333333333335,7.253333333333359,348,365,17,chromagram
509,8,155.57333333333335,202.5066666666667,46.93333333333334,365,475,110,chromagram
509,9,202.5066666666667,217.0,14.493333333333311,475,507,32,chromagram
509,1,0.0,25.013333333333332,25.013333333333332,0,59,59,chroma_acts
509,2,25.013333333333332,53.6,28.58666666666667,59,126,67,chroma_acts
509,3,53.6,67.68,14.080000000000005,126,159,33,chroma_acts
509,4,67.68,79.62666666666667,11.946666666666658,159,187,28,chroma_acts
509,5,79.62666666666667,101.38666666666667,21.760000000000005,187,238,51,chroma_acts
509,6,101.38666666666667,134.24,32.85333333333334,238,315,77,chroma_acts
509,7,134.24,141.92000000000002,7.680000000000007,315,333,18,chroma_acts
509,8,141.92000000000002,202.5066666666667,60.58666666666667,333,475,142,chroma_acts
509,9,202.5066666666667,217.0,14.493333333333311,475,507,32,chroma_acts
509,1,0.0,25.439999999999998,25.439999999999998,0,60,60,chroma_acts_smoothed
509,2,25.439999999999998,53.6,28.160000000000004,60,126,66,chroma_acts_smoothed
509,3,53.6,68.10666666666667,14.506666666666668,126,160,34,chroma_acts_smoothed
509,4,68.10666666666667,80.05333333333334,11.946666666666673,160,188,28,chroma_acts_smoothed
509,5,80.05333333333334,101.38666666666667,21.33333333333333,188,238,50,chroma_acts_smoothed
509,6,101.38666666666667,134.24,32.85333333333334,238,315,77,chroma_acts_smoothed
509,7,134.24,155.57333333333335,21.333333333333343,315,365,50,chroma_acts_smoothed
509,8,155.57333333333335,202.08,46.50666666666666,365,474,109,chroma_acts_smoothed
509,9,202.08,217.0,14.919999999999987,474,507,33,chroma_acts_smoothed
509,1,0.0,27.146666666666665,27.146666666666665,0,64,64,ki_chroma
509,2,27.146666666666665,79.62666666666667,52.480000000000004,64,187,123,ki_chroma
509,3,79.62666666666667,101.38666666666667,21.760000000000005,187,238,51,ki_chroma
509,4,101.38666666666667,134.24,32.85333333333334,238,315,77,ki_chroma
509,5,134.24,141.92000000000002,7.680000000000007,315,333,18,ki_chroma
509,6,141.92000000000002,148.32,6.399999999999977,333,348,15,ki_chroma
509,7,148.32,155.57333333333335,7.253333333333359,348,365,17,ki_chroma
509,8,155.57333333333335,202.5066666666667,46.93333333333334,365,475,110,ki_chroma
509,9,202.5066666666667,217.0,14.493333333333311,475,507,32,ki_chroma
509,1,0.0,25.013333333333332,25.013333333333332,0,59,59,ki_chroma_acts
509,2,25.013333333333332,53.6,28.58666666666667,59,126,67,ki_chroma_acts
509,3,53.6,67.68,14.080000000000005,126,159,33,ki_chroma_acts
509,4,67.68,79.62666666666667,11.946666666666658,159,187,28,ki_chroma_acts
509,5,79.62666666666667,101.38666666666667,21.760000000000005,187,238,51,ki_chroma_acts
509,6,101.38666666666667,134.24,32.85333333333334,238,315,77,ki_chroma_acts
509,7,134.24,141.92000000000002,7.680000000000007,315,333,18,ki_chroma_acts
509,8,141.92000000000002,202.5066666666667,60.58666666666667,333,475,142,ki_chroma_acts
509,9,202.5066666666667,217.0,14.493333333333311,475,507,32,ki_chroma_acts
509,1,0.0,25.439999999999998,25.439999999999998,0,60,60,ki_chroma_acts_smoothed
509,2,25.439999999999998,53.6,28.160000000000004,60,126,66,ki_chroma_acts_smoothed
509,3,53.6,68.10666666666667,14.506666666666668,126,160,34,ki_chroma_acts_smoothed
509,4,68.10666666666667,80.05333333333334,11.946666666666673,160,188,28,ki_chroma_acts_smoothed
509,5,80.05333333333334,101.38666666666667,21.33333333333333,188,238,50,ki_chroma_acts_smoothed
509,6,101.38666666666667,134.24,32.85333333333334,238,315,77,ki_chroma_acts_smoothed
509,7,134.24,155.57333333333335,21.333333333333343,315,365,50,ki_chroma_acts_smoothed
509,8,155.57333333333335,202.08,46.50666666666666,365,474,109,ki_chroma_acts_smoothed
509,9,202.08,217.0,14.919999999999987,474,507,33,ki_chroma_acts_smoothed
510,1,0.0,4.6080000000000005,4.6080000000000005,0,10,10,chromagram
510,2,4.6080000000000005,15.872,11.264,10,34,24,chromagram
510,3,15.872,29.013333333333332,13.141333333333332,34,62,28,chromagram
510,4,29.013333333333332,75.94666666666667,46.93333333333334,62,162,100,chromagram
510,5,75.94666666666667,85.33333333333333,9.386666666666656,162,182,20,chromagram
510,6,85.33333333333333,98.47466666666666,13.141333333333336,182,210,28,chromagram
510,7,98.47466666666666,126.63466666666666,28.159999999999997,210,270,60,chromagram
510,8,126.63466666666666,174.866,48.23133333333335,270,371,101,chromagram
510,1,0.0,4.6080000000000005,4.6080000000000005,0,10,10,chroma_acts
510,2,4.6080000000000005,6.485333333333333,1.8773333333333326,10,14,4,chroma_acts
510,3,6.485333333333333,8.362666666666666,1.8773333333333326,14,18,4,chroma_acts
510,4,8.362666666666666,10.24,1.8773333333333344,18,22,4,chroma_acts
510,5,10.24,29.013333333333332,18.773333333333333,22,62,40,chroma_acts
510,6,29.013333333333332,76.416,47.40266666666666,62,163,101,chroma_acts
510,7,76.416,126.63466666666666,50.218666666666664,163,270,107,chroma_acts
510,8,126.63466666666666,174.866,48.23133333333335,270,371,101,chroma_acts
510,1,0.0,13.994666666666667,13.994666666666667,0,30,30,chroma_acts_smoothed
510,2,13.994666666666667,15.872,1.8773333333333326,30,34,4,chroma_acts_smoothed
510,3,15.872,29.013333333333332,13.141333333333332,34,62,28,chroma_acts_smoothed
510,4,29.013333333333332,75.47733333333333,46.464,62,161,99,chroma_acts_smoothed
510,5,75.47733333333333,85.33333333333333,9.855999999999995,161,182,21,chroma_acts_smoothed
510,6,85.33333333333333,124.288,38.95466666666667,182,265,83,chroma_acts_smoothed
510,7,124.288,126.63466666666666,2.346666666666664,265,270,5,chroma_acts_smoothed
510,8,126.63466666666666,174.866,48.23133333333335,270,371,101,chroma_acts_smoothed
510,1,0.0,4.6080000000000005,4.6080000000000005,0,10,10,ki_chroma
510,2,4.6080000000000005,15.872,11.264,10,34,24,ki_chroma
510,3,15.872,29.013333333333332,13.141333333333332,34,62,28,ki_chroma
510,4,29.013333333333332,75.94666666666667,46.93333333333334,62,162,100,ki_chroma
510,5,75.94666666666667,85.33333333333333,9.386666666666656,162,182,20,ki_chroma
510,6,85.33333333333333,98.47466666666666,13.141333333333336,182,210,28,ki_chroma
510,7,98.47466666666666,126.63466666666666,28.159999999999997,210,270,60,ki_chroma
510,8,126.63466666666666,174.866,48.23133333333335,270,371,101,ki_chroma
510,1,0.0,4.6080000000000005,4.6080000000000005,0,10,10,ki_chroma_acts
510,2,4.6080000000000005,6.485333333333333,1.8773333333333326,10,14,4,ki_chroma_acts
510,3,6.485333333333333,8.362666666666666,1.8773333333333326,14,18,4,ki_chroma_acts
510,4,8.362666666666666,10.24,1.8773333333333344,18,22,4,ki_chroma_acts
510,5,10.24,29.013333333333332,18.773333333333333,22,62,40,ki_chroma_acts
510,6,29.013333333333332,76.416,47.40266666666666,62,163,101,ki_chroma_acts
510,7,76.416,126.63466666666666,50.218666666666664,163,270,107,ki_chroma_acts
510,8,126.63466666666666,174.866,48.23133333333335,270,371,101,ki_chroma_acts
510,1,0.0,13.994666666666667,13.994666666666667,0,30,30,ki_chroma_acts_smoothed
510,2,13.994666666666667,15.872,1.8773333333333326,30,34,4,ki_chroma_acts_smoothed
510,3,15.872,29.013333333333332,13.141333333333332,34,62,28,ki_chroma_acts_smoothed
510,4,29.013333333333332,75.47733333333333,46.464,62,161,99,ki_chroma_acts_smoothed
510,5,75.47733333333333,85.33333333333333,9.855999999999995,161,182,21,ki_chroma_acts_smoothed
510,6,85.33333333333333,124.288,38.95466666666667,182,265,83,ki_chroma_acts_smoothed
510,7,124.288,126.63466666666666,2.346666666666664,265,270,5,ki_chroma_acts_smoothed
510,8,126.63466666666666,174.866,48.23133333333335,270,371,101,ki_chroma_acts_smoothed
511,1,0.0,15.338666666666667,15.338666666666667,0,33,33,chromagram
511,2,15.338666666666667,30.357333333333333,15.018666666666666,33,65,32,chromagram
511,3,30.357333333333333,44.906666666666666,14.549333333333333,65,96,31,chromagram
511,4,44.906666666666666,90.43199999999999,45.52533333333332,96,193,97,chromagram
511,5,90.43199999999999,120.46933333333332,30.037333333333336,193,257,64,chromagram
511,6,120.46933333333332,129.38666666666666,8.917333333333332,257,276,19,chromagram
511,7,129.38666666666666,133.61066666666665,4.2239999999999895,276,285,9,chromagram
511,8,133.61066666666665,142.99733333333333,9.386666666666684,285,305,20,chromagram
511,9,142.99733333333333,196.939,53.94166666666666,305,418,113,chromagram
511,1,0.0,16.746666666666666,16.746666666666666,0,36,36,chroma_acts
511,2,16.746666666666666,30.357333333333333,13.610666666666667,36,65,29,chroma_acts
511,3,30.357333333333333,42.090666666666664,11.73333333333333,65,90,25,chroma_acts
511,4,42.090666666666664,90.43199999999999,48.341333333333324,90,193,103,chroma_acts
511,5,90.43199999999999,118.12266666666666,27.690666666666672,193,252,59,chroma_acts
511,6,118.12266666666666,129.38666666666666,11.263999999999996,252,276,24,chroma_acts
511,7,129.38666666666666,133.14133333333334,3.7546666666666795,276,284,8,chroma_acts
511,8,133.14133333333334,149.09866666666665,15.95733333333331,284,318,34,chroma_acts
511,9,149.09866666666665,196.939,47.84033333333335,318,418,100,chroma_acts
511,1,0.0,17.216,17.216,0,37,37,chroma_acts_smoothed
511,2,17.216,30.357333333333333,13.141333333333332,37,65,28,chroma_acts_smoothed
511,3,30.357333333333333,44.437333333333335,14.080000000000002,65,95,30,chroma_acts_smoothed
511,4,44.437333333333335,90.43199999999999,45.99466666666665,95,193,98,chroma_acts_smoothed
511,5,90.43199999999999,118.12266666666666,27.690666666666672,193,252,59,chroma_acts_smoothed
511,6,118.12266666666666,129.38666666666666,11.263999999999996,252,276,24,chroma_acts_smoothed
511,7,129.38666666666666,133.14133333333334,3.7546666666666795,276,284,8,chroma_acts_smoothed
511,8,133.14133333333334,148.62933333333334,15.488,284,317,33,chroma_acts_smoothed
511,9,148.62933333333334,196.939,48.30966666666666,317,418,101,chroma_acts_smoothed
511,1,0.0,15.338666666666667,15.338666666666667,0,33,33,ki_chroma
511,2,15.338666666666667,30.357333333333333,15.018666666666666,33,65,32,ki_chroma
511,3,30.357333333333333,44.906666666666666,14.549333333333333,65,96,31,ki_chroma
511,4,44.906666666666666,90.43199999999999,45.52533333333332,96,193,97,ki_chroma
511,5,90.43199999999999,120.46933333333332,30.037333333333336,193,257,64,ki_chroma
511,6,120.46933333333332,129.38666666666666,8.917333333333332,257,276,19,ki_chroma
511,7,129.38666666666666,133.61066666666665,4.2239999999999895,276,285,9,ki_chroma
511,8,133.61066666666665,142.99733333333333,9.386666666666684,285,305,20,ki_chroma
511,9,142.99733333333333,196.939,53.94166666666666,305,418,113,ki_chroma
511,1,0.0,16.746666666666666,16.746666666666666,0,36,36,ki_chroma_acts
511,2,16.746666666666666,30.357333333333333,13.610666666666667,36,65,29,ki_chroma_acts
511,3,30.357333333333333,42.090666666666664,11.73333333333333,65,90,25,ki_chroma_acts
511,4,42.090666666666664,90.43199999999999,48.341333333333324,90,193,103,ki_chroma_acts
511,5,90.43199999999999,118.12266666666666,27.690666666666672,193,252,59,ki_chroma_acts
511,6,118.12266666666666,129.38666666666666,11.263999999999996,252,276,24,ki_chroma_acts
511,7,129.38666666666666,133.14133333333334,3.7546666666666795,276,284,8,ki_chroma_acts
511,8,133.14133333333334,149.09866666666665,15.95733333333331,284,318,34,ki_chroma_acts
511,9,149.09866666666665,196.939,47.84033333333335,318,418,100,ki_chroma_acts
511,1,0.0,17.216,17.216,0,37,37,ki_chroma_acts_smoothed
511,2,17.216,30.357333333333333,13.141333333333332,37,65,28,ki_chroma_acts_smoothed
511,3,30.357333333333333,44.437333333333335,14.080000000000002,65,95,30,ki_chroma_acts_smoothed
511,4,44.437333333333335,90.43199999999999,45.99466666666665,95,193,98,ki_chroma_acts_smoothed
511,5,90.43199999999999,118.12266666666666,27.690666666666672,193,252,59,ki_chroma_acts_smoothed
511,6,118.12266666666666,129.38666666666666,11.263999999999996,252,276,24,ki_chroma_acts_smoothed
511,7,129.38666666666666,133.14133333333334,3.7546666666666795,276,284,8,ki_chroma_acts_smoothed
511,8,133.14133333333334,148.62933333333334,15.488,284,317,33,ki_chroma_acts_smoothed
511,9,148.62933333333334,196.939,48.30966666666666,317,418,101,ki_chroma_acts_smoothed
512,1,0.0,6.122666666666667,6.122666666666667,0,16,16,chromagram
512,2,6.122666666666667,51.52,45.397333333333336,16,128,112,chromagram
512,3,51.52,57.6,6.079999999999998,128,143,15,chromagram
512,4,57.6,84.35200000000002,26.752000000000017,143,209,66,chromagram
512,5,84.35200000000002,108.26666666666668,23.914666666666662,209,268,59,chromagram
512,6,108.26666666666668,128.53333333333336,20.26666666666668,268,318,50,chromagram
512,7,128.53333333333336,134.208,5.6746666666666385,318,332,14,chromagram
512,8,134.208,160.14933333333335,25.941333333333347,332,396,64,chromagram
512,9,160.14933333333335,211.2,51.05066666666664,396,520,124,chromagram
512,1,0.0,6.122666666666667,6.122666666666667,0,16,16,chroma_acts
512,2,6.122666666666667,45.03466666666667,38.912000000000006,16,112,96,chroma_acts
512,3,45.03466666666667,51.52,6.48533333333333,112,128,16,chroma_acts
512,4,51.52,57.6,6.079999999999998,128,143,15,chroma_acts
512,5,57.6,108.26666666666668,50.66666666666668,143,268,125,chroma_acts
512,6,108.26666666666668,128.53333333333336,20.26666666666668,268,318,50,chroma_acts
512,7,128.53333333333336,134.208,5.6746666666666385,318,332,14,chroma_acts
512,8,134.208,160.14933333333335,25.941333333333347,332,396,64,chroma_acts
512,9,160.14933333333335,211.2,51.05066666666664,396,520,124,chroma_acts
512,1,0.0,5.717333333333334,5.717333333333334,0,15,15,chroma_acts_smoothed
512,2,5.717333333333334,51.52,45.80266666666667,15,128,113,chroma_acts_smoothed
512,3,51.52,57.19466666666667,5.674666666666667,128,142,14,chroma_acts_smoothed
512,4,57.19466666666667,84.75733333333335,27.56266666666668,142,210,68,chroma_acts_smoothed
512,5,84.75733333333335,108.26666666666668,23.50933333333333,210,268,58,chroma_acts_smoothed
512,6,108.26666666666668,128.12800000000001,19.861333333333334,268,317,49,chroma_acts_smoothed
512,7,128.12800000000001,134.208,6.079999999999984,317,332,15,chroma_acts_smoothed
512,8,134.208,160.14933333333335,25.941333333333347,332,396,64,chroma_acts_smoothed
512,9,160.14933333333335,211.2,51.05066666666664,396,520,124,chroma_acts_smoothed
512,1,0.0,6.122666666666667,6.122666666666667,0,16,16,ki_chroma
512,2,6.122666666666667,51.52,45.397333333333336,16,128,112,ki_chroma
512,3,51.52,57.6,6.079999999999998,128,143,15,ki_chroma
512,4,57.6,84.35200000000002,26.752000000000017,143,209,66,ki_chroma
512,5,84.35200000000002,108.26666666666668,23.914666666666662,209,268,59,ki_chroma
512,6,108.26666666666668,128.53333333333336,20.26666666666668,268,318,50,ki_chroma
512,7,128.53333333333336,134.208,5.6746666666666385,318,332,14,ki_chroma
512,8,134.208,160.14933333333335,25.941333333333347,332,396,64,ki_chroma
512,9,160.14933333333335,211.2,51.05066666666664,396,520,124,ki_chroma
512,1,0.0,6.122666666666667,6.122666666666667,0,16,16,ki_chroma_acts
512,2,6.122666666666667,45.03466666666667,38.912000000000006,16,112,96,ki_chroma_acts
512,3,45.03466666666667,51.52,6.48533333333333,112,128,16,ki_chroma_acts
512,4,51.52,57.6,6.079999999999998,128,143,15,ki_chroma_acts
512,5,57.6,108.26666666666668,50.66666666666668,143,268,125,ki_chroma_acts
512,6,108.26666666666668,128.53333333333336,20.26666666666668,268,318,50,ki_chroma_acts
512,7,128.53333333333336,134.208,5.6746666666666385,318,332,14,ki_chroma_acts
512,8,134.208,160.14933333333335,25.941333333333347,332,396,64,ki_chroma_acts
512,9,160.14933333333335,211.2,51.05066666666664,396,520,124,ki_chroma_acts
512,1,0.0,5.717333333333334,5.717333333333334,0,15,15,ki_chroma_acts_smoothed
512,2,5.717333333333334,51.52,45.80266666666667,15,128,113,ki_chroma_acts_smoothed
512,3,51.52,57.19466666666667,5.674666666666667,128,142,14,ki_chroma_acts_smoothed
512,4,57.19466666666667,84.75733333333335,27.56266666666668,142,210,68,ki_chroma_acts_smoothed
512,5,84.75733333333335,108.26666666666668,23.50933333333333,210,268,58,ki_chroma_acts_smoothed
512,6,108.26666666666668,128.12800000000001,19.861333333333334,268,317,49,ki_chroma_acts_smoothed
512,7,128.12800000000001,134.208,6.079999999999984,317,332,15,ki_chroma_acts_smoothed
512,8,134.208,160.14933333333335,25.941333333333347,332,396,64,ki_chroma_acts_smoothed
512,9,160.14933333333335,211.2,51.05066666666664,396,520,124,ki_chroma_acts_smoothed
514,1,0.0,54.272,54.272,0,114,114,chromagram
514,2,54.272,74.91199999999999,20.639999999999993,114,157,43,chromagram
514,3,74.91199999999999,80.192,5.280000000000001,157,168,11,chromagram
514,4,80.192,123.872,43.68000000000001,168,259,91,chromagram
514,5,123.872,132.03199999999998,8.159999999999982,259,276,17,chromagram
514,6,132.03199999999998,168.03199999999998,36.0,276,351,75,chromagram
514,7,168.03199999999998,196.832,28.80000000000001,351,411,60,chromagram
514,8,196.832,210.75199999999998,13.919999999999987,411,440,29,chromagram
514,9,210.75199999999998,257.991,47.239000000000004,440,537,97,chromagram
514,1,0.0,26.912,26.912,0,57,57,chroma_acts
514,2,26.912,74.91199999999999,47.99999999999999,57,157,100,chroma_acts
514,3,74.91199999999999,80.192,5.280000000000001,157,168,11,chroma_acts
514,4,80.192,123.872,43.68000000000001,168,259,91,chroma_acts
514,5,123.872,132.03199999999998,8.159999999999982,259,276,17,chroma_acts
514,6,132.03199999999998,168.992,36.96000000000001,276,353,77,chroma_acts
514,7,168.992,197.31199999999998,28.319999999999993,353,412,59,chroma_acts
514,8,197.31199999999998,210.75199999999998,13.439999999999998,412,440,28,chroma_acts
514,9,210.75199999999998,257.991,47.239000000000004,440,537,97,chroma_acts
514,1,0.0,27.872,27.872,0,59,59,chroma_acts_smoothed
514,2,27.872,74.91199999999999,47.03999999999999,59,157,98,chroma_acts_smoothed
514,3,74.91199999999999,80.192,5.280000000000001,157,168,11,chroma_acts_smoothed
514,4,80.192,124.35199999999999,44.16,168,260,92,chroma_acts_smoothed
514,5,124.35199999999999,132.512,8.16000000000001,260,277,17,chroma_acts_smoothed
514,6,132.512,168.992,36.47999999999999,277,353,76,chroma_acts_smoothed
514,7,168.992,197.31199999999998,28.319999999999993,353,412,59,chroma_acts_smoothed
514,8,197.31199999999998,210.75199999999998,13.439999999999998,412,440,28,chroma_acts_smoothed
514,9,210.75199999999998,257.991,47.239000000000004,440,537,97,chroma_acts_smoothed
514,1,0.0,54.272,54.272,0,114,114,ki_chroma
514,2,54.272,74.91199999999999,20.639999999999993,114,157,43,ki_chroma
514,3,74.91199999999999,80.192,5.280000000000001,157,168,11,ki_chroma
514,4,80.192,123.872,43.68000000000001,168,259,91,ki_chroma
514,5,123.872,132.03199999999998,8.159999999999982,259,276,17,ki_chroma
514,6,132.03199999999998,168.03199999999998,36.0,276,351,75,ki_chroma
514,7,168.03199999999998,196.832,28.80000000000001,351,411,60,ki_chroma
514,8,196.832,210.75199999999998,13.919999999999987,411,440,29,ki_chroma
514,9,210.75199999999998,257.991,47.239000000000004,440,537,97,ki_chroma
514,1,0.0,26.912,26.912,0,57,57,ki_chroma_acts
514,2,26.912,74.91199999999999,47.99999999999999,57,157,100,ki_chroma_acts
514,3,74.91199999999999,80.192,5.280000000000001,157,168,11,ki_chroma_acts
514,4,80.192,123.872,43.68000000000001,168,259,91,ki_chroma_acts
514,5,123.872,132.03199999999998,8.159999999999982,259,276,17,ki_chroma_acts
514,6,132.03199999999998,168.992,36.96000000000001,276,353,77,ki_chroma_acts
514,7,168.992,197.31199999999998,28.319999999999993,353,412,59,ki_chroma_acts
514,8,197.31199999999998,210.75199999999998,13.439999999999998,412,440,28,ki_chroma_acts
514,9,210.75199999999998,257.991,47.239000000000004,440,537,97,ki_chroma_acts
514,1,0.0,27.872,27.872,0,59,59,ki_chroma_acts_smoothed
514,2,27.872,74.91199999999999,47.03999999999999,59,157,98,ki_chroma_acts_smoothed
514,3,74.91199999999999,80.192,5.280000000000001,157,168,11,ki_chroma_acts_smoothed
514,4,80.192,124.35199999999999,44.16,168,260,92,ki_chroma_acts_smoothed
514,5,124.35199999999999,132.512,8.16000000000001,260,277,17,ki_chroma_acts_smoothed
514,6,132.512,168.992,36.47999999999999,277,353,76,ki_chroma_acts_smoothed
514,7,168.992,197.31199999999998,28.319999999999993,353,412,59,ki_chroma_acts_smoothed
514,8,197.31199999999998,210.75199999999998,13.439999999999998,412,440,28,ki_chroma_acts_smoothed
514,9,210.75199999999998,257.991,47.239000000000004,440,537,97,ki_chroma_acts_smoothed
517,1,0.0,5.215999999999999,5.215999999999999,0,11,11,chromagram
517,2,5.215999999999999,13.237333333333334,8.021333333333335,11,27,16,chromagram
517,3,13.237333333333334,50.837333333333326,37.599999999999994,27,102,75,chromagram
517,4,50.837333333333326,97.46133333333333,46.624,102,195,93,chromagram
517,5,97.46133333333333,146.59199999999998,49.130666666666656,195,293,98,chromagram
517,6,146.59199999999998,189.2053333333333,42.613333333333316,293,378,85,chromagram
517,7,189.2053333333333,262.68,73.4746666666667,378,523,145,chromagram
517,1,0.0,5.215999999999999,5.215999999999999,0,11,11,chroma_acts
517,2,5.215999999999999,10.229333333333333,5.013333333333334,11,21,10,chroma_acts
517,3,10.229333333333333,13.237333333333334,3.008000000000001,21,27,6,chroma_acts
517,4,13.237333333333334,50.336,37.09866666666667,27,101,74,chroma_acts
517,5,50.336,101.472,51.135999999999996,101,203,102,chroma_acts
517,6,101.472,145.58933333333331,44.11733333333332,203,291,88,chroma_acts
517,7,145.58933333333331,189.2053333333333,43.615999999999985,291,378,87,chroma_acts
517,8,189.2053333333333,262.68,73.4746666666667,378,523,145,chroma_acts
517,1,0.0,5.215999999999999,5.215999999999999,0,11,11,chroma_acts_smoothed
517,2,5.215999999999999,10.229333333333333,5.013333333333334,11,21,10,chroma_acts_smoothed
517,3,10.229333333333333,13.237333333333334,3.008000000000001,21,27,6,chroma_acts_smoothed
517,4,13.237333333333334,50.336,37.09866666666667,27,101,74,chroma_acts_smoothed
517,5,50.336,97.46133333333333,47.12533333333333,101,195,94,chroma_acts_smoothed
517,6,97.46133333333333,145.088,47.626666666666665,195,290,95,chroma_acts_smoothed
517,7,145.088,189.2053333333333,44.117333333333306,290,378,88,chroma_acts_smoothed
517,8,189.2053333333333,262.68,73.4746666666667,378,523,145,chroma_acts_smoothed
517,1,0.0,5.215999999999999,5.215999999999999,0,11,11,ki_chroma
517,2,5.215999999999999,13.237333333333334,8.021333333333335,11,27,16,ki_chroma
517,3,13.237333333333334,50.837333333333326,37.599999999999994,27,102,75,ki_chroma
517,4,50.837333333333326,97.46133333333333,46.624,102,195,93,ki_chroma
517,5,97.46133333333333,146.59199999999998,49.130666666666656,195,293,98,ki_chroma
517,6,146.59199999999998,189.2053333333333,42.613333333333316,293,378,85,ki_chroma
517,7,189.2053333333333,262.68,73.4746666666667,378,523,145,ki_chroma
517,1,0.0,5.215999999999999,5.215999999999999,0,11,11,ki_chroma_acts
517,2,5.215999999999999,10.229333333333333,5.013333333333334,11,21,10,ki_chroma_acts
517,3,10.229333333333333,13.237333333333334,3.008000000000001,21,27,6,ki_chroma_acts
517,4,13.237333333333334,50.336,37.09866666666667,27,101,74,ki_chroma_acts
517,5,50.336,101.472,51.135999999999996,101,203,102,ki_chroma_acts
517,6,101.472,145.58933333333331,44.11733333333332,203,291,88,ki_chroma_acts
517,7,145.58933333333331,189.2053333333333,43.615999999999985,291,378,87,ki_chroma_acts
517,8,189.2053333333333,262.68,73.4746666666667,378,523,145,ki_chroma_acts
517,1,0.0,5.215999999999999,5.215999999999999,0,11,11,ki_chroma_acts_smoothed
517,2,5.215999999999999,10.229333333333333,5.013333333333334,11,21,10,ki_chroma_acts_smoothed
517,3,10.229333333333333,13.237333333333334,3.008000000000001,21,27,6,ki_chroma_acts_smoothed
517,4,13.237333333333334,50.336,37.09866666666667,27,101,74,ki_chroma_acts_smoothed
517,5,50.336,97.46133333333333,47.12533333333333,101,195,94,ki_chroma_acts_smoothed
517,6,97.46133333333333,145.088,47.626666666666665,195,290,95,ki_chroma_acts_smoothed
517,7,145.088,189.2053333333333,44.117333333333306,290,378,88,ki_chroma_acts_smoothed
517,8,189.2053333333333,262.68,73.4746666666667,378,523,145,ki_chroma_acts_smoothed
520,1,0.0,16.85333333333333,16.85333333333333,0,36,36,chromagram
520,2,16.85333333333333,45.013333333333335,28.160000000000004,36,96,60,chromagram
520,3,45.013333333333335,54.4,9.386666666666663,96,116,20,chromagram
520,4,54.4,119.16799999999999,64.768,116,254,138,chromagram
520,5,119.16799999999999,147.32799999999997,28.159999999999982,254,314,60,chromagram
520,6,147.32799999999997,166.57066666666665,19.24266666666668,314,355,41,chromagram
520,7,166.57066666666665,175.01866666666666,8.448000000000008,355,373,18,chromagram
520,8,175.01866666666666,179.712,4.693333333333328,373,383,10,chromagram
520,9,179.712,198.75,19.03800000000001,383,422,39,chromagram
520,1,0.0,13.098666666666666,13.098666666666666,0,28,28,chroma_acts
520,2,13.098666666666666,45.013333333333335,31.91466666666667,28,96,68,chroma_acts
520,3,45.013333333333335,54.4,9.386666666666663,96,116,20,chroma_acts
520,4,54.4,59.562666666666665,5.1626666666666665,116,127,11,chroma_acts
520,5,59.562666666666665,117.76,58.19733333333334,127,251,124,chroma_acts
520,6,117.76,119.16799999999999,1.407999999999987,251,254,3,chroma_acts
520,7,119.16799999999999,145.92,26.751999999999995,254,311,57,chroma_acts
520,8,145.92,166.57066666666665,20.650666666666666,311,355,44,chroma_acts
520,9,166.57066666666665,198.75,32.179333333333346,355,422,67,chroma_acts
520,1,0.0,13.568000000000001,13.568000000000001,0,29,29,chroma_acts_smoothed
520,2,13.568000000000001,45.013333333333335,31.445333333333334,29,96,67,chroma_acts_smoothed
520,3,45.013333333333335,54.4,9.386666666666663,96,116,20,chroma_acts_smoothed
520,4,54.4,59.562666666666665,5.1626666666666665,116,127,11,chroma_acts_smoothed
520,5,59.562666666666665,119.16799999999999,59.60533333333333,127,254,127,chroma_acts_smoothed
520,6,119.16799999999999,147.32799999999997,28.159999999999982,254,314,60,chroma_acts_smoothed
520,7,147.32799999999997,166.57066666666665,19.24266666666668,314,355,41,chroma_acts_smoothed
520,8,166.57066666666665,179.712,13.141333333333336,355,383,28,chroma_acts_smoothed
520,9,179.712,198.75,19.03800000000001,383,422,39,chroma_acts_smoothed
520,1,0.0,16.85333333333333,16.85333333333333,0,36,36,ki_chroma
520,2,16.85333333333333,45.013333333333335,28.160000000000004,36,96,60,ki_chroma
520,3,45.013333333333335,54.4,9.386666666666663,96,116,20,ki_chroma
520,4,54.4,119.16799999999999,64.768,116,254,138,ki_chroma
520,5,119.16799999999999,147.32799999999997,28.159999999999982,254,314,60,ki_chroma
520,6,147.32799999999997,166.57066666666665,19.24266666666668,314,355,41,ki_chroma
520,7,166.57066666666665,175.01866666666666,8.448000000000008,355,373,18,ki_chroma
520,8,175.01866666666666,179.712,4.693333333333328,373,383,10,ki_chroma
520,9,179.712,198.75,19.03800000000001,383,422,39,ki_chroma
520,1,0.0,13.098666666666666,13.098666666666666,0,28,28,ki_chroma_acts
520,2,13.098666666666666,45.013333333333335,31.91466666666667,28,96,68,ki_chroma_acts
520,3,45.013333333333335,54.4,9.386666666666663,96,116,20,ki_chroma_acts
520,4,54.4,59.562666666666665,5.1626666666666665,116,127,11,ki_chroma_acts
520,5,59.562666666666665,117.76,58.19733333333334,127,251,124,ki_chroma_acts
520,6,117.76,119.16799999999999,1.407999999999987,251,254,3,ki_chroma_acts
520,7,119.16799999999999,145.92,26.751999999999995,254,311,57,ki_chroma_acts
520,8,145.92,166.57066666666665,20.650666666666666,311,355,44,ki_chroma_acts
520,9,166.57066666666665,198.75,32.179333333333346,355,422,67,ki_chroma_acts
520,1,0.0,13.568000000000001,13.568000000000001,0,29,29,ki_chroma_acts_smoothed
520,2,13.568000000000001,45.013333333333335,31.445333333333334,29,96,67,ki_chroma_acts_smoothed
520,3,45.013333333333335,54.4,9.386666666666663,96,116,20,ki_chroma_acts_smoothed
520,4,54.4,59.562666666666665,5.1626666666666665,116,127,11,ki_chroma_acts_smoothed
520,5,59.562666666666665,119.16799999999999,59.60533333333333,127,254,127,ki_chroma_acts_smoothed
520,6,119.16799999999999,147.32799999999997,28.159999999999982,254,314,60,ki_chroma_acts_smoothed
520,7,147.32799999999997,166.57066666666665,19.24266666666668,314,355,41,ki_chroma_acts_smoothed
520,8,166.57066666666665,179.712,13.141333333333336,355,383,28,ki_chroma_acts_smoothed
520,9,179.712,198.75,19.03800000000001,383,422,39,ki_chroma_acts_smoothed
522,1,0.0,15.626666666666667,15.626666666666667,0,33,33,chromagram
522,2,15.626666666666667,29.546666666666663,13.919999999999996,33,62,29,chromagram
522,3,29.546666666666663,76.58666666666666,47.03999999999999,62,160,98,chromagram
522,4,76.58666666666666,91.46666666666667,14.88000000000001,160,191,31,chromagram
522,5,91.46666666666667,105.86666666666666,14.399999999999991,191,221,30,chromagram
522,6,105.86666666666666,120.26666666666667,14.400000000000006,221,251,30,chromagram
522,7,120.26666666666667,125.54666666666667,5.280000000000001,251,262,11,chromagram
522,8,125.54666666666667,187.143,61.596333333333334,262,389,127,chromagram
522,1,0.0,11.306666666666667,11.306666666666667,0,24,24,chroma_acts
522,2,11.306666666666667,29.546666666666663,18.239999999999995,24,62,38,chroma_acts
522,3,29.546666666666663,30.506666666666664,0.9600000000000009,62,64,2,chroma_acts
522,4,30.506666666666664,76.58666666666666,46.08,64,160,96,chroma_acts
522,5,76.58666666666666,91.46666666666667,14.88000000000001,160,191,31,chroma_acts
522,6,91.46666666666667,105.86666666666666,14.399999999999991,191,221,30,chroma_acts
522,7,105.86666666666666,125.54666666666667,19.680000000000007,221,262,41,chroma_acts
522,8,125.54666666666667,187.143,61.596333333333334,262,389,127,chroma_acts
522,1,0.0,11.786666666666667,11.786666666666667,0,25,25,chroma_acts_smoothed
522,2,11.786666666666667,29.546666666666663,17.759999999999998,25,62,37,chroma_acts_smoothed
522,3,29.546666666666663,30.506666666666664,0.9600000000000009,62,64,2,chroma_acts_smoothed
522,4,30.506666666666664,76.58666666666666,46.08,64,160,96,chroma_acts_smoothed
522,5,76.58666666666666,91.46666666666667,14.88000000000001,160,191,31,chroma_acts_smoothed
522,6,91.46666666666667,105.38666666666666,13.919999999999987,191,220,29,chroma_acts_smoothed
522,7,105.38666666666666,125.54666666666667,20.16000000000001,220,262,42,chroma_acts_smoothed
522,8,125.54666666666667,187.143,61.596333333333334,262,389,127,chroma_acts_smoothed
522,1,0.0,15.626666666666667,15.626666666666667,0,33,33,ki_chroma
522,2,15.626666666666667,29.546666666666663,13.919999999999996,33,62,29,ki_chroma
522,3,29.546666666666663,76.58666666666666,47.03999999999999,62,160,98,ki_chroma
522,4,76.58666666666666,91.46666666666667,14.88000000000001,160,191,31,ki_chroma
522,5,91.46666666666667,105.86666666666666,14.399999999999991,191,221,30,ki_chroma
522,6,105.86666666666666,120.26666666666667,14.400000000000006,221,251,30,ki_chroma
522,7,120.26666666666667,125.54666666666667,5.280000000000001,251,262,11,ki_chroma
522,8,125.54666666666667,187.143,61.596333333333334,262,389,127,ki_chroma
522,1,0.0,11.306666666666667,11.306666666666667,0,24,24,ki_chroma_acts
522,2,11.306666666666667,29.546666666666663,18.239999999999995,24,62,38,ki_chroma_acts
522,3,29.546666666666663,30.506666666666664,0.9600000000000009,62,64,2,ki_chroma_acts
522,4,30.506666666666664,76.58666666666666,46.08,64,160,96,ki_chroma_acts
522,5,76.58666666666666,91.46666666666667,14.88000000000001,160,191,31,ki_chroma_acts
522,6,91.46666666666667,105.86666666666666,14.399999999999991,191,221,30,ki_chroma_acts
522,7,105.86666666666666,125.54666666666667,19.680000000000007,221,262,41,ki_chroma_acts
522,8,125.54666666666667,187.143,61.596333333333334,262,389,127,ki_chroma_acts
522,1,0.0,11.786666666666667,11.786666666666667,0,25,25,ki_chroma_acts_smoothed
522,2,11.786666666666667,29.546666666666663,17.759999999999998,25,62,37,ki_chroma_acts_smoothed
522,3,29.546666666666663,30.506666666666664,0.9600000000000009,62,64,2,ki_chroma_acts_smoothed
522,4,30.506666666666664,76.58666666666666,46.08,64,160,96,ki_chroma_acts_smoothed
522,5,76.58666666666666,91.46666666666667,14.88000000000001,160,191,31,ki_chroma_acts_smoothed
522,6,91.46666666666667,105.38666666666666,13.919999999999987,191,220,29,ki_chroma_acts_smoothed
522,7,105.38666666666666,125.54666666666667,20.16000000000001,220,262,42,ki_chroma_acts_smoothed
522,8,125.54666666666667,187.143,61.596333333333334,262,389,127,ki_chroma_acts_smoothed
523,1,0.0,5.024,5.024,0,11,11,chromagram
523,2,5.024,16.757333333333335,11.733333333333334,11,36,25,chromagram
523,3,16.757333333333335,47.263999999999996,30.50666666666666,36,101,65,chromagram
523,4,47.263999999999996,66.03733333333334,18.77333333333334,101,141,40,chromagram
523,5,66.03733333333334,77.30133333333333,11.263999999999996,141,165,24,chromagram
523,6,77.30133333333333,122.82666666666667,45.525333333333336,165,262,97,chromagram
523,7,122.82666666666667,164.59733333333332,41.770666666666656,262,351,89,chromagram
523,8,164.59733333333332,213.56,48.96266666666668,351,454,103,chromagram
523,1,0.0,16.757333333333335,16.757333333333335,0,36,36,chroma_acts
523,2,16.757333333333335,47.263999999999996,30.50666666666666,36,101,65,chroma_acts
523,3,47.263999999999996,66.03733333333334,18.77333333333334,101,141,40,chroma_acts
523,4,66.03733333333334,77.30133333333333,11.263999999999996,141,165,24,chroma_acts
523,5,77.30133333333333,122.82666666666667,45.525333333333336,165,262,97,chroma_acts
523,6,122.82666666666667,162.25066666666666,39.42399999999999,262,346,84,chroma_acts
523,7,162.25066666666666,164.59733333333332,2.346666666666664,346,351,5,chroma_acts
523,8,164.59733333333332,167.88266666666667,3.285333333333341,351,358,7,chroma_acts
523,9,167.88266666666667,213.56,45.67733333333334,358,454,96,chroma_acts
523,1,0.0,16.757333333333335,16.757333333333335,0,36,36,chroma_acts_smoothed
523,2,16.757333333333335,47.263999999999996,30.50666666666666,36,101,65,chroma_acts_smoothed
523,3,47.263999999999996,65.09866666666666,17.834666666666664,101,139,38,chroma_acts_smoothed
523,4,65.09866666666666,77.30133333333333,12.202666666666673,139,165,26,chroma_acts_smoothed
523,5,77.30133333333333,122.82666666666667,45.525333333333336,165,262,97,chroma_acts_smoothed
523,6,122.82666666666667,136.90666666666667,14.079999999999998,262,292,30,chroma_acts_smoothed
523,7,136.90666666666667,164.59733333333332,27.690666666666658,292,351,59,chroma_acts_smoothed
523,8,164.59733333333332,167.88266666666667,3.285333333333341,351,358,7,chroma_acts_smoothed
523,9,167.88266666666667,213.56,45.67733333333334,358,454,96,chroma_acts_smoothed
523,1,0.0,5.024,5.024,0,11,11,ki_chroma
523,2,5.024,16.757333333333335,11.733333333333334,11,36,25,ki_chroma
523,3,16.757333333333335,47.263999999999996,30.50666666666666,36,101,65,ki_chroma
523,4,47.263999999999996,66.03733333333334,18.77333333333334,101,141,40,ki_chroma
523,5,66.03733333333334,77.30133333333333,11.263999999999996,141,165,24,ki_chroma
523,6,77.30133333333333,122.82666666666667,45.525333333333336,165,262,97,ki_chroma
523,7,122.82666666666667,164.59733333333332,41.770666666666656,262,351,89,ki_chroma
523,8,164.59733333333332,213.56,48.96266666666668,351,454,103,ki_chroma
523,1,0.0,16.757333333333335,16.757333333333335,0,36,36,ki_chroma_acts
523,2,16.757333333333335,47.263999999999996,30.50666666666666,36,101,65,ki_chroma_acts
523,3,47.263999999999996,66.03733333333334,18.77333333333334,101,141,40,ki_chroma_acts
523,4,66.03733333333334,77.30133333333333,11.263999999999996,141,165,24,ki_chroma_acts
523,5,77.30133333333333,122.82666666666667,45.525333333333336,165,262,97,ki_chroma_acts
523,6,122.82666666666667,162.25066666666666,39.42399999999999,262,346,84,ki_chroma_acts
523,7,162.25066666666666,164.59733333333332,2.346666666666664,346,351,5,ki_chroma_acts
523,8,164.59733333333332,167.88266666666667,3.285333333333341,351,358,7,ki_chroma_acts
523,9,167.88266666666667,213.56,45.67733333333334,358,454,96,ki_chroma_acts
523,1,0.0,16.757333333333335,16.757333333333335,0,36,36,ki_chroma_acts_smoothed
523,2,16.757333333333335,47.263999999999996,30.50666666666666,36,101,65,ki_chroma_acts_smoothed
523,3,47.263999999999996,65.09866666666666,17.834666666666664,101,139,38,ki_chroma_acts_smoothed
523,4,65.09866666666666,77.30133333333333,12.202666666666673,139,165,26,ki_chroma_acts_smoothed
523,5,77.30133333333333,122.82666666666667,45.525333333333336,165,262,97,ki_chroma_acts_smoothed
523,6,122.82666666666667,136.90666666666667,14.079999999999998,262,292,30,ki_chroma_acts_smoothed
523,7,136.90666666666667,164.59733333333332,27.690666666666658,292,351,59,ki_chroma_acts_smoothed
523,8,164.59733333333332,167.88266666666667,3.285333333333341,351,358,7,ki_chroma_acts_smoothed
523,9,167.88266666666667,213.56,45.67733333333334,358,454,96,ki_chroma_acts_smoothed
524,1,0.0,46.592,46.592,0,98,98,chromagram
524,2,46.592,60.032,13.439999999999998,98,126,28,chromagram
524,3,60.032,84.99199999999999,24.959999999999994,126,178,52,chromagram
524,4,84.99199999999999,93.152,8.16000000000001,178,195,17,chromagram
524,5,93.152,123.872,30.72,195,259,64,chromagram
524,6,123.872,152.672,28.799999999999997,259,319,60,chromagram
524,7,152.672,173.792,21.120000000000005,319,363,44,chromagram
524,8,173.792,247.232,73.44,363,516,153,chromagram
524,9,247.232,278.912,31.67999999999998,516,581,65,chromagram
524,1,0.0,46.592,46.592,0,98,98,chroma_acts
524,2,46.592,60.032,13.439999999999998,98,126,28,chroma_acts
524,3,60.032,85.472,25.439999999999998,126,179,53,chroma_acts
524,4,85.472,93.152,7.680000000000007,179,195,16,chroma_acts
524,5,93.152,115.71199999999999,22.559999999999988,195,242,47,chroma_acts
524,6,115.71199999999999,121.952,6.240000000000009,242,255,13,chroma_acts
524,7,121.952,151.712,29.75999999999999,255,317,62,chroma_acts
524,8,151.712,173.792,22.080000000000013,317,363,46,chroma_acts
524,9,173.792,278.912,105.11999999999998,363,581,218,chroma_acts
524,1,0.0,46.112,46.112,0,97,97,chroma_acts_smoothed
524,2,46.112,60.032,13.919999999999995,97,126,29,chroma_acts_smoothed
524,3,60.032,84.99199999999999,24.959999999999994,126,178,52,chroma_acts_smoothed
524,4,84.99199999999999,93.152,8.16000000000001,178,195,17,chroma_acts_smoothed
524,5,93.152,121.952,28.799999999999997,195,255,60,chroma_acts_smoothed
524,6,121.952,151.712,29.75999999999999,255,317,62,chroma_acts_smoothed
524,7,151.712,173.792,22.080000000000013,317,363,46,chroma_acts_smoothed
524,8,173.792,247.232,73.44,363,516,153,chroma_acts_smoothed
524,9,247.232,278.912,31.67999999999998,516,581,65,chroma_acts_smoothed
524,1,0.0,46.592,46.592,0,98,98,ki_chroma
524,2,46.592,60.032,13.439999999999998,98,126,28,ki_chroma
524,3,60.032,84.99199999999999,24.959999999999994,126,178,52,ki_chroma
524,4,84.99199999999999,93.152,8.16000000000001,178,195,17,ki_chroma
524,5,93.152,123.872,30.72,195,259,64,ki_chroma
524,6,123.872,152.672,28.799999999999997,259,319,60,ki_chroma
524,7,152.672,173.792,21.120000000000005,319,363,44,ki_chroma
524,8,173.792,247.232,73.44,363,516,153,ki_chroma
524,9,247.232,278.912,31.67999999999998,516,581,65,ki_chroma
524,1,0.0,46.592,46.592,0,98,98,ki_chroma_acts
524,2,46.592,60.032,13.439999999999998,98,126,28,ki_chroma_acts
524,3,60.032,85.472,25.439999999999998,126,179,53,ki_chroma_acts
524,4,85.472,93.152,7.680000000000007,179,195,16,ki_chroma_acts
524,5,93.152,115.71199999999999,22.559999999999988,195,242,47,ki_chroma_acts
524,6,115.71199999999999,121.952,6.240000000000009,242,255,13,ki_chroma_acts
524,7,121.952,151.712,29.75999999999999,255,317,62,ki_chroma_acts
524,8,151.712,173.792,22.080000000000013,317,363,46,ki_chroma_acts
524,9,173.792,278.912,105.11999999999998,363,581,218,ki_chroma_acts
524,1,0.0,46.112,46.112,0,97,97,ki_chroma_acts_smoothed
524,2,46.112,60.032,13.919999999999995,97,126,29,ki_chroma_acts_smoothed
524,3,60.032,84.99199999999999,24.959999999999994,126,178,52,ki_chroma_acts_smoothed
524,4,84.99199999999999,93.152,8.16000000000001,178,195,17,ki_chroma_acts_smoothed
524,5,93.152,121.952,28.799999999999997,195,255,60,ki_chroma_acts_smoothed
524,6,121.952,151.712,29.75999999999999,255,317,62,ki_chroma_acts_smoothed
524,7,151.712,173.792,22.080000000000013,317,363,46,ki_chroma_acts_smoothed
524,8,173.792,247.232,73.44,363,516,153,ki_chroma_acts_smoothed
524,9,247.232,278.912,31.67999999999998,516,581,65,ki_chroma_acts_smoothed
526,1,0.0,14.901333333333332,14.901333333333332,0,32,32,chromagram
526,2,14.901333333333332,21.621333333333332,6.720000000000001,32,46,14,chromagram
526,3,21.621333333333332,30.261333333333333,8.64,46,64,18,chromagram
526,4,30.261333333333333,87.38133333333333,57.12,64,183,119,chromagram
526,5,87.38133333333333,107.54133333333333,20.159999999999997,183,225,42,chromagram
526,6,107.54133333333333,140.18133333333333,32.64,225,293,68,chromagram
526,7,140.18133333333333,147.8613333333333,7.679999999999978,293,309,16,chromagram
526,8,147.8613333333333,152.18133333333333,4.320000000000022,309,318,9,chromagram
526,9,152.18133333333333,182.845,30.66366666666667,318,380,62,chromagram
526,1,0.0,14.901333333333332,14.901333333333332,0,32,32,chroma_acts
526,2,14.901333333333332,21.621333333333332,6.720000000000001,32,46,14,chroma_acts
526,3,21.621333333333332,30.261333333333333,8.64,46,64,18,chroma_acts
526,4,30.261333333333333,87.38133333333333,57.12,64,183,119,chroma_acts
526,5,87.38133333333333,107.54133333333333,20.159999999999997,183,225,42,chroma_acts
526,6,107.54133333333333,139.7013333333333,32.15999999999998,225,292,67,chroma_acts
526,7,139.7013333333333,145.46133333333333,5.760000000000019,292,304,12,chroma_acts
526,8,145.46133333333333,152.18133333333333,6.719999999999999,304,318,14,chroma_acts
526,9,152.18133333333333,182.845,30.66366666666667,318,380,62,chroma_acts
526,1,0.0,14.901333333333332,14.901333333333332,0,32,32,chroma_acts_smoothed
526,2,14.901333333333332,22.101333333333333,7.200000000000001,32,47,15,chroma_acts_smoothed
526,3,22.101333333333333,30.261333333333333,8.16,47,64,17,chroma_acts_smoothed
526,4,30.261333333333333,107.54133333333333,77.28,64,225,161,chroma_acts_smoothed
526,5,107.54133333333333,139.7013333333333,32.15999999999998,225,292,67,chroma_acts_smoothed
526,6,139.7013333333333,142.5813333333333,2.8799999999999955,292,298,6,chroma_acts_smoothed
526,7,142.5813333333333,148.8213333333333,6.240000000000009,298,311,13,chroma_acts_smoothed
526,8,148.8213333333333,152.18133333333333,3.3600000000000136,311,318,7,chroma_acts_smoothed
526,9,152.18133333333333,182.845,30.66366666666667,318,380,62,chroma_acts_smoothed
526,1,0.0,14.901333333333332,14.901333333333332,0,32,32,ki_chroma
526,2,14.901333333333332,21.621333333333332,6.720000000000001,32,46,14,ki_chroma
526,3,21.621333333333332,30.261333333333333,8.64,46,64,18,ki_chroma
526,4,30.261333333333333,87.38133333333333,57.12,64,183,119,ki_chroma
526,5,87.38133333333333,107.54133333333333,20.159999999999997,183,225,42,ki_chroma
526,6,107.54133333333333,140.18133333333333,32.64,225,293,68,ki_chroma
526,7,140.18133333333333,147.8613333333333,7.679999999999978,293,309,16,ki_chroma
526,8,147.8613333333333,152.18133333333333,4.320000000000022,309,318,9,ki_chroma
526,9,152.18133333333333,182.845,30.66366666666667,318,380,62,ki_chroma
526,1,0.0,14.901333333333332,14.901333333333332,0,32,32,ki_chroma_acts
526,2,14.901333333333332,21.621333333333332,6.720000000000001,32,46,14,ki_chroma_acts
526,3,21.621333333333332,30.261333333333333,8.64,46,64,18,ki_chroma_acts
526,4,30.261333333333333,87.38133333333333,57.12,64,183,119,ki_chroma_acts
526,5,87.38133333333333,107.54133333333333,20.159999999999997,183,225,42,ki_chroma_acts
526,6,107.54133333333333,139.7013333333333,32.15999999999998,225,292,67,ki_chroma_acts
526,7,139.7013333333333,145.46133333333333,5.760000000000019,292,304,12,ki_chroma_acts
526,8,145.46133333333333,152.18133333333333,6.719999999999999,304,318,14,ki_chroma_acts
526,9,152.18133333333333,182.845,30.66366666666667,318,380,62,ki_chroma_acts
526,1,0.0,14.901333333333332,14.901333333333332,0,32,32,ki_chroma_acts_smoothed
526,2,14.901333333333332,22.101333333333333,7.200000000000001,32,47,15,ki_chroma_acts_smoothed
526,3,22.101333333333333,30.261333333333333,8.16,47,64,17,ki_chroma_acts_smoothed
526,4,30.261333333333333,107.54133333333333,77.28,64,225,161,ki_chroma_acts_smoothed
526,5,107.54133333333333,139.7013333333333,32.15999999999998,225,292,67,ki_chroma_acts_smoothed
526,6,139.7013333333333,142.5813333333333,2.8799999999999955,292,298,6,ki_chroma_acts_smoothed
526,7,142.5813333333333,148.8213333333333,6.240000000000009,298,311,13,ki_chroma_acts_smoothed
526,8,148.8213333333333,152.18133333333333,3.3600000000000136,311,318,7,ki_chroma_acts_smoothed
526,9,152.18133333333333,182.845,30.66366666666667,318,380,62,ki_chroma_acts_smoothed
527,1,0.0,15.328,15.328,0,33,33,chromagram
527,2,15.328,26.592000000000002,11.264000000000003,33,57,24,chromagram
527,3,26.592000000000002,30.346666666666668,3.7546666666666653,57,65,8,chromagram
527,4,30.346666666666668,75.40266666666666,45.056,65,161,96,chromagram
527,5,75.40266666666666,100.27733333333333,24.87466666666667,161,214,53,chromagram
527,6,100.27733333333333,120.45866666666666,20.181333333333328,214,257,43,chromagram
527,7,120.45866666666666,135.008,14.549333333333351,257,288,31,chromagram
527,8,135.008,165.984,30.976,288,354,66,chromagram
527,9,165.984,180.193,14.209000000000003,354,383,29,chromagram
527,1,0.0,14.389333333333333,14.389333333333333,0,31,31,chroma_acts
527,2,14.389333333333333,26.592000000000002,12.20266666666667,31,57,26,chroma_acts
527,3,26.592000000000002,30.346666666666668,3.7546666666666653,57,65,8,chroma_acts
527,4,30.346666666666668,75.40266666666666,45.056,65,161,96,chroma_acts
527,5,75.40266666666666,100.27733333333333,24.87466666666667,161,214,53,chroma_acts
527,6,100.27733333333333,119.05066666666666,18.773333333333326,214,254,40,chroma_acts
527,7,119.05066666666666,135.008,15.957333333333352,254,288,34,chroma_acts
527,8,135.008,165.984,30.976,288,354,66,chroma_acts
527,9,165.984,180.193,14.209000000000003,354,383,29,chroma_acts
527,1,0.0,14.389333333333333,14.389333333333333,0,31,31,chroma_acts_smoothed
527,2,14.389333333333333,30.346666666666668,15.957333333333334,31,65,34,chroma_acts_smoothed
527,3,30.346666666666668,75.40266666666666,45.056,65,161,96,chroma_acts_smoothed
527,4,75.40266666666666,105.44,30.037333333333336,161,225,64,chroma_acts_smoothed
527,5,105.44,119.52,14.079999999999998,225,255,30,chroma_acts_smoothed
527,6,119.52,131.72266666666667,12.202666666666673,255,281,26,chroma_acts_smoothed
527,7,131.72266666666667,135.008,3.285333333333341,281,288,7,chroma_acts_smoothed
527,8,135.008,164.10666666666668,29.098666666666674,288,350,62,chroma_acts_smoothed
527,9,164.10666666666668,180.193,16.08633333333333,350,383,33,chroma_acts_smoothed
527,1,0.0,15.328,15.328,0,33,33,ki_chroma
527,2,15.328,26.592000000000002,11.264000000000003,33,57,24,ki_chroma
527,3,26.592000000000002,30.346666666666668,3.7546666666666653,57,65,8,ki_chroma
527,4,30.346666666666668,75.40266666666666,45.056,65,161,96,ki_chroma
527,5,75.40266666666666,100.27733333333333,24.87466666666667,161,214,53,ki_chroma
527,6,100.27733333333333,120.45866666666666,20.181333333333328,214,257,43,ki_chroma
527,7,120.45866666666666,135.008,14.549333333333351,257,288,31,ki_chroma
527,8,135.008,165.984,30.976,288,354,66,ki_chroma
527,9,165.984,180.193,14.209000000000003,354,383,29,ki_chroma
527,1,0.0,14.389333333333333,14.389333333333333,0,31,31,ki_chroma_acts
527,2,14.389333333333333,26.592000000000002,12.20266666666667,31,57,26,ki_chroma_acts
527,3,26.592000000000002,30.346666666666668,3.7546666666666653,57,65,8,ki_chroma_acts
527,4,30.346666666666668,75.40266666666666,45.056,65,161,96,ki_chroma_acts
527,5,75.40266666666666,100.27733333333333,24.87466666666667,161,214,53,ki_chroma_acts
527,6,100.27733333333333,119.05066666666666,18.773333333333326,214,254,40,ki_chroma_acts
527,7,119.05066666666666,135.008,15.957333333333352,254,288,34,ki_chroma_acts
527,8,135.008,165.984,30.976,288,354,66,ki_chroma_acts
527,9,165.984,180.193,14.209000000000003,354,383,29,ki_chroma_acts
527,1,0.0,14.389333333333333,14.389333333333333,0,31,31,ki_chroma_acts_smoothed
527,2,14.389333333333333,30.346666666666668,15.957333333333334,31,65,34,ki_chroma_acts_smoothed
527,3,30.346666666666668,75.40266666666666,45.056,65,161,96,ki_chroma_acts_smoothed
527,4,75.40266666666666,105.44,30.037333333333336,161,225,64,ki_chroma_acts_smoothed
527,5,105.44,119.52,14.079999999999998,225,255,30,ki_chroma_acts_smoothed
527,6,119.52,131.72266666666667,12.202666666666673,255,281,26,ki_chroma_acts_smoothed
527,7,131.72266666666667,135.008,3.285333333333341,281,288,7,ki_chroma_acts_smoothed
527,8,135.008,164.10666666666668,29.098666666666674,288,350,62,ki_chroma_acts_smoothed
527,9,164.10666666666668,180.193,16.08633333333333,350,383,33,ki_chroma_acts_smoothed
528,1,0.0,8.256,8.256,0,18,18,chromagram
528,2,8.256,15.765333333333333,7.509333333333332,18,34,16,chromagram
528,3,15.765333333333333,60.352,44.586666666666666,34,129,95,chromagram
528,4,60.352,68.8,8.448,129,147,18,chromagram
528,5,68.8,73.96266666666666,5.1626666666666665,147,158,11,chromagram
528,6,73.96266666666666,83.34933333333333,9.38666666666667,158,178,20,chromagram
528,7,83.34933333333333,88.98133333333332,5.631999999999991,178,190,12,chromagram
528,8,88.98133333333332,119.95733333333332,30.976,190,256,66,chromagram
528,9,119.95733333333332,168.162,48.20466666666668,256,357,101,chromagram
528,1,0.0,8.256,8.256,0,18,18,chroma_acts
528,2,8.256,15.765333333333333,7.509333333333332,18,34,16,chroma_acts
528,3,15.765333333333333,60.82133333333333,45.056,34,130,96,chroma_acts
528,4,60.82133333333333,68.8,7.978666666666669,130,147,17,chroma_acts
528,5,68.8,72.08533333333332,3.2853333333333268,147,154,7,chroma_acts
528,6,72.08533333333332,75.84,3.7546666666666795,154,162,8,chroma_acts
528,7,75.84,83.34933333333333,7.5093333333333305,162,178,16,chroma_acts
528,8,83.34933333333333,90.85866666666666,7.5093333333333305,178,194,16,chroma_acts
528,9,90.85866666666666,168.162,77.30333333333334,194,357,163,chroma_acts
528,1,0.0,8.256,8.256,0,18,18,chroma_acts_smoothed
528,2,8.256,15.296,7.039999999999999,18,33,15,chroma_acts_smoothed
528,3,15.296,61.29066666666667,45.99466666666667,33,131,98,chroma_acts_smoothed
528,4,61.29066666666667,68.33066666666666,7.039999999999992,131,146,15,chroma_acts_smoothed
528,5,68.33066666666666,75.84,7.509333333333345,146,162,16,chroma_acts_smoothed
528,6,75.84,83.34933333333333,7.5093333333333305,162,178,16,chroma_acts_smoothed
528,7,83.34933333333333,90.85866666666666,7.5093333333333305,178,194,16,chroma_acts_smoothed
528,8,90.85866666666666,119.95733333333332,29.09866666666666,194,256,62,chroma_acts_smoothed
528,9,119.95733333333332,168.162,48.20466666666668,256,357,101,chroma_acts_smoothed
528,1,0.0,8.256,8.256,0,18,18,ki_chroma
528,2,8.256,15.765333333333333,7.509333333333332,18,34,16,ki_chroma
528,3,15.765333333333333,60.352,44.586666666666666,34,129,95,ki_chroma
528,4,60.352,68.8,8.448,129,147,18,ki_chroma
528,5,68.8,73.96266666666666,5.1626666666666665,147,158,11,ki_chroma
528,6,73.96266666666666,83.34933333333333,9.38666666666667,158,178,20,ki_chroma
528,7,83.34933333333333,88.98133333333332,5.631999999999991,178,190,12,ki_chroma
528,8,88.98133333333332,119.95733333333332,30.976,190,256,66,ki_chroma
528,9,119.95733333333332,168.162,48.20466666666668,256,357,101,ki_chroma
528,1,0.0,8.256,8.256,0,18,18,ki_chroma_acts
528,2,8.256,15.765333333333333,7.509333333333332,18,34,16,ki_chroma_acts
528,3,15.765333333333333,60.82133333333333,45.056,34,130,96,ki_chroma_acts
528,4,60.82133333333333,68.8,7.978666666666669,130,147,17,ki_chroma_acts
528,5,68.8,72.08533333333332,3.2853333333333268,147,154,7,ki_chroma_acts
528,6,72.08533333333332,75.84,3.7546666666666795,154,162,8,ki_chroma_acts
528,7,75.84,83.34933333333333,7.5093333333333305,162,178,16,ki_chroma_acts
528,8,83.34933333333333,90.85866666666666,7.5093333333333305,178,194,16,ki_chroma_acts
528,9,90.85866666666666,168.162,77.30333333333334,194,357,163,ki_chroma_acts
528,1,0.0,8.256,8.256,0,18,18,ki_chroma_acts_smoothed
528,2,8.256,15.296,7.039999999999999,18,33,15,ki_chroma_acts_smoothed
528,3,15.296,61.29066666666667,45.99466666666667,33,131,98,ki_chroma_acts_smoothed
528,4,61.29066666666667,68.33066666666666,7.039999999999992,131,146,15,ki_chroma_acts_smoothed
528,5,68.33066666666666,75.84,7.509333333333345,146,162,16,ki_chroma_acts_smoothed
528,6,75.84,83.34933333333333,7.5093333333333305,162,178,16,ki_chroma_acts_smoothed
528,7,83.34933333333333,90.85866666666666,7.5093333333333305,178,194,16,ki_chroma_acts_smoothed
528,8,90.85866666666666,119.95733333333332,29.09866666666666,194,256,62,ki_chroma_acts_smoothed
528,9,119.95733333333332,168.162,48.20466666666668,256,357,101,ki_chroma_acts_smoothed
529,1,0.0,7.4879999999999995,7.4879999999999995,0,17,17,chromagram
529,2,7.4879999999999995,18.496,11.008,17,41,24,chromagram
529,3,18.496,40.05333333333333,21.55733333333333,41,88,47,chromagram
529,4,40.05333333333333,102.89066666666666,62.83733333333333,88,225,137,chromagram
529,5,102.89066666666666,143.25333333333333,40.36266666666667,225,313,88,chromagram
529,6,143.25333333333333,157.93066666666667,14.677333333333337,313,345,32,chromagram
529,7,157.93066666666667,168.02133333333333,10.090666666666664,345,367,22,chromagram
529,8,168.02133333333333,172.14933333333332,4.127999999999986,367,376,9,chromagram
529,9,172.14933333333332,216.289,44.13966666666667,376,471,95,chromagram
529,1,0.0,7.4879999999999995,7.4879999999999995,0,17,17,chroma_acts
529,2,7.4879999999999995,11.157333333333332,3.6693333333333324,17,25,8,chroma_acts
529,3,11.157333333333332,14.826666666666666,3.6693333333333342,25,33,8,chroma_acts
529,4,14.826666666666666,18.496,3.6693333333333324,33,41,8,chroma_acts
529,5,18.496,40.05333333333333,21.55733333333333,41,88,47,chroma_acts
529,6,40.05333333333333,102.89066666666666,62.83733333333333,88,225,137,chroma_acts
529,7,102.89066666666666,143.25333333333333,40.36266666666667,225,313,88,chroma_acts
529,8,143.25333333333333,158.38933333333333,15.135999999999996,313,346,33,chroma_acts
529,9,158.38933333333333,216.289,57.89966666666666,346,471,125,chroma_acts
529,1,0.0,7.4879999999999995,7.4879999999999995,0,17,17,chroma_acts_smoothed
529,2,7.4879999999999995,11.157333333333332,3.6693333333333324,17,25,8,chroma_acts_smoothed
529,3,11.157333333333332,18.496,7.338666666666667,25,41,16,chroma_acts_smoothed
529,4,18.496,40.51199999999999,22.015999999999995,41,89,48,chroma_acts_smoothed
529,5,40.51199999999999,102.89066666666666,62.37866666666667,89,225,136,chroma_acts_smoothed
529,6,102.89066666666666,142.79466666666664,39.90399999999998,225,312,87,chroma_acts_smoothed
529,7,142.79466666666664,159.30666666666664,16.512,312,348,36,chroma_acts_smoothed
529,8,159.30666666666664,172.14933333333332,12.842666666666673,348,376,28,chroma_acts_smoothed
529,9,172.14933333333332,216.289,44.13966666666667,376,471,95,chroma_acts_smoothed
529,1,0.0,7.4879999999999995,7.4879999999999995,0,17,17,ki_chroma
529,2,7.4879999999999995,18.496,11.008,17,41,24,ki_chroma
529,3,18.496,40.05333333333333,21.55733333333333,41,88,47,ki_chroma
529,4,40.05333333333333,102.89066666666666,62.83733333333333,88,225,137,ki_chroma
529,5,102.89066666666666,143.25333333333333,40.36266666666667,225,313,88,ki_chroma
529,6,143.25333333333333,157.93066666666667,14.677333333333337,313,345,32,ki_chroma
529,7,157.93066666666667,168.02133333333333,10.090666666666664,345,367,22,ki_chroma
529,8,168.02133333333333,172.14933333333332,4.127999999999986,367,376,9,ki_chroma
529,9,172.14933333333332,216.289,44.13966666666667,376,471,95,ki_chroma
529,1,0.0,7.4879999999999995,7.4879999999999995,0,17,17,ki_chroma_acts
529,2,7.4879999999999995,11.157333333333332,3.6693333333333324,17,25,8,ki_chroma_acts
529,3,11.157333333333332,14.826666666666666,3.6693333333333342,25,33,8,ki_chroma_acts
529,4,14.826666666666666,18.496,3.6693333333333324,33,41,8,ki_chroma_acts
529,5,18.496,40.05333333333333,21.55733333333333,41,88,47,ki_chroma_acts
529,6,40.05333333333333,102.89066666666666,62.83733333333333,88,225,137,ki_chroma_acts
529,7,102.89066666666666,143.25333333333333,40.36266666666667,225,313,88,ki_chroma_acts
529,8,143.25333333333333,158.38933333333333,15.135999999999996,313,346,33,ki_chroma_acts
529,9,158.38933333333333,216.289,57.89966666666666,346,471,125,ki_chroma_acts
529,1,0.0,7.4879999999999995,7.4879999999999995,0,17,17,ki_chroma_acts_smoothed
529,2,7.4879999999999995,11.157333333333332,3.6693333333333324,17,25,8,ki_chroma_acts_smoothed
529,3,11.157333333333332,18.496,7.338666666666667,25,41,16,ki_chroma_acts_smoothed
529,4,18.496,40.51199999999999,22.015999999999995,41,89,48,ki_chroma_acts_smoothed
529,5,40.51199999999999,102.89066666666666,62.37866666666667,89,225,136,ki_chroma_acts_smoothed
529,6,102.89066666666666,142.79466666666664,39.90399999999998,225,312,87,ki_chroma_acts_smoothed
529,7,142.79466666666664,159.30666666666664,16.512,312,348,36,ki_chroma_acts_smoothed
529,8,159.30666666666664,172.14933333333332,12.842666666666673,348,376,28,ki_chroma_acts_smoothed
529,9,172.14933333333332,216.289,44.13966666666667,376,471,95,ki_chroma_acts_smoothed
530,1,0.0,31.509333333333334,31.509333333333334,0,68,68,chromagram
530,2,31.509333333333334,46.05866666666667,14.549333333333333,68,99,31,chromagram
530,3,46.05866666666667,49.81333333333333,3.7546666666666653,99,107,8,chromagram
530,4,49.81333333333333,88.768,38.95466666666667,107,190,83,chromagram
530,5,88.768,94.86933333333333,6.101333333333329,190,203,13,chromagram
530,6,94.86933333333333,125.37599999999999,30.50666666666666,203,268,65,chromagram
530,7,125.37599999999999,145.08800000000002,19.71200000000003,268,310,42,chromagram
530,8,145.08800000000002,158.69866666666667,13.610666666666646,310,339,29,chromagram
530,9,158.69866666666667,193.075,34.37633333333332,339,411,72,chromagram
530,1,0.0,31.509333333333334,31.509333333333334,0,68,68,chroma_acts
530,2,31.509333333333334,46.05866666666667,14.549333333333333,68,99,31,chroma_acts
530,3,46.05866666666667,49.81333333333333,3.7546666666666653,99,107,8,chroma_acts
530,4,49.81333333333333,91.11466666666666,41.30133333333333,107,195,88,chroma_acts
530,5,91.11466666666666,121.62133333333333,30.50666666666666,195,260,65,chroma_acts
530,6,121.62133333333333,125.37599999999999,3.7546666666666653,260,268,8,chroma_acts
530,7,125.37599999999999,144.61866666666668,19.242666666666693,268,309,41,chroma_acts
530,8,144.61866666666668,158.69866666666667,14.079999999999984,309,339,30,chroma_acts
530,9,158.69866666666667,193.075,34.37633333333332,339,411,72,chroma_acts
530,1,0.0,31.509333333333334,31.509333333333334,0,68,68,chroma_acts_smoothed
530,2,31.509333333333334,50.28266666666667,18.773333333333337,68,108,40,chroma_acts_smoothed
530,3,50.28266666666667,91.58399999999999,41.30133333333332,108,196,88,chroma_acts_smoothed
530,4,91.58399999999999,121.62133333333333,30.037333333333336,196,260,64,chroma_acts_smoothed
530,5,121.62133333333333,125.84533333333333,4.224000000000004,260,269,9,chroma_acts_smoothed
530,6,125.84533333333333,146.02666666666667,20.181333333333342,269,312,43,chroma_acts_smoothed
530,7,146.02666666666667,154.00533333333334,7.978666666666669,312,329,17,chroma_acts_smoothed
530,8,154.00533333333334,158.22933333333333,4.2239999999999895,329,338,9,chroma_acts_smoothed
530,9,158.22933333333333,193.075,34.84566666666666,338,411,73,chroma_acts_smoothed
530,1,0.0,31.509333333333334,31.509333333333334,0,68,68,ki_chroma
530,2,31.509333333333334,46.05866666666667,14.549333333333333,68,99,31,ki_chroma
530,3,46.05866666666667,49.81333333333333,3.7546666666666653,99,107,8,ki_chroma
530,4,49.81333333333333,88.768,38.95466666666667,107,190,83,ki_chroma
530,5,88.768,94.86933333333333,6.101333333333329,190,203,13,ki_chroma
530,6,94.86933333333333,125.37599999999999,30.50666666666666,203,268,65,ki_chroma
530,7,125.37599999999999,145.08800000000002,19.71200000000003,268,310,42,ki_chroma
530,8,145.08800000000002,158.69866666666667,13.610666666666646,310,339,29,ki_chroma
530,9,158.69866666666667,193.075,34.37633333333332,339,411,72,ki_chroma
530,1,0.0,31.509333333333334,31.509333333333334,0,68,68,ki_chroma_acts
530,2,31.509333333333334,46.05866666666667,14.549333333333333,68,99,31,ki_chroma_acts
530,3,46.05866666666667,49.81333333333333,3.7546666666666653,99,107,8,ki_chroma_acts
530,4,49.81333333333333,91.11466666666666,41.30133333333333,107,195,88,ki_chroma_acts
530,5,91.11466666666666,121.62133333333333,30.50666666666666,195,260,65,ki_chroma_acts
530,6,121.62133333333333,125.37599999999999,3.7546666666666653,260,268,8,ki_chroma_acts
530,7,125.37599999999999,144.61866666666668,19.242666666666693,268,309,41,ki_chroma_acts
530,8,144.61866666666668,158.69866666666667,14.079999999999984,309,339,30,ki_chroma_acts
530,9,158.69866666666667,193.075,34.37633333333332,339,411,72,ki_chroma_acts
530,1,0.0,31.509333333333334,31.509333333333334,0,68,68,ki_chroma_acts_smoothed
530,2,31.509333333333334,50.28266666666667,18.773333333333337,68,108,40,ki_chroma_acts_smoothed
530,3,50.28266666666667,91.58399999999999,41.30133333333332,108,196,88,ki_chroma_acts_smoothed
530,4,91.58399999999999,121.62133333333333,30.037333333333336,196,260,64,ki_chroma_acts_smoothed
530,5,121.62133333333333,125.84533333333333,4.224000000000004,260,269,9,ki_chroma_acts_smoothed
530,6,125.84533333333333,146.02666666666667,20.181333333333342,269,312,43,ki_chroma_acts_smoothed
530,7,146.02666666666667,154.00533333333334,7.978666666666669,312,329,17,ki_chroma_acts_smoothed
530,8,154.00533333333334,158.22933333333333,4.2239999999999895,329,338,9,ki_chroma_acts_smoothed
530,9,158.22933333333333,193.075,34.84566666666666,338,411,73,ki_chroma_acts_smoothed
533,1,0.0,9.226666666666667,9.226666666666667,0,20,20,chromagram
533,2,9.226666666666667,16.906666666666666,7.68,20,36,16,chromagram
533,3,16.906666666666666,24.586666666666666,7.68,36,52,16,chromagram
533,4,24.586666666666666,31.786666666666665,7.199999999999999,52,67,15,chromagram
533,5,31.786666666666665,45.70666666666667,13.920000000000005,67,96,29,chromagram
533,6,45.70666666666667,91.30666666666667,45.6,96,191,95,chromagram
533,7,91.30666666666667,123.46666666666667,32.16,191,258,67,chromagram
533,8,123.46666666666667,136.90666666666664,13.43999999999997,258,286,28,chromagram
533,9,136.90666666666664,170.017,33.11033333333336,286,353,67,chromagram
533,1,0.0,9.226666666666667,9.226666666666667,0,20,20,chroma_acts
533,2,9.226666666666667,16.906666666666666,7.68,20,36,16,chroma_acts
533,3,16.906666666666666,24.586666666666666,7.68,36,52,16,chroma_acts
533,4,24.586666666666666,31.786666666666665,7.199999999999999,52,67,15,chroma_acts
533,5,31.786666666666665,93.22666666666666,61.44,67,195,128,chroma_acts
533,6,93.22666666666666,100.90666666666667,7.680000000000007,195,211,16,chroma_acts
533,7,100.90666666666667,108.10666666666667,7.200000000000003,211,226,15,chroma_acts
533,8,108.10666666666667,115.78666666666666,7.679999999999993,226,242,16,chroma_acts
533,9,115.78666666666666,170.017,54.230333333333334,242,353,111,chroma_acts
533,1,0.0,9.226666666666667,9.226666666666667,0,20,20,chroma_acts_smoothed
533,2,9.226666666666667,16.906666666666666,7.68,20,36,16,chroma_acts_smoothed
533,3,16.906666666666666,24.586666666666666,7.68,36,52,16,chroma_acts_smoothed
533,4,24.586666666666666,31.786666666666665,7.199999999999999,52,67,15,chroma_acts_smoothed
533,5,31.786666666666665,93.22666666666666,61.44,67,195,128,chroma_acts_smoothed
533,6,93.22666666666666,100.90666666666667,7.680000000000007,195,211,16,chroma_acts_smoothed
533,7,100.90666666666667,108.10666666666667,7.200000000000003,211,226,15,chroma_acts_smoothed
533,8,108.10666666666667,115.78666666666666,7.679999999999993,226,242,16,chroma_acts_smoothed
533,9,115.78666666666666,170.017,54.230333333333334,242,353,111,chroma_acts_smoothed
533,1,0.0,9.226666666666667,9.226666666666667,0,20,20,ki_chroma
533,2,9.226666666666667,16.906666666666666,7.68,20,36,16,ki_chroma
533,3,16.906666666666666,24.586666666666666,7.68,36,52,16,ki_chroma
533,4,24.586666666666666,31.786666666666665,7.199999999999999,52,67,15,ki_chroma
533,5,31.786666666666665,45.70666666666667,13.920000000000005,67,96,29,ki_chroma
533,6,45.70666666666667,91.30666666666667,45.6,96,191,95,ki_chroma
533,7,91.30666666666667,123.46666666666667,32.16,191,258,67,ki_chroma
533,8,123.46666666666667,136.90666666666664,13.43999999999997,258,286,28,ki_chroma
533,9,136.90666666666664,170.017,33.11033333333336,286,353,67,ki_chroma
533,1,0.0,9.226666666666667,9.226666666666667,0,20,20,ki_chroma_acts
533,2,9.226666666666667,16.906666666666666,7.68,20,36,16,ki_chroma_acts
533,3,16.906666666666666,24.586666666666666,7.68,36,52,16,ki_chroma_acts
533,4,24.586666666666666,31.786666666666665,7.199999999999999,52,67,15,ki_chroma_acts
533,5,31.786666666666665,93.22666666666666,61.44,67,195,128,ki_chroma_acts
533,6,93.22666666666666,100.90666666666667,7.680000000000007,195,211,16,ki_chroma_acts
533,7,100.90666666666667,108.10666666666667,7.200000000000003,211,226,15,ki_chroma_acts
533,8,108.10666666666667,115.78666666666666,7.679999999999993,226,242,16,ki_chroma_acts
533,9,115.78666666666666,170.017,54.230333333333334,242,353,111,ki_chroma_acts
533,1,0.0,9.226666666666667,9.226666666666667,0,20,20,ki_chroma_acts_smoothed
533,2,9.226666666666667,16.906666666666666,7.68,20,36,16,ki_chroma_acts_smoothed
533,3,16.906666666666666,24.586666666666666,7.68,36,52,16,ki_chroma_acts_smoothed
533,4,24.586666666666666,31.786666666666665,7.199999999999999,52,67,15,ki_chroma_acts_smoothed
533,5,31.786666666666665,93.22666666666666,61.44,67,195,128,ki_chroma_acts_smoothed
533,6,93.22666666666666,100.90666666666667,7.680000000000007,195,211,16,ki_chroma_acts_smoothed
533,7,100.90666666666667,108.10666666666667,7.200000000000003,211,226,15,ki_chroma_acts_smoothed
533,8,108.10666666666667,115.78666666666666,7.679999999999993,226,242,16,ki_chroma_acts_smoothed
533,9,115.78666666666666,170.017,54.230333333333334,242,353,111,ki_chroma_acts_smoothed
534,1,0.0,5.546666666666666,5.546666666666666,0,12,12,chromagram
534,2,5.546666666666666,22.826666666666664,17.279999999999998,12,48,36,chromagram
534,3,22.826666666666664,35.306666666666665,12.48,48,74,26,chromagram
534,4,35.306666666666665,81.86666666666666,46.559999999999995,74,171,97,chromagram
534,5,81.86666666666666,83.78666666666666,1.9200000000000017,171,175,4,chromagram
534,6,83.78666666666666,109.22666666666666,25.439999999999998,175,228,53,chromagram
534,7,109.22666666666666,123.14666666666666,13.920000000000002,228,257,29,chromagram
534,8,123.14666666666666,170.953,47.80633333333334,257,355,98,chromagram
534,1,0.0,5.546666666666666,5.546666666666666,0,12,12,chroma_acts
534,2,5.546666666666666,22.826666666666664,17.279999999999998,12,48,36,chroma_acts
534,3,22.826666666666664,37.22666666666667,14.400000000000002,48,78,30,chroma_acts
534,4,37.22666666666667,81.86666666666666,44.63999999999999,78,171,93,chroma_acts
534,5,81.86666666666666,83.78666666666666,1.9200000000000017,171,175,4,chroma_acts
534,6,83.78666666666666,109.22666666666666,25.439999999999998,175,228,53,chroma_acts
534,7,109.22666666666666,121.70666666666666,12.480000000000004,228,254,26,chroma_acts
534,8,121.70666666666666,170.953,49.24633333333334,254,355,101,chroma_acts
534,1,0.0,5.546666666666666,5.546666666666666,0,12,12,chroma_acts_smoothed
534,2,5.546666666666666,25.226666666666667,19.68,12,53,41,chroma_acts_smoothed
534,3,25.226666666666667,35.306666666666665,10.079999999999998,53,74,21,chroma_acts_smoothed
534,4,35.306666666666665,37.70666666666666,2.3999999999999986,74,79,5,chroma_acts_smoothed
534,5,37.70666666666666,84.26666666666667,46.56,79,176,97,chroma_acts_smoothed
534,6,84.26666666666667,109.22666666666666,24.959999999999994,176,228,52,chroma_acts_smoothed
534,7,109.22666666666666,122.66666666666666,13.439999999999998,228,256,28,chroma_acts_smoothed
534,8,122.66666666666666,170.953,48.286333333333346,256,355,99,chroma_acts_smoothed
534,1,0.0,5.546666666666666,5.546666666666666,0,12,12,ki_chroma
534,2,5.546666666666666,22.826666666666664,17.279999999999998,12,48,36,ki_chroma
534,3,22.826666666666664,35.306666666666665,12.48,48,74,26,ki_chroma
534,4,35.306666666666665,81.86666666666666,46.559999999999995,74,171,97,ki_chroma
534,5,81.86666666666666,83.78666666666666,1.9200000000000017,171,175,4,ki_chroma
534,6,83.78666666666666,109.22666666666666,25.439999999999998,175,228,53,ki_chroma
534,7,109.22666666666666,123.14666666666666,13.920000000000002,228,257,29,ki_chroma
534,8,123.14666666666666,170.953,47.80633333333334,257,355,98,ki_chroma
534,1,0.0,5.546666666666666,5.546666666666666,0,12,12,ki_chroma_acts
534,2,5.546666666666666,22.826666666666664,17.279999999999998,12,48,36,ki_chroma_acts
534,3,22.826666666666664,37.22666666666667,14.400000000000002,48,78,30,ki_chroma_acts
534,4,37.22666666666667,81.86666666666666,44.63999999999999,78,171,93,ki_chroma_acts
534,5,81.86666666666666,83.78666666666666,1.9200000000000017,171,175,4,ki_chroma_acts
534,6,83.78666666666666,109.22666666666666,25.439999999999998,175,228,53,ki_chroma_acts
534,7,109.22666666666666,121.70666666666666,12.480000000000004,228,254,26,ki_chroma_acts
534,8,121.70666666666666,170.953,49.24633333333334,254,355,101,ki_chroma_acts
534,1,0.0,5.546666666666666,5.546666666666666,0,12,12,ki_chroma_acts_smoothed
534,2,5.546666666666666,25.226666666666667,19.68,12,53,41,ki_chroma_acts_smoothed
534,3,25.226666666666667,35.306666666666665,10.079999999999998,53,74,21,ki_chroma_acts_smoothed
534,4,35.306666666666665,37.70666666666666,2.3999999999999986,74,79,5,ki_chroma_acts_smoothed
534,5,37.70666666666666,84.26666666666667,46.56,79,176,97,ki_chroma_acts_smoothed
534,6,84.26666666666667,109.22666666666666,24.959999999999994,176,228,52,ki_chroma_acts_smoothed
534,7,109.22666666666666,122.66666666666666,13.439999999999998,228,256,28,ki_chroma_acts_smoothed
534,8,122.66666666666666,170.953,48.286333333333346,256,355,99,ki_chroma_acts_smoothed
535,1,0.0,8.725333333333333,8.725333333333333,0,19,19,chromagram
535,2,8.725333333333333,30.80533333333333,22.08,19,65,46,chromagram
535,3,30.80533333333333,37.52533333333333,6.719999999999999,65,79,14,chromagram
535,4,37.52533333333333,72.08533333333332,34.559999999999995,79,151,72,chromagram
535,5,72.08533333333332,88.88533333333334,16.80000000000001,151,186,35,chromagram
535,6,88.88533333333334,118.16533333333332,29.279999999999987,186,247,61,chromagram
535,7,118.16533333333332,140.24533333333332,22.08,247,293,46,chromagram
535,8,140.24533333333332,181.52533333333332,41.28,293,379,86,chromagram
535,9,181.52533333333332,189.765,8.239666666666665,379,395,16,chromagram
535,1,0.0,8.725333333333333,8.725333333333333,0,19,19,chroma_acts
535,2,8.725333333333333,30.80533333333333,22.08,19,65,46,chroma_acts
535,3,30.80533333333333,67.28533333333333,36.48,65,141,76,chroma_acts
535,4,67.28533333333333,72.08533333333332,4.799999999999997,141,151,10,chroma_acts
535,5,72.08533333333332,90.32533333333333,18.24000000000001,151,189,38,chroma_acts
535,6,90.32533333333333,118.16533333333332,27.83999999999999,189,247,58,chroma_acts
535,7,118.16533333333332,140.24533333333332,22.08,247,293,46,chroma_acts
535,8,140.24533333333332,181.52533333333332,41.28,293,379,86,chroma_acts
535,9,181.52533333333332,189.765,8.239666666666665,379,395,16,chroma_acts
535,1,0.0,8.245333333333333,8.245333333333333,0,18,18,chroma_acts_smoothed
535,2,8.245333333333333,24.08533333333333,15.839999999999998,18,51,33,chroma_acts_smoothed
535,3,24.08533333333333,41.36533333333333,17.28,51,87,36,chroma_acts_smoothed
535,4,41.36533333333333,90.32533333333333,48.96,87,189,102,chroma_acts_smoothed
535,5,90.32533333333333,118.16533333333332,27.83999999999999,189,247,58,chroma_acts_smoothed
535,6,118.16533333333332,140.24533333333332,22.08,247,293,46,chroma_acts_smoothed
535,7,140.24533333333332,146.96533333333332,6.719999999999999,293,307,14,chroma_acts_smoothed
535,8,146.96533333333332,181.52533333333332,34.56,307,379,72,chroma_acts_smoothed
535,9,181.52533333333332,189.765,8.239666666666665,379,395,16,chroma_acts_smoothed
535,1,0.0,8.725333333333333,8.725333333333333,0,19,19,ki_chroma
535,2,8.725333333333333,30.80533333333333,22.08,19,65,46,ki_chroma
535,3,30.80533333333333,37.52533333333333,6.719999999999999,65,79,14,ki_chroma
535,4,37.52533333333333,72.08533333333332,34.559999999999995,79,151,72,ki_chroma
535,5,72.08533333333332,88.88533333333334,16.80000000000001,151,186,35,ki_chroma
535,6,88.88533333333334,118.16533333333332,29.279999999999987,186,247,61,ki_chroma
535,7,118.16533333333332,140.24533333333332,22.08,247,293,46,ki_chroma
535,8,140.24533333333332,181.52533333333332,41.28,293,379,86,ki_chroma
535,9,181.52533333333332,189.765,8.239666666666665,379,395,16,ki_chroma
535,1,0.0,8.725333333333333,8.725333333333333,0,19,19,ki_chroma_acts
535,2,8.725333333333333,30.80533333333333,22.08,19,65,46,ki_chroma_acts
535,3,30.80533333333333,67.28533333333333,36.48,65,141,76,ki_chroma_acts
535,4,67.28533333333333,72.08533333333332,4.799999999999997,141,151,10,ki_chroma_acts
535,5,72.08533333333332,90.32533333333333,18.24000000000001,151,189,38,ki_chroma_acts
535,6,90.32533333333333,118.16533333333332,27.83999999999999,189,247,58,ki_chroma_acts
535,7,118.16533333333332,140.24533333333332,22.08,247,293,46,ki_chroma_acts
535,8,140.24533333333332,181.52533333333332,41.28,293,379,86,ki_chroma_acts
535,9,181.52533333333332,189.765,8.239666666666665,379,395,16,ki_chroma_acts
535,1,0.0,8.245333333333333,8.245333333333333,0,18,18,ki_chroma_acts_smoothed
535,2,8.245333333333333,24.08533333333333,15.839999999999998,18,51,33,ki_chroma_acts_smoothed
535,3,24.08533333333333,41.36533333333333,17.28,51,87,36,ki_chroma_acts_smoothed
535,4,41.36533333333333,90.32533333333333,48.96,87,189,102,ki_chroma_acts_smoothed
535,5,90.32533333333333,118.16533333333332,27.83999999999999,189,247,58,ki_chroma_acts_smoothed
535,6,118.16533333333332,140.24533333333332,22.08,247,293,46,ki_chroma_acts_smoothed
535,7,140.24533333333332,146.96533333333332,6.719999999999999,293,307,14,ki_chroma_acts_smoothed
535,8,146.96533333333332,181.52533333333332,34.56,307,379,72,ki_chroma_acts_smoothed
535,9,181.52533333333332,189.765,8.239666666666665,379,395,16,ki_chroma_acts_smoothed
540,1,0.0,31.893333333333334,31.893333333333334,0,68,68,chromagram
540,2,31.893333333333334,77.41866666666665,45.52533333333332,68,165,97,chromagram
540,3,77.41866666666665,107.45599999999999,30.037333333333336,165,229,64,chromagram
540,4,107.45599999999999,121.06666666666666,13.610666666666674,229,258,29,chromagram
540,5,121.06666666666666,122.47466666666666,1.4080000000000013,258,261,3,chromagram
540,6,122.47466666666666,151.57333333333335,29.098666666666688,261,323,62,chromagram
540,7,151.57333333333335,152.98133333333334,1.407999999999987,323,326,3,chromagram
540,8,152.98133333333334,169.33,16.348666666666674,326,359,33,chromagram
540,1,0.0,31.893333333333334,31.893333333333334,0,68,68,chroma_acts
540,2,31.893333333333334,60.522666666666666,28.62933333333333,68,129,61,chroma_acts
540,3,60.522666666666666,62.4,1.8773333333333326,129,133,4,chroma_acts
540,4,62.4,77.41866666666665,15.018666666666654,133,165,32,chroma_acts
540,5,77.41866666666665,107.45599999999999,30.037333333333336,165,229,64,chroma_acts
540,6,107.45599999999999,121.06666666666666,13.610666666666674,229,258,29,chroma_acts
540,7,121.06666666666666,122.47466666666666,1.4080000000000013,258,261,3,chroma_acts
540,8,122.47466666666666,169.33,46.85533333333335,261,359,98,chroma_acts
540,1,0.0,31.893333333333334,31.893333333333334,0,68,68,chroma_acts_smoothed
540,2,31.893333333333334,60.522666666666666,28.62933333333333,68,129,61,chroma_acts_smoothed
540,3,60.522666666666666,62.4,1.8773333333333326,129,133,4,chroma_acts_smoothed
540,4,62.4,77.41866666666665,15.018666666666654,133,165,32,chroma_acts_smoothed
540,5,77.41866666666665,107.45599999999999,30.037333333333336,165,229,64,chroma_acts_smoothed
540,6,107.45599999999999,150.63466666666667,43.178666666666686,229,321,92,chroma_acts_smoothed
540,7,150.63466666666667,152.98133333333334,2.346666666666664,321,326,5,chroma_acts_smoothed
540,8,152.98133333333334,169.33,16.348666666666674,326,359,33,chroma_acts_smoothed
540,1,0.0,31.893333333333334,31.893333333333334,0,68,68,ki_chroma
540,2,31.893333333333334,77.41866666666665,45.52533333333332,68,165,97,ki_chroma
540,3,77.41866666666665,107.45599999999999,30.037333333333336,165,229,64,ki_chroma
540,4,107.45599999999999,121.06666666666666,13.610666666666674,229,258,29,ki_chroma
540,5,121.06666666666666,122.47466666666666,1.4080000000000013,258,261,3,ki_chroma
540,6,122.47466666666666,151.57333333333335,29.098666666666688,261,323,62,ki_chroma
540,7,151.57333333333335,152.98133333333334,1.407999999999987,323,326,3,ki_chroma
540,8,152.98133333333334,169.33,16.348666666666674,326,359,33,ki_chroma
540,1,0.0,31.893333333333334,31.893333333333334,0,68,68,ki_chroma_acts
540,2,31.893333333333334,60.522666666666666,28.62933333333333,68,129,61,ki_chroma_acts
540,3,60.522666666666666,62.4,1.8773333333333326,129,133,4,ki_chroma_acts
540,4,62.4,77.41866666666665,15.018666666666654,133,165,32,ki_chroma_acts
540,5,77.41866666666665,107.45599999999999,30.037333333333336,165,229,64,ki_chroma_acts
540,6,107.45599999999999,121.06666666666666,13.610666666666674,229,258,29,ki_chroma_acts
540,7,121.06666666666666,122.47466666666666,1.4080000000000013,258,261,3,ki_chroma_acts
540,8,122.47466666666666,169.33,46.85533333333335,261,359,98,ki_chroma_acts
540,1,0.0,31.893333333333334,31.893333333333334,0,68,68,ki_chroma_acts_smoothed
540,2,31.893333333333334,60.522666666666666,28.62933333333333,68,129,61,ki_chroma_acts_smoothed
540,3,60.522666666666666,62.4,1.8773333333333326,129,133,4,ki_chroma_acts_smoothed
540,4,62.4,77.41866666666665,15.018666666666654,133,165,32,ki_chroma_acts_smoothed
540,5,77.41866666666665,107.45599999999999,30.037333333333336,165,229,64,ki_chroma_acts_smoothed
540,6,107.45599999999999,150.63466666666667,43.178666666666686,229,321,92,ki_chroma_acts_smoothed
540,7,150.63466666666667,152.98133333333334,2.346666666666664,321,326,5,ki_chroma_acts_smoothed
540,8,152.98133333333334,169.33,16.348666666666674,326,359,33,ki_chroma_acts_smoothed
543,1,0.0,20.864,20.864,0,45,45,chromagram
543,2,20.864,29.781333333333333,8.917333333333332,45,64,19,chromagram
543,3,29.781333333333333,71.55199999999999,41.770666666666656,64,153,89,chromagram
543,4,71.55199999999999,75.30666666666666,3.7546666666666653,153,161,8,chromagram
543,5,75.30666666666666,109.09866666666666,33.792,161,233,72,chromagram
543,6,109.09866666666666,126.464,17.36533333333334,233,270,37,chromagram
543,7,126.464,135.38133333333334,8.917333333333346,270,289,19,chromagram
543,8,135.38133333333334,166.35733333333334,30.976,289,355,66,chromagram
543,9,166.35733333333334,184.329,17.971666666666664,355,392,37,chromagram
543,1,0.0,20.394666666666666,20.394666666666666,0,44,44,chroma_acts
543,2,20.394666666666666,27.904,7.509333333333334,44,60,16,chroma_acts
543,3,27.904,66.38933333333333,38.48533333333333,60,142,82,chroma_acts
543,4,66.38933333333333,75.30666666666666,8.917333333333332,142,161,19,chroma_acts
543,5,75.30666666666666,106.28266666666666,30.976,161,227,66,chroma_acts
543,6,106.28266666666666,126.464,20.181333333333342,227,270,43,chroma_acts
543,7,126.464,135.38133333333334,8.917333333333346,270,289,19,chroma_acts
543,8,135.38133333333334,166.35733333333334,30.976,289,355,66,chroma_acts
543,9,166.35733333333334,184.329,17.971666666666664,355,392,37,chroma_acts
543,1,0.0,20.864,20.864,0,45,45,chroma_acts_smoothed
543,2,20.864,29.781333333333333,8.917333333333332,45,64,19,chroma_acts_smoothed
543,3,29.781333333333333,71.08266666666667,41.30133333333333,64,152,88,chroma_acts_smoothed
543,4,71.08266666666667,75.30666666666666,4.2239999999999895,152,161,9,chroma_acts_smoothed
543,5,75.30666666666666,106.28266666666666,30.976,161,227,66,chroma_acts_smoothed
543,6,106.28266666666666,126.464,20.181333333333342,227,270,43,chroma_acts_smoothed
543,7,126.464,135.85066666666668,9.386666666666684,270,290,20,chroma_acts_smoothed
543,8,135.85066666666668,166.35733333333334,30.50666666666666,290,355,65,chroma_acts_smoothed
543,9,166.35733333333334,184.329,17.971666666666664,355,392,37,chroma_acts_smoothed
543,1,0.0,20.864,20.864,0,45,45,ki_chroma
543,2,20.864,29.781333333333333,8.917333333333332,45,64,19,ki_chroma
543,3,29.781333333333333,71.55199999999999,41.770666666666656,64,153,89,ki_chroma
543,4,71.55199999999999,75.30666666666666,3.7546666666666653,153,161,8,ki_chroma
543,5,75.30666666666666,109.09866666666666,33.792,161,233,72,ki_chroma
543,6,109.09866666666666,126.464,17.36533333333334,233,270,37,ki_chroma
543,7,126.464,135.38133333333334,8.917333333333346,270,289,19,ki_chroma
543,8,135.38133333333334,166.35733333333334,30.976,289,355,66,ki_chroma
543,9,166.35733333333334,184.329,17.971666666666664,355,392,37,ki_chroma
543,1,0.0,20.394666666666666,20.394666666666666,0,44,44,ki_chroma_acts
543,2,20.394666666666666,27.904,7.509333333333334,44,60,16,ki_chroma_acts
543,3,27.904,66.38933333333333,38.48533333333333,60,142,82,ki_chroma_acts
543,4,66.38933333333333,75.30666666666666,8.917333333333332,142,161,19,ki_chroma_acts
543,5,75.30666666666666,106.28266666666666,30.976,161,227,66,ki_chroma_acts
543,6,106.28266666666666,126.464,20.181333333333342,227,270,43,ki_chroma_acts
543,7,126.464,135.38133333333334,8.917333333333346,270,289,19,ki_chroma_acts
543,8,135.38133333333334,166.35733333333334,30.976,289,355,66,ki_chroma_acts
543,9,166.35733333333334,184.329,17.971666666666664,355,392,37,ki_chroma_acts
543,1,0.0,20.864,20.864,0,45,45,ki_chroma_acts_smoothed
543,2,20.864,29.781333333333333,8.917333333333332,45,64,19,ki_chroma_acts_smoothed
543,3,29.781333333333333,71.08266666666667,41.30133333333333,64,152,88,ki_chroma_acts_smoothed
543,4,71.08266666666667,75.30666666666666,4.2239999999999895,152,161,9,ki_chroma_acts_smoothed
543,5,75.30666666666666,106.28266666666666,30.976,161,227,66,ki_chroma_acts_smoothed
543,6,106.28266666666666,126.464,20.181333333333342,227,270,43,ki_chroma_acts_smoothed
543,7,126.464,135.85066666666668,9.386666666666684,270,290,20,ki_chroma_acts_smoothed
543,8,135.85066666666668,166.35733333333334,30.50666666666666,290,355,65,ki_chroma_acts_smoothed
543,9,166.35733333333334,184.329,17.971666666666664,355,392,37,ki_chroma_acts_smoothed
544,1,0.0,49.94133333333333,49.94133333333333,0,105,105,chromagram
544,2,49.94133333333333,53.30133333333333,3.3599999999999994,105,112,7,chromagram
544,3,53.30133333333333,56.66133333333333,3.3599999999999994,112,119,7,chromagram
544,4,56.66133333333333,91.22133333333333,34.56,119,191,72,chromagram
544,5,91.22133333333333,148.8213333333333,57.59999999999998,191,311,120,chromagram
544,6,148.8213333333333,154.5813333333333,5.759999999999991,311,323,12,chromagram
544,7,154.5813333333333,182.90133333333333,28.32000000000002,323,382,59,chromagram
544,8,182.90133333333333,289.524,106.62266666666667,382,603,221,chromagram
544,1,0.0,49.94133333333333,49.94133333333333,0,105,105,chroma_acts
544,2,49.94133333333333,91.22133333333333,41.28,105,191,86,chroma_acts
544,3,91.22133333333333,116.18133333333333,24.959999999999994,191,243,52,chroma_acts
544,4,116.18133333333333,121.94133333333333,5.760000000000005,243,255,12,chroma_acts
544,5,121.94133333333333,146.90133333333333,24.959999999999994,255,307,52,chroma_acts
544,6,146.90133333333333,155.5413333333333,8.639999999999986,307,325,18,chroma_acts
544,7,155.5413333333333,182.90133333333333,27.360000000000014,325,382,57,chroma_acts
544,8,182.90133333333333,289.524,106.62266666666667,382,603,221,chroma_acts
544,1,0.0,49.94133333333333,49.94133333333333,0,105,105,chroma_acts_smoothed
544,2,49.94133333333333,60.98133333333333,11.04,105,128,23,chroma_acts_smoothed
544,3,60.98133333333333,91.22133333333333,30.240000000000002,128,191,63,chroma_acts_smoothed
544,4,91.22133333333333,116.18133333333333,24.959999999999994,191,243,52,chroma_acts_smoothed
544,5,116.18133333333333,121.94133333333333,5.760000000000005,243,255,12,chroma_acts_smoothed
544,6,121.94133333333333,146.90133333333333,24.959999999999994,255,307,52,chroma_acts_smoothed
544,7,146.90133333333333,182.4213333333333,35.51999999999998,307,381,74,chroma_acts_smoothed
544,8,182.4213333333333,289.524,107.10266666666669,381,603,222,chroma_acts_smoothed
544,1,0.0,49.94133333333333,49.94133333333333,0,105,105,ki_chroma
544,2,49.94133333333333,53.30133333333333,3.3599999999999994,105,112,7,ki_chroma
544,3,53.30133333333333,56.66133333333333,3.3599999999999994,112,119,7,ki_chroma
544,4,56.66133333333333,91.22133333333333,34.56,119,191,72,ki_chroma
544,5,91.22133333333333,148.8213333333333,57.59999999999998,191,311,120,ki_chroma
544,6,148.8213333333333,154.5813333333333,5.759999999999991,311,323,12,ki_chroma
544,7,154.5813333333333,182.90133333333333,28.32000000000002,323,382,59,ki_chroma
544,8,182.90133333333333,289.524,106.62266666666667,382,603,221,ki_chroma
544,1,0.0,49.94133333333333,49.94133333333333,0,105,105,ki_chroma_acts
544,2,49.94133333333333,91.22133333333333,41.28,105,191,86,ki_chroma_acts
544,3,91.22133333333333,116.18133333333333,24.959999999999994,191,243,52,ki_chroma_acts
544,4,116.18133333333333,121.94133333333333,5.760000000000005,243,255,12,ki_chroma_acts
544,5,121.94133333333333,146.90133333333333,24.959999999999994,255,307,52,ki_chroma_acts
544,6,146.90133333333333,155.5413333333333,8.639999999999986,307,325,18,ki_chroma_acts
544,7,155.5413333333333,182.90133333333333,27.360000000000014,325,382,57,ki_chroma_acts
544,8,182.90133333333333,289.524,106.62266666666667,382,603,221,ki_chroma_acts
544,1,0.0,49.94133333333333,49.94133333333333,0,105,105,ki_chroma_acts_smoothed
544,2,49.94133333333333,60.98133333333333,11.04,105,128,23,ki_chroma_acts_smoothed
544,3,60.98133333333333,91.22133333333333,30.240000000000002,128,191,63,ki_chroma_acts_smoothed
544,4,91.22133333333333,116.18133333333333,24.959999999999994,191,243,52,ki_chroma_acts_smoothed
544,5,116.18133333333333,121.94133333333333,5.760000000000005,243,255,12,ki_chroma_acts_smoothed
544,6,121.94133333333333,146.90133333333333,24.959999999999994,255,307,52,ki_chroma_acts_smoothed
544,7,146.90133333333333,182.4213333333333,35.51999999999998,307,381,74,ki_chroma_acts_smoothed
544,8,182.4213333333333,289.524,107.10266666666669,381,603,222,ki_chroma_acts_smoothed
545,1,0.0,18.336,18.336,0,40,40,chromagram
545,2,18.336,33.824,15.488,40,73,33,chromagram
545,3,33.824,48.84266666666666,15.018666666666661,73,105,32,chromagram
545,4,48.84266666666666,78.88,30.037333333333336,105,169,64,chromagram
545,5,78.88,86.38933333333333,7.5093333333333305,169,185,16,chromagram
545,6,86.38933333333333,89.67466666666667,3.285333333333341,185,192,7,chromagram
545,7,89.67466666666667,97.184,7.5093333333333305,192,208,16,chromagram
545,8,97.184,128.836,31.652000000000015,208,274,66,chromagram
545,1,0.0,18.336,18.336,0,40,40,chroma_acts
545,2,18.336,48.84266666666666,30.50666666666666,40,105,65,chroma_acts
545,3,48.84266666666666,77.00266666666666,28.159999999999997,105,165,60,chroma_acts
545,4,77.00266666666666,78.88,1.8773333333333397,165,169,4,chroma_acts
545,5,78.88,86.38933333333333,7.5093333333333305,169,185,16,chroma_acts
545,6,86.38933333333333,89.67466666666667,3.285333333333341,185,192,7,chroma_acts
545,7,89.67466666666667,96.71466666666666,7.039999999999992,192,207,15,chroma_acts
545,8,96.71466666666666,128.836,32.121333333333354,207,274,67,chroma_acts
545,1,0.0,19.274666666666665,19.274666666666665,0,42,42,chroma_acts_smoothed
545,2,19.274666666666665,33.824,14.549333333333333,42,73,31,chroma_acts_smoothed
545,3,33.824,48.84266666666666,15.018666666666661,73,105,32,chroma_acts_smoothed
545,4,48.84266666666666,79.34933333333333,30.506666666666675,105,170,65,chroma_acts_smoothed
545,5,79.34933333333333,86.38933333333333,7.039999999999992,170,185,15,chroma_acts_smoothed
545,6,86.38933333333333,91.55199999999999,5.1626666666666665,185,196,11,chroma_acts_smoothed
545,7,91.55199999999999,96.71466666666666,5.1626666666666665,196,207,11,chroma_acts_smoothed
545,8,96.71466666666666,128.836,32.121333333333354,207,274,67,chroma_acts_smoothed
545,1,0.0,18.336,18.336,0,40,40,ki_chroma
545,2,18.336,33.824,15.488,40,73,33,ki_chroma
545,3,33.824,48.84266666666666,15.018666666666661,73,105,32,ki_chroma
545,4,48.84266666666666,78.88,30.037333333333336,105,169,64,ki_chroma
545,5,78.88,86.38933333333333,7.5093333333333305,169,185,16,ki_chroma
545,6,86.38933333333333,89.67466666666667,3.285333333333341,185,192,7,ki_chroma
545,7,89.67466666666667,97.184,7.5093333333333305,192,208,16,ki_chroma
545,8,97.184,128.836,31.652000000000015,208,274,66,ki_chroma
545,1,0.0,18.336,18.336,0,40,40,ki_chroma_acts
545,2,18.336,48.84266666666666,30.50666666666666,40,105,65,ki_chroma_acts
545,3,48.84266666666666,77.00266666666666,28.159999999999997,105,165,60,ki_chroma_acts
545,4,77.00266666666666,78.88,1.8773333333333397,165,169,4,ki_chroma_acts
545,5,78.88,86.38933333333333,7.5093333333333305,169,185,16,ki_chroma_acts
545,6,86.38933333333333,89.67466666666667,3.285333333333341,185,192,7,ki_chroma_acts
545,7,89.67466666666667,96.71466666666666,7.039999999999992,192,207,15,ki_chroma_acts
545,8,96.71466666666666,128.836,32.121333333333354,207,274,67,ki_chroma_acts
545,1,0.0,19.274666666666665,19.274666666666665,0,42,42,ki_chroma_acts_smoothed
545,2,19.274666666666665,33.824,14.549333333333333,42,73,31,ki_chroma_acts_smoothed
545,3,33.824,48.84266666666666,15.018666666666661,73,105,32,ki_chroma_acts_smoothed
545,4,48.84266666666666,79.34933333333333,30.506666666666675,105,170,65,ki_chroma_acts_smoothed
545,5,79.34933333333333,86.38933333333333,7.039999999999992,170,185,15,ki_chroma_acts_smoothed
545,6,86.38933333333333,91.55199999999999,5.1626666666666665,185,196,11,ki_chroma_acts_smoothed
545,7,91.55199999999999,96.71466666666666,5.1626666666666665,196,207,11,ki_chroma_acts_smoothed
545,8,96.71466666666666,128.836,32.121333333333354,207,274,67,ki_chroma_acts_smoothed
546,1,0.0,42.93333333333332,42.93333333333332,0,94,94,chromagram
546,2,42.93333333333332,51.64799999999999,8.714666666666666,94,113,19,chromagram
546,3,51.64799999999999,109.89866666666666,58.25066666666667,113,240,127,chromagram
546,4,109.89866666666666,125.49333333333331,15.594666666666654,240,274,34,chromagram
546,5,125.49333333333331,150.71999999999997,25.22666666666666,274,329,55,chromagram
546,6,150.71999999999997,154.84799999999998,4.128000000000014,329,338,9,chromagram
546,7,154.84799999999998,202.093,47.245000000000005,338,440,102,chromagram
546,1,0.0,41.09866666666666,41.09866666666666,0,90,90,chroma_acts
546,2,41.09866666666666,51.64799999999999,10.54933333333333,90,113,23,chroma_acts
546,3,51.64799999999999,109.89866666666666,58.25066666666667,113,240,127,chroma_acts
546,4,109.89866666666666,122.74133333333332,12.84266666666666,240,268,28,chroma_acts
546,5,122.74133333333332,150.71999999999997,27.978666666666655,268,329,61,chroma_acts
546,6,150.71999999999997,169.52533333333332,18.80533333333335,329,370,41,chroma_acts
546,7,169.52533333333332,202.093,32.56766666666667,370,440,70,chroma_acts
546,1,0.0,40.63999999999999,40.63999999999999,0,89,89,chroma_acts_smoothed
546,2,40.63999999999999,51.64799999999999,11.007999999999996,89,113,24,chroma_acts_smoothed
546,3,51.64799999999999,108.98133333333332,57.333333333333336,113,238,125,chroma_acts_smoothed
546,4,108.98133333333332,125.49333333333331,16.511999999999986,238,274,36,chroma_acts_smoothed
546,5,125.49333333333331,151.17866666666666,25.685333333333347,274,330,56,chroma_acts_smoothed
546,6,151.17866666666666,154.84799999999998,3.669333333333327,330,338,8,chroma_acts_smoothed
546,7,154.84799999999998,202.093,47.245000000000005,338,440,102,chroma_acts_smoothed
546,1,0.0,42.93333333333332,42.93333333333332,0,94,94,ki_chroma
546,2,42.93333333333332,51.64799999999999,8.714666666666666,94,113,19,ki_chroma
546,3,51.64799999999999,109.89866666666666,58.25066666666667,113,240,127,ki_chroma
546,4,109.89866666666666,125.49333333333331,15.594666666666654,240,274,34,ki_chroma
546,5,125.49333333333331,150.71999999999997,25.22666666666666,274,329,55,ki_chroma
546,6,150.71999999999997,154.84799999999998,4.128000000000014,329,338,9,ki_chroma
546,7,154.84799999999998,202.093,47.245000000000005,338,440,102,ki_chroma
546,1,0.0,41.09866666666666,41.09866666666666,0,90,90,ki_chroma_acts
546,2,41.09866666666666,51.64799999999999,10.54933333333333,90,113,23,ki_chroma_acts
546,3,51.64799999999999,109.89866666666666,58.25066666666667,113,240,127,ki_chroma_acts
546,4,109.89866666666666,122.74133333333332,12.84266666666666,240,268,28,ki_chroma_acts
546,5,122.74133333333332,150.71999999999997,27.978666666666655,268,329,61,ki_chroma_acts
546,6,150.71999999999997,169.52533333333332,18.80533333333335,329,370,41,ki_chroma_acts
546,7,169.52533333333332,202.093,32.56766666666667,370,440,70,ki_chroma_acts
546,1,0.0,40.63999999999999,40.63999999999999,0,89,89,ki_chroma_acts_smoothed
546,2,40.63999999999999,51.64799999999999,11.007999999999996,89,113,24,ki_chroma_acts_smoothed
546,3,51.64799999999999,108.98133333333332,57.333333333333336,113,238,125,ki_chroma_acts_smoothed
546,4,108.98133333333332,125.49333333333331,16.511999999999986,238,274,36,ki_chroma_acts_smoothed
546,5,125.49333333333331,151.17866666666666,25.685333333333347,274,330,56,ki_chroma_acts_smoothed
546,6,151.17866666666666,154.84799999999998,3.669333333333327,330,338,8,ki_chroma_acts_smoothed
546,7,154.84799999999998,202.093,47.245000000000005,338,440,102,ki_chroma_acts_smoothed
547,1,0.0,58.037333333333336,58.037333333333336,0,124,124,chromagram
547,2,58.037333333333336,84.32,26.282666666666657,124,180,56,chromagram
547,3,84.32,91.82933333333334,7.509333333333345,180,196,16,chromagram
547,4,91.82933333333334,121.86666666666666,30.037333333333322,196,260,64,chromagram
547,5,121.86666666666666,196.96,75.09333333333335,260,420,160,chromagram
547,6,196.96,204.46933333333334,7.5093333333333305,420,436,16,chromagram
547,7,204.46933333333334,211.50933333333333,7.039999999999992,436,451,15,chromagram
547,8,211.50933333333333,242.016,30.50666666666666,451,516,65,chromagram
547,9,242.016,294.722,52.70599999999999,516,627,111,chromagram
547,1,0.0,58.037333333333336,58.037333333333336,0,124,124,chroma_acts
547,2,58.037333333333336,73.056,15.018666666666661,124,156,32,chroma_acts
547,3,73.056,84.32,11.263999999999996,156,180,24,chroma_acts
547,4,84.32,91.82933333333334,7.509333333333345,180,196,16,chroma_acts
547,5,91.82933333333334,121.86666666666666,30.037333333333322,196,260,64,chroma_acts
547,6,121.86666666666666,196.96,75.09333333333335,260,420,160,chroma_acts
547,7,196.96,211.50933333333333,14.549333333333323,420,451,31,chroma_acts
547,8,211.50933333333333,252.81066666666666,41.30133333333333,451,539,88,chroma_acts
547,9,252.81066666666666,294.722,41.91133333333332,539,627,88,chroma_acts
547,1,0.0,58.037333333333336,58.037333333333336,0,124,124,chroma_acts_smoothed
547,2,58.037333333333336,63.669333333333334,5.631999999999998,124,136,12,chroma_acts_smoothed
547,3,63.669333333333334,73.056,9.386666666666663,136,156,20,chroma_acts_smoothed
547,4,73.056,84.32,11.263999999999996,156,180,24,chroma_acts_smoothed
547,5,84.32,133.13066666666666,48.81066666666666,180,284,104,chroma_acts_smoothed
547,6,133.13066666666666,196.49066666666667,63.360000000000014,284,419,135,chroma_acts_smoothed
547,7,196.49066666666667,211.50933333333333,15.018666666666661,419,451,32,chroma_acts_smoothed
547,8,211.50933333333333,252.81066666666666,41.30133333333333,451,539,88,chroma_acts_smoothed
547,9,252.81066666666666,294.722,41.91133333333332,539,627,88,chroma_acts_smoothed
547,1,0.0,58.037333333333336,58.037333333333336,0,124,124,ki_chroma
547,2,58.037333333333336,84.32,26.282666666666657,124,180,56,ki_chroma
547,3,84.32,91.82933333333334,7.509333333333345,180,196,16,ki_chroma
547,4,91.82933333333334,121.86666666666666,30.037333333333322,196,260,64,ki_chroma
547,5,121.86666666666666,196.96,75.09333333333335,260,420,160,ki_chroma
547,6,196.96,204.46933333333334,7.5093333333333305,420,436,16,ki_chroma
547,7,204.46933333333334,211.50933333333333,7.039999999999992,436,451,15,ki_chroma
547,8,211.50933333333333,242.016,30.50666666666666,451,516,65,ki_chroma
547,9,242.016,294.722,52.70599999999999,516,627,111,ki_chroma
547,1,0.0,58.037333333333336,58.037333333333336,0,124,124,ki_chroma_acts
547,2,58.037333333333336,73.056,15.018666666666661,124,156,32,ki_chroma_acts
547,3,73.056,84.32,11.263999999999996,156,180,24,ki_chroma_acts
547,4,84.32,91.82933333333334,7.509333333333345,180,196,16,ki_chroma_acts
547,5,91.82933333333334,121.86666666666666,30.037333333333322,196,260,64,ki_chroma_acts
547,6,121.86666666666666,196.96,75.09333333333335,260,420,160,ki_chroma_acts
547,7,196.96,211.50933333333333,14.549333333333323,420,451,31,ki_chroma_acts
547,8,211.50933333333333,252.81066666666666,41.30133333333333,451,539,88,ki_chroma_acts
547,9,252.81066666666666,294.722,41.91133333333332,539,627,88,ki_chroma_acts
547,1,0.0,58.037333333333336,58.037333333333336,0,124,124,ki_chroma_acts_smoothed
547,2,58.037333333333336,63.669333333333334,5.631999999999998,124,136,12,ki_chroma_acts_smoothed
547,3,63.669333333333334,73.056,9.386666666666663,136,156,20,ki_chroma_acts_smoothed
547,4,73.056,84.32,11.263999999999996,156,180,24,ki_chroma_acts_smoothed
547,5,84.32,133.13066666666666,48.81066666666666,180,284,104,ki_chroma_acts_smoothed
547,6,133.13066666666666,196.49066666666667,63.360000000000014,284,419,135,ki_chroma_acts_smoothed
547,7,196.49066666666667,211.50933333333333,15.018666666666661,419,451,32,ki_chroma_acts_smoothed
547,8,211.50933333333333,252.81066666666666,41.30133333333333,451,539,88,ki_chroma_acts_smoothed
547,9,252.81066666666666,294.722,41.91133333333332,539,627,88,ki_chroma_acts_smoothed
548,1,0.0,18.890666666666668,18.890666666666668,0,41,41,chromagram
548,2,18.890666666666668,33.909333333333336,15.018666666666668,41,73,32,chromagram
548,3,33.909333333333336,62.538666666666664,28.629333333333328,73,134,61,chromagram
548,4,62.538666666666664,96.8,34.26133333333333,134,207,73,chromagram
548,5,96.8,111.34933333333333,14.549333333333337,207,238,31,chromagram
548,6,111.34933333333333,126.368,15.018666666666661,238,270,32,chromagram
548,7,126.368,171.89333333333335,45.52533333333335,270,367,97,chromagram
548,8,171.89333333333335,206.15466666666666,34.26133333333331,367,440,73,chromagram
548,9,206.15466666666666,218.284,12.129333333333335,440,464,24,chromagram
548,1,0.0,18.890666666666668,18.890666666666668,0,41,41,chroma_acts
548,2,18.890666666666668,33.909333333333336,15.018666666666668,41,73,32,chroma_acts
548,3,33.909333333333336,63.946666666666665,30.03733333333333,73,137,64,chroma_acts
548,4,63.946666666666665,96.8,32.85333333333333,137,207,70,chroma_acts
548,5,96.8,111.34933333333333,14.549333333333337,207,238,31,chroma_acts
548,6,111.34933333333333,125.42933333333333,14.079999999999998,238,268,30,chroma_acts
548,7,125.42933333333333,171.89333333333335,46.46400000000001,268,367,99,chroma_acts
548,8,171.89333333333335,206.15466666666666,34.26133333333331,367,440,73,chroma_acts
548,9,206.15466666666666,218.284,12.129333333333335,440,464,24,chroma_acts
548,1,0.0,18.890666666666668,18.890666666666668,0,41,41,chroma_acts_smoothed
548,2,18.890666666666668,33.909333333333336,15.018666666666668,41,73,32,chroma_acts_smoothed
548,3,33.909333333333336,63.946666666666665,30.03733333333333,73,137,64,chroma_acts_smoothed
548,4,63.946666666666665,96.8,32.85333333333333,137,207,70,chroma_acts_smoothed
548,5,96.8,111.34933333333333,14.549333333333337,207,238,31,chroma_acts_smoothed
548,6,111.34933333333333,126.368,15.018666666666661,238,270,32,chroma_acts_smoothed
548,7,126.368,171.89333333333335,45.52533333333335,270,367,97,chroma_acts_smoothed
548,8,171.89333333333335,200.52266666666665,28.629333333333307,367,428,61,chroma_acts_smoothed
548,9,200.52266666666665,218.284,17.76133333333334,428,464,36,chroma_acts_smoothed
548,1,0.0,18.890666666666668,18.890666666666668,0,41,41,ki_chroma
548,2,18.890666666666668,33.909333333333336,15.018666666666668,41,73,32,ki_chroma
548,3,33.909333333333336,62.538666666666664,28.629333333333328,73,134,61,ki_chroma
548,4,62.538666666666664,96.8,34.26133333333333,134,207,73,ki_chroma
548,5,96.8,111.34933333333333,14.549333333333337,207,238,31,ki_chroma
548,6,111.34933333333333,126.368,15.018666666666661,238,270,32,ki_chroma
548,7,126.368,171.89333333333335,45.52533333333335,270,367,97,ki_chroma
548,8,171.89333333333335,206.15466666666666,34.26133333333331,367,440,73,ki_chroma
548,9,206.15466666666666,218.284,12.129333333333335,440,464,24,ki_chroma
548,1,0.0,18.890666666666668,18.890666666666668,0,41,41,ki_chroma_acts
548,2,18.890666666666668,33.909333333333336,15.018666666666668,41,73,32,ki_chroma_acts
548,3,33.909333333333336,63.946666666666665,30.03733333333333,73,137,64,ki_chroma_acts
548,4,63.946666666666665,96.8,32.85333333333333,137,207,70,ki_chroma_acts
548,5,96.8,111.34933333333333,14.549333333333337,207,238,31,ki_chroma_acts
548,6,111.34933333333333,125.42933333333333,14.079999999999998,238,268,30,ki_chroma_acts
548,7,125.42933333333333,171.89333333333335,46.46400000000001,268,367,99,ki_chroma_acts
548,8,171.89333333333335,206.15466666666666,34.26133333333331,367,440,73,ki_chroma_acts
548,9,206.15466666666666,218.284,12.129333333333335,440,464,24,ki_chroma_acts
548,1,0.0,18.890666666666668,18.890666666666668,0,41,41,ki_chroma_acts_smoothed
548,2,18.890666666666668,33.909333333333336,15.018666666666668,41,73,32,ki_chroma_acts_smoothed
548,3,33.909333333333336,63.946666666666665,30.03733333333333,73,137,64,ki_chroma_acts_smoothed
548,4,63.946666666666665,96.8,32.85333333333333,137,207,70,ki_chroma_acts_smoothed
548,5,96.8,111.34933333333333,14.549333333333337,207,238,31,ki_chroma_acts_smoothed
548,6,111.34933333333333,126.368,15.018666666666661,238,270,32,ki_chroma_acts_smoothed
548,7,126.368,171.89333333333335,45.52533333333335,270,367,97,ki_chroma_acts_smoothed
548,8,171.89333333333335,200.52266666666665,28.629333333333307,367,428,61,ki_chroma_acts_smoothed
548,9,200.52266666666665,218.284,17.76133333333334,428,464,36,ki_chroma_acts_smoothed
550,1,0.0,8.16,8.16,0,18,18,chromagram
550,2,8.16,67.29599999999999,59.135999999999996,18,144,126,chromagram
550,3,67.29599999999999,112.82133333333333,45.525333333333336,144,241,97,chromagram
550,4,112.82133333333333,120.33066666666666,7.5093333333333305,241,257,16,chromagram
550,5,120.33066666666666,180.40533333333332,60.07466666666666,257,385,128,chromagram
550,6,180.40533333333332,195.42399999999998,15.018666666666661,385,417,32,chromagram
550,7,195.42399999999998,203.87199999999999,8.448000000000008,417,435,18,chromagram
550,8,203.87199999999999,255.49866666666665,51.626666666666665,435,545,110,chromagram
550,9,255.49866666666665,266.043,10.544333333333356,545,566,21,chromagram
550,1,0.0,8.16,8.16,0,18,18,chroma_acts
550,2,8.16,67.29599999999999,59.135999999999996,18,144,126,chroma_acts
550,3,67.29599999999999,114.69866666666665,47.40266666666666,144,245,101,chroma_acts
550,4,114.69866666666665,120.33066666666666,5.632000000000005,245,257,12,chroma_acts
550,5,120.33066666666666,180.40533333333332,60.07466666666666,257,385,128,chroma_acts
550,6,180.40533333333332,195.42399999999998,15.018666666666661,385,417,32,chroma_acts
550,7,195.42399999999998,202.93333333333334,7.509333333333359,417,433,16,chroma_acts
550,8,202.93333333333334,255.49866666666665,52.565333333333314,433,545,112,chroma_acts
550,9,255.49866666666665,266.043,10.544333333333356,545,566,21,chroma_acts
550,1,0.0,8.16,8.16,0,18,18,chroma_acts_smoothed
550,2,8.16,67.29599999999999,59.135999999999996,18,144,126,chroma_acts_smoothed
550,3,67.29599999999999,112.82133333333333,45.525333333333336,144,241,97,chroma_acts_smoothed
550,4,112.82133333333333,120.33066666666666,7.5093333333333305,241,257,16,chroma_acts_smoothed
550,5,120.33066666666666,180.87466666666666,60.544,257,386,129,chroma_acts_smoothed
550,6,180.87466666666666,195.42399999999998,14.549333333333323,386,417,31,chroma_acts_smoothed
550,7,195.42399999999998,209.504,14.080000000000013,417,447,30,chroma_acts_smoothed
550,8,209.504,256.90666666666664,47.40266666666665,447,548,101,chroma_acts_smoothed
550,9,256.90666666666664,266.043,9.136333333333369,548,566,18,chroma_acts_smoothed
550,1,0.0,8.16,8.16,0,18,18,ki_chroma
550,2,8.16,67.29599999999999,59.135999999999996,18,144,126,ki_chroma
550,3,67.29599999999999,112.82133333333333,45.525333333333336,144,241,97,ki_chroma
550,4,112.82133333333333,120.33066666666666,7.5093333333333305,241,257,16,ki_chroma
550,5,120.33066666666666,180.40533333333332,60.07466666666666,257,385,128,ki_chroma
550,6,180.40533333333332,195.42399999999998,15.018666666666661,385,417,32,ki_chroma
550,7,195.42399999999998,203.87199999999999,8.448000000000008,417,435,18,ki_chroma
550,8,203.87199999999999,255.49866666666665,51.626666666666665,435,545,110,ki_chroma
550,9,255.49866666666665,266.043,10.544333333333356,545,566,21,ki_chroma
550,1,0.0,8.16,8.16,0,18,18,ki_chroma_acts
550,2,8.16,67.29599999999999,59.135999999999996,18,144,126,ki_chroma_acts
550,3,67.29599999999999,114.69866666666665,47.40266666666666,144,245,101,ki_chroma_acts
550,4,114.69866666666665,120.33066666666666,5.632000000000005,245,257,12,ki_chroma_acts
550,5,120.33066666666666,180.40533333333332,60.07466666666666,257,385,128,ki_chroma_acts
550,6,180.40533333333332,195.42399999999998,15.018666666666661,385,417,32,ki_chroma_acts
550,7,195.42399999999998,202.93333333333334,7.509333333333359,417,433,16,ki_chroma_acts
550,8,202.93333333333334,255.49866666666665,52.565333333333314,433,545,112,ki_chroma_acts
550,9,255.49866666666665,266.043,10.544333333333356,545,566,21,ki_chroma_acts
550,1,0.0,8.16,8.16,0,18,18,ki_chroma_acts_smoothed
550,2,8.16,67.29599999999999,59.135999999999996,18,144,126,ki_chroma_acts_smoothed
550,3,67.29599999999999,112.82133333333333,45.525333333333336,144,241,97,ki_chroma_acts_smoothed
550,4,112.82133333333333,120.33066666666666,7.5093333333333305,241,257,16,ki_chroma_acts_smoothed
550,5,120.33066666666666,180.87466666666666,60.544,257,386,129,ki_chroma_acts_smoothed
550,6,180.87466666666666,195.42399999999998,14.549333333333323,386,417,31,ki_chroma_acts_smoothed
550,7,195.42399999999998,209.504,14.080000000000013,417,447,30,ki_chroma_acts_smoothed
550,8,209.504,256.90666666666664,47.40266666666665,447,548,101,ki_chroma_acts_smoothed
550,9,256.90666666666664,266.043,9.136333333333369,548,566,18,ki_chroma_acts_smoothed
551,1,0.0,34.602666666666664,34.602666666666664,0,73,73,chromagram
551,2,34.602666666666664,69.16266666666667,34.56,73,145,72,chromagram
551,3,69.16266666666667,76.84266666666666,7.679999999999993,145,161,16,chromagram
551,4,76.84266666666666,80.68266666666666,3.8400000000000034,161,169,8,chromagram
551,5,80.68266666666666,84.52266666666667,3.8400000000000034,169,177,8,chromagram
551,6,84.52266666666667,92.20266666666666,7.679999999999993,177,193,16,chromagram
551,7,92.20266666666666,96.04266666666666,3.8400000000000034,193,201,8,chromagram
551,8,96.04266666666666,147.88266666666667,51.84,201,309,108,chromagram
551,9,147.88266666666667,165.09,17.207333333333338,309,343,34,chromagram
551,1,0.0,34.602666666666664,34.602666666666664,0,73,73,chroma_acts
551,2,34.602666666666664,69.16266666666667,34.56,73,145,72,chroma_acts
551,3,69.16266666666667,76.84266666666666,7.679999999999993,145,161,16,chroma_acts
551,4,76.84266666666666,80.68266666666666,3.8400000000000034,161,169,8,chroma_acts
551,5,80.68266666666666,84.52266666666667,3.8400000000000034,169,177,8,chroma_acts
551,6,84.52266666666667,92.20266666666666,7.679999999999993,177,193,16,chroma_acts
551,7,92.20266666666666,96.04266666666666,3.8400000000000034,193,201,8,chroma_acts
551,8,96.04266666666666,107.56266666666666,11.519999999999996,201,225,24,chroma_acts
551,9,107.56266666666666,165.09,57.527333333333345,225,343,118,chroma_acts
551,1,0.0,34.602666666666664,34.602666666666664,0,73,73,chroma_acts_smoothed
551,2,34.602666666666664,69.16266666666667,34.56,73,145,72,chroma_acts_smoothed
551,3,69.16266666666667,77.32266666666666,8.159999999999997,145,162,17,chroma_acts_smoothed
551,4,77.32266666666666,80.68266666666666,3.3599999999999994,162,169,7,chroma_acts_smoothed
551,5,80.68266666666666,85.00266666666666,4.319999999999993,169,178,9,chroma_acts_smoothed
551,6,85.00266666666666,92.20266666666666,7.200000000000003,178,193,15,chroma_acts_smoothed
551,7,92.20266666666666,96.04266666666666,3.8400000000000034,193,201,8,chroma_acts_smoothed
551,8,96.04266666666666,108.04266666666666,12.0,201,226,25,chroma_acts_smoothed
551,9,108.04266666666666,165.09,57.04733333333334,226,343,117,chroma_acts_smoothed
551,1,0.0,34.602666666666664,34.602666666666664,0,73,73,ki_chroma
551,2,34.602666666666664,69.16266666666667,34.56,73,145,72,ki_chroma
551,3,69.16266666666667,76.84266666666666,7.679999999999993,145,161,16,ki_chroma
551,4,76.84266666666666,80.68266666666666,3.8400000000000034,161,169,8,ki_chroma
551,5,80.68266666666666,84.52266666666667,3.8400000000000034,169,177,8,ki_chroma
551,6,84.52266666666667,92.20266666666666,7.679999999999993,177,193,16,ki_chroma
551,7,92.20266666666666,96.04266666666666,3.8400000000000034,193,201,8,ki_chroma
551,8,96.04266666666666,147.88266666666667,51.84,201,309,108,ki_chroma
551,9,147.88266666666667,165.09,17.207333333333338,309,343,34,ki_chroma
551,1,0.0,34.602666666666664,34.602666666666664,0,73,73,ki_chroma_acts
551,2,34.602666666666664,69.16266666666667,34.56,73,145,72,ki_chroma_acts
551,3,69.16266666666667,76.84266666666666,7.679999999999993,145,161,16,ki_chroma_acts
551,4,76.84266666666666,80.68266666666666,3.8400000000000034,161,169,8,ki_chroma_acts
551,5,80.68266666666666,84.52266666666667,3.8400000000000034,169,177,8,ki_chroma_acts
551,6,84.52266666666667,92.20266666666666,7.679999999999993,177,193,16,ki_chroma_acts
551,7,92.20266666666666,96.04266666666666,3.8400000000000034,193,201,8,ki_chroma_acts
551,8,96.04266666666666,107.56266666666666,11.519999999999996,201,225,24,ki_chroma_acts
551,9,107.56266666666666,165.09,57.527333333333345,225,343,118,ki_chroma_acts
551,1,0.0,34.602666666666664,34.602666666666664,0,73,73,ki_chroma_acts_smoothed
551,2,34.602666666666664,69.16266666666667,34.56,73,145,72,ki_chroma_acts_smoothed
551,3,69.16266666666667,77.32266666666666,8.159999999999997,145,162,17,ki_chroma_acts_smoothed
551,4,77.32266666666666,80.68266666666666,3.3599999999999994,162,169,7,ki_chroma_acts_smoothed
551,5,80.68266666666666,85.00266666666666,4.319999999999993,169,178,9,ki_chroma_acts_smoothed
551,6,85.00266666666666,92.20266666666666,7.200000000000003,178,193,15,ki_chroma_acts_smoothed
551,7,92.20266666666666,96.04266666666666,3.8400000000000034,193,201,8,ki_chroma_acts_smoothed
551,8,96.04266666666666,108.04266666666666,12.0,201,226,25,ki_chroma_acts_smoothed
551,9,108.04266666666666,165.09,57.04733333333334,226,343,117,ki_chroma_acts_smoothed
552,1,0.0,7.349333333333333,7.349333333333333,0,16,16,chromagram
552,2,7.349333333333333,38.54933333333333,31.199999999999996,16,81,65,chromagram
552,3,38.54933333333333,53.42933333333333,14.880000000000003,81,112,31,chromagram
552,4,53.42933333333333,83.66933333333333,30.239999999999995,112,175,63,chromagram
552,5,83.66933333333333,99.50933333333333,15.840000000000003,175,208,33,chromagram
552,6,99.50933333333333,131.18933333333334,31.680000000000007,208,274,66,chromagram
552,7,131.18933333333334,144.62933333333334,13.439999999999998,274,302,28,chromagram
552,8,144.62933333333334,209.656,65.02666666666667,302,436,134,chromagram
552,1,0.0,7.349333333333333,7.349333333333333,0,16,16,chroma_acts
552,2,7.349333333333333,38.54933333333333,31.199999999999996,16,81,65,chroma_acts
552,3,38.54933333333333,53.42933333333333,14.880000000000003,81,112,31,chroma_acts
552,4,53.42933333333333,84.14933333333333,30.72,112,176,64,chroma_acts
552,5,84.14933333333333,99.98933333333333,15.840000000000003,176,209,33,chroma_acts
552,6,99.98933333333333,131.18933333333334,31.200000000000003,209,274,65,chroma_acts
552,7,131.18933333333334,145.10933333333335,13.920000000000016,274,303,29,chroma_acts
552,8,145.10933333333335,209.656,64.54666666666665,303,436,133,chroma_acts
552,1,0.0,7.349333333333333,7.349333333333333,0,16,16,chroma_acts_smoothed
552,2,7.349333333333333,38.54933333333333,31.199999999999996,16,81,65,chroma_acts_smoothed
552,3,38.54933333333333,53.42933333333333,14.880000000000003,81,112,31,chroma_acts_smoothed
552,4,53.42933333333333,83.66933333333333,30.239999999999995,112,175,63,chroma_acts_smoothed
552,5,83.66933333333333,99.98933333333333,16.320000000000007,175,209,34,chroma_acts_smoothed
552,6,99.98933333333333,133.10933333333335,33.12000000000002,209,278,69,chroma_acts_smoothed
552,7,133.10933333333335,145.10933333333335,12.0,278,303,25,chroma_acts_smoothed
552,8,145.10933333333335,209.656,64.54666666666665,303,436,133,chroma_acts_smoothed
552,1,0.0,7.349333333333333,7.349333333333333,0,16,16,ki_chroma
552,2,7.349333333333333,38.54933333333333,31.199999999999996,16,81,65,ki_chroma
552,3,38.54933333333333,53.42933333333333,14.880000000000003,81,112,31,ki_chroma
552,4,53.42933333333333,83.66933333333333,30.239999999999995,112,175,63,ki_chroma
552,5,83.66933333333333,99.50933333333333,15.840000000000003,175,208,33,ki_chroma
552,6,99.50933333333333,131.18933333333334,31.680000000000007,208,274,66,ki_chroma
552,7,131.18933333333334,144.62933333333334,13.439999999999998,274,302,28,ki_chroma
552,8,144.62933333333334,209.656,65.02666666666667,302,436,134,ki_chroma
552,1,0.0,7.349333333333333,7.349333333333333,0,16,16,ki_chroma_acts
552,2,7.349333333333333,38.54933333333333,31.199999999999996,16,81,65,ki_chroma_acts
552,3,38.54933333333333,53.42933333333333,14.880000000000003,81,112,31,ki_chroma_acts
552,4,53.42933333333333,84.14933333333333,30.72,112,176,64,ki_chroma_acts
552,5,84.14933333333333,99.98933333333333,15.840000000000003,176,209,33,ki_chroma_acts
552,6,99.98933333333333,131.18933333333334,31.200000000000003,209,274,65,ki_chroma_acts
552,7,131.18933333333334,145.10933333333335,13.920000000000016,274,303,29,ki_chroma_acts
552,8,145.10933333333335,209.656,64.54666666666665,303,436,133,ki_chroma_acts
552,1,0.0,7.349333333333333,7.349333333333333,0,16,16,ki_chroma_acts_smoothed
552,2,7.349333333333333,38.54933333333333,31.199999999999996,16,81,65,ki_chroma_acts_smoothed
552,3,38.54933333333333,53.42933333333333,14.880000000000003,81,112,31,ki_chroma_acts_smoothed
552,4,53.42933333333333,83.66933333333333,30.239999999999995,112,175,63,ki_chroma_acts_smoothed
552,5,83.66933333333333,99.98933333333333,16.320000000000007,175,209,34,ki_chroma_acts_smoothed
552,6,99.98933333333333,133.10933333333335,33.12000000000002,209,278,69,ki_chroma_acts_smoothed
552,7,133.10933333333335,145.10933333333335,12.0,278,303,25,ki_chroma_acts_smoothed
552,8,145.10933333333335,209.656,64.54666666666665,303,436,133,ki_chroma_acts_smoothed
553,1,0.0,20.469333333333335,20.469333333333335,0,43,43,chromagram
553,2,20.469333333333335,30.549333333333333,10.079999999999998,43,64,21,chromagram
553,3,30.549333333333333,73.74933333333333,43.19999999999999,64,154,90,chromagram
553,4,73.74933333333333,87.66933333333333,13.920000000000002,154,183,29,chromagram
553,5,87.66933333333333,106.86933333333333,19.200000000000003,183,223,40,chromagram
553,6,106.86933333333333,114.54933333333332,7.679999999999993,223,239,16,chromagram
553,7,114.54933333333332,129.42933333333335,14.880000000000024,239,270,31,chromagram
553,8,129.42933333333335,205.74933333333334,76.32,270,429,159,chromagram
553,9,205.74933333333334,213.875,8.12566666666666,429,444,15,chromagram
553,1,0.0,19.989333333333335,19.989333333333335,0,42,42,chroma_acts
553,2,19.989333333333335,30.549333333333333,10.559999999999999,42,64,22,chroma_acts
553,3,30.549333333333333,73.74933333333333,43.19999999999999,64,154,90,chroma_acts
553,4,73.74933333333333,87.66933333333333,13.920000000000002,154,183,29,chroma_acts
553,5,87.66933333333333,106.86933333333333,19.200000000000003,183,223,40,chroma_acts
553,6,106.86933333333333,114.54933333333332,7.679999999999993,223,239,16,chroma_acts
553,7,114.54933333333332,129.42933333333335,14.880000000000024,239,270,31,chroma_acts
553,8,129.42933333333335,213.875,84.44566666666665,270,444,174,chroma_acts
553,1,0.0,21.909333333333333,21.909333333333333,0,46,46,chroma_acts_smoothed
553,2,21.909333333333333,30.549333333333333,8.64,46,64,18,chroma_acts_smoothed
553,3,30.549333333333333,74.22933333333333,43.67999999999999,64,155,91,chroma_acts_smoothed
553,4,74.22933333333333,91.50933333333333,17.28,155,191,36,chroma_acts_smoothed
553,5,91.50933333333333,106.86933333333333,15.36,191,223,32,chroma_acts_smoothed
553,6,106.86933333333333,114.54933333333332,7.679999999999993,223,239,16,chroma_acts_smoothed
553,7,114.54933333333332,129.42933333333335,14.880000000000024,239,270,31,chroma_acts_smoothed
553,8,129.42933333333335,213.875,84.44566666666665,270,444,174,chroma_acts_smoothed
553,1,0.0,20.469333333333335,20.469333333333335,0,43,43,ki_chroma
553,2,20.469333333333335,30.549333333333333,10.079999999999998,43,64,21,ki_chroma
553,3,30.549333333333333,73.74933333333333,43.19999999999999,64,154,90,ki_chroma
553,4,73.74933333333333,87.66933333333333,13.920000000000002,154,183,29,ki_chroma
553,5,87.66933333333333,106.86933333333333,19.200000000000003,183,223,40,ki_chroma
553,6,106.86933333333333,114.54933333333332,7.679999999999993,223,239,16,ki_chroma
553,7,114.54933333333332,129.42933333333335,14.880000000000024,239,270,31,ki_chroma
553,8,129.42933333333335,205.74933333333334,76.32,270,429,159,ki_chroma
553,9,205.74933333333334,213.875,8.12566666666666,429,444,15,ki_chroma
553,1,0.0,19.989333333333335,19.989333333333335,0,42,42,ki_chroma_acts
553,2,19.989333333333335,30.549333333333333,10.559999999999999,42,64,22,ki_chroma_acts
553,3,30.549333333333333,73.74933333333333,43.19999999999999,64,154,90,ki_chroma_acts
553,4,73.74933333333333,87.66933333333333,13.920000000000002,154,183,29,ki_chroma_acts
553,5,87.66933333333333,106.86933333333333,19.200000000000003,183,223,40,ki_chroma_acts
553,6,106.86933333333333,114.54933333333332,7.679999999999993,223,239,16,ki_chroma_acts
553,7,114.54933333333332,129.42933333333335,14.880000000000024,239,270,31,ki_chroma_acts
553,8,129.42933333333335,213.875,84.44566666666665,270,444,174,ki_chroma_acts
553,1,0.0,21.909333333333333,21.909333333333333,0,46,46,ki_chroma_acts_smoothed
553,2,21.909333333333333,30.549333333333333,8.64,46,64,18,ki_chroma_acts_smoothed
553,3,30.549333333333333,74.22933333333333,43.67999999999999,64,155,91,ki_chroma_acts_smoothed
553,4,74.22933333333333,91.50933333333333,17.28,155,191,36,ki_chroma_acts_smoothed
553,5,91.50933333333333,106.86933333333333,15.36,191,223,32,ki_chroma_acts_smoothed
553,6,106.86933333333333,114.54933333333332,7.679999999999993,223,239,16,ki_chroma_acts_smoothed
553,7,114.54933333333332,129.42933333333335,14.880000000000024,239,270,31,ki_chroma_acts_smoothed
553,8,129.42933333333335,213.875,84.44566666666665,270,444,174,ki_chroma_acts_smoothed
